rank_number,actor,contributions,percent,cumulative_sum,cumulative_percent,all_contributions
1,pitr,591,0.51352,591,0.51352,115088
2,roboshopkeep,522,0.45357,1113,0.96709,115088
3,winebarrel,398,0.34582,1511,1.31291,115088
4,FoxBoxsnet,354,0.30759,1865,1.62050,115088
5,mia-0032,340,0.29543,2205,1.91593,115088
6,chaitanyaphalak,319,0.27718,2524,2.19310,115088
7,aayamauchi,298,0.25893,2822,2.45204,115088
8,nigels-com,266,0.23113,3088,2.68316,115088
9,toyokazu,235,0.20419,3323,2.88736,115088
10,warmfusion,217,0.18855,3540,3.07591,115088
11,bungoume,196,0.17030,3736,3.24621,115088
12,tachikomapocket,194,0.16857,3930,3.41478,115088
13,sawanoboly,184,0.15988,4114,3.57466,115088
14,LiweiPeng,183,0.15901,4297,3.73366,115088
15,pazjacket,182,0.15814,4479,3.89180,115088
16,togusafish,182,0.15814,4661,4.04994,115088
17,dtregonning,167,0.14511,4828,4.19505,115088
18,PettitWesley,167,0.14511,4995,4.34016,115088
19,shinsaka,166,0.14424,5161,4.48439,115088
20,simukappu,160,0.13902,5321,4.62342,115088
21,imaifactory,153,0.13294,5474,4.75636,115088
22,rockb1017,151,0.13120,5625,4.88756,115088
23,cmrust,142,0.12338,5767,5.01095,115088
24,HatsuneMiku3939,135,0.11730,5902,5.12825,115088
25,naoya,135,0.11730,6037,5.24555,115088
26,yanana,135,0.11730,6172,5.36285,115088
27,codeout,130,0.11296,6302,5.47581,115088
28,ixixi,130,0.11296,6432,5.58877,115088
29,dterror,127,0.11035,6559,5.69912,115088
30,kenhys,121,0.10514,6680,5.80425,115088
31,mosuka,121,0.10514,6801,5.90939,115088
32,civitaspo,117,0.10166,6918,6.01105,115088
33,oleewere,114,0.09905,7032,6.11011,115088
34,daichirata,110,0.09558,7142,6.20569,115088
35,thinkbotbot,110,0.09558,7252,6.30127,115088
36,coto,108,0.09384,7360,6.39511,115088
37,joshughes,108,0.09384,7468,6.48895,115088
38,hakobera,107,0.09297,7575,6.58192,115088
39,atomita,103,0.08950,7678,6.67142,115088
40,yantang-msft,100,0.08689,7778,6.75831,115088
41,PakDLiu,91,0.07907,7869,6.83738,115088
42,toddysm,91,0.07907,7960,6.91645,115088
43,bin3377,90,0.07820,8050,6.99465,115088
44,dhrupadb,90,0.07820,8140,7.07285,115088
45,mmasashi,88,0.07646,8228,7.14931,115088
46,takumakanari,88,0.07646,8316,7.22578,115088
47,cmeerbeek,87,0.07559,8403,7.30137,115088
48,imron,86,0.07473,8489,7.37609,115088
49,kawasakitoshiya,86,0.07473,8575,7.45082,115088
50,roiravhon,86,0.07473,8661,7.52555,115088
51,sbonebrake,84,0.07299,8745,7.59853,115088
52,luckyj5,83,0.07212,8828,7.67065,115088
53,nemonium,83,0.07212,8911,7.74277,115088
54,szilvesztersimicza,81,0.07038,8992,7.81315,115088
55,komainu8,80,0.06951,9072,7.88266,115088
56,shunwen,75,0.06517,9147,7.94783,115088
57,williampratt,74,0.06430,9221,8.01213,115088
58,brycied00d,72,0.06256,9293,8.07469,115088
59,dgarros,72,0.06256,9365,8.13725,115088
60,ecwws,70,0.06082,9435,8.19807,115088
61,yaron-idan,68,0.05909,9503,8.25716,115088
62,AlexGaspar,67,0.05822,9570,8.31538,115088
63,h-michael,67,0.05822,9637,8.37359,115088
64,mattheworiordan,67,0.05822,9704,8.43181,115088
65,ewolinetz,66,0.05735,9770,8.48916,115088
66,filipjs,66,0.05735,9836,8.54650,115088
67,toyama-h,66,0.05735,9902,8.60385,115088
68,katsyoshi,65,0.05648,9967,8.66033,115088
69,takaishi,65,0.05648,10032,8.71681,115088
70,haruyama,63,0.05474,10095,8.77155,115088
71,innossh,63,0.05474,10158,8.82629,115088
72,inokappa,63,0.05474,10221,8.88103,115088
73,laramiel,63,0.05474,10284,8.93577,115088
74,digivava,62,0.05387,10346,8.98964,115088
75,dmnfortytwo,62,0.05387,10408,9.04351,115088
76,tarokkk,62,0.05387,10470,9.09739,115088
77,fernandosilvacornejo,61,0.05300,10531,9.15039,115088
78,GLStephen,61,0.05300,10592,9.20339,115088
79,rolandjitsu,61,0.05300,10653,9.25640,115088
80,hirakiuc,60,0.05213,10713,9.30853,115088
81,mdoi,60,0.05213,10773,9.36066,115088
82,t0ffel,60,0.05213,10833,9.41280,115088
83,jordo1138,59,0.05127,10892,9.46406,115088
84,soylent,59,0.05127,10951,9.51533,115088
85,vijaykramesh,59,0.05127,11010,9.56659,115088
86,pyrocro,58,0.05040,11068,9.61699,115088
87,ppp0,57,0.04953,11125,9.66652,115088
88,yu-yamada,57,0.04953,11182,9.71604,115088
89,davidbtucker,56,0.04866,11238,9.76470,115088
90,kumaravel29,56,0.04866,11294,9.81336,115088
91,lunardial,56,0.04866,11350,9.86202,115088
92,matsuokah,56,0.04866,11406,9.91068,115088
93,darashi,55,0.04779,11461,9.95847,115088
94,darkrat,54,0.04692,11515,10.00539,115088
95,stevezau,54,0.04692,11569,10.05231,115088
96,orion46,53,0.04605,11622,10.09836,115088
97,brint,52,0.04518,11674,10.14354,115088
98,Bigel0w,51,0.04431,11725,10.18786,115088
99,cpedro,51,0.04431,11776,10.23217,115088
100,gintau,51,0.04431,11827,10.27648,115088
101,mblaschke,51,0.04431,11878,10.32080,115088
102,meetyg,51,0.04431,11929,10.36511,115088
103,ajacquemot,50,0.04345,11979,10.40856,115088
104,gtrevg,50,0.04345,12029,10.45200,115088
105,jasonzio,50,0.04345,12079,10.49545,115088
106,patant,50,0.04345,12129,10.53889,115088
107,fpytloun,49,0.04258,12178,10.58147,115088
108,jovillas,49,0.04258,12227,10.62404,115088
109,kimutansk,49,0.04258,12276,10.66662,115088
110,chenjienn,48,0.04171,12324,10.70833,115088
111,chris-u,48,0.04171,12372,10.75003,115088
112,junpei-yoshino,48,0.04171,12420,10.79174,115088
113,ahsandar,47,0.04084,12467,10.83258,115088
114,arthurdarcet,47,0.04084,12514,10.87342,115088
115,gp510,47,0.04084,12561,10.91426,115088
116,JonathanSerafini,47,0.04084,12608,10.95510,115088
117,stackdriver-instrumentation-release,47,0.04084,12655,10.99593,115088
118,wolf31o2,47,0.04084,12702,11.03677,115088
119,alexlry,46,0.03997,12748,11.07674,115088
120,muddydixon,46,0.03997,12794,11.11671,115088
121,chicofranchico,45,0.03910,12839,11.15581,115088
122,josefkarasek,45,0.03910,12884,11.19491,115088
123,Knium,45,0.03910,12929,11.23401,115088
124,sgerrand,45,0.03910,12974,11.27311,115088
125,studio3104,45,0.03910,13019,11.31221,115088
126,ahrtr,44,0.03823,13063,11.35044,115088
127,brissenden,44,0.03823,13107,11.38868,115088
128,imunew,44,0.03823,13151,11.42691,115088
129,kikusu,44,0.03823,13195,11.46514,115088
130,koooge,44,0.03823,13239,11.50337,115088
131,lingz,44,0.03823,13283,11.54160,115088
132,lingzhang-lyon,44,0.03823,13327,11.57983,115088
133,t-umeno,44,0.03823,13371,11.61807,115088
134,hiro-su,43,0.03736,13414,11.65543,115088
135,Jackyjjc,43,0.03736,13457,11.69279,115088
136,mamewotoko,43,0.03736,13500,11.73015,115088
137,NivLipetz,43,0.03736,13543,11.76752,115088
138,perrin4869,43,0.03736,13586,11.80488,115088
139,Songmu,43,0.03736,13629,11.84224,115088
140,adamenger,42,0.03649,13671,11.87874,115088
141,AkshayDubey29,42,0.03649,13713,11.91523,115088
142,hasjenL,42,0.03649,13755,11.95172,115088
143,kaecyra,42,0.03649,13797,11.98822,115088
144,khetman,42,0.03649,13839,12.02471,115088
145,adamchainz,41,0.03562,13880,12.06034,115088
146,ephemeralsnow,41,0.03562,13921,12.09596,115088
147,gcs-github,41,0.03562,13962,12.13159,115088
148,hovu96,41,0.03562,14003,12.16721,115088
149,ohsawa0515,41,0.03562,14044,12.20284,115088
150,papiveron,41,0.03562,14085,12.23846,115088
151,salekseev,41,0.03562,14126,12.27409,115088
152,ttanimichi,41,0.03562,14167,12.30971,115088
153,ansoni,40,0.03476,14207,12.34447,115088
154,bombela,40,0.03476,14247,12.37922,115088
155,gaddevijay,40,0.03476,14287,12.41398,115088
156,gozzip2009,40,0.03476,14327,12.44873,115088
157,HeartSaVioR,40,0.03476,14367,12.48349,115088
158,hrix,40,0.03476,14407,12.51825,115088
159,imnotjames,40,0.03476,14447,12.55300,115088
160,jkschulz,40,0.03476,14487,12.58776,115088
161,loveshell,40,0.03476,14527,12.62251,115088
162,moccos,40,0.03476,14567,12.65727,115088
163,samjsong,40,0.03476,14607,12.69203,115088
164,sebv,40,0.03476,14647,12.72678,115088
165,shirou,40,0.03476,14687,12.76154,115088
166,wbchn,40,0.03476,14727,12.79630,115088
167,dpgaspar,39,0.03389,14766,12.83018,115088
168,dsouzajude,39,0.03389,14805,12.86407,115088
169,elelement,39,0.03389,14844,12.89796,115088
170,reizist,39,0.03389,14883,12.93184,115088
171,s5o-c,39,0.03389,14922,12.96573,115088
172,chaeyk,38,0.03302,14960,12.99875,115088
173,iamhasibrahman,38,0.03302,14998,13.03177,115088
174,kumarappan-arumugam,38,0.03302,15036,13.06479,115088
175,pushm0v,38,0.03302,15074,13.09780,115088
176,scalp42,38,0.03302,15112,13.13082,115088
177,tdtds,38,0.03302,15150,13.16384,115088
178,tetuyosi,38,0.03302,15188,13.19686,115088
179,dtboctor,37,0.03215,15225,13.22901,115088
180,gihad,37,0.03215,15262,13.26116,115088
181,Gimi,37,0.03215,15299,13.29331,115088
182,niyonmaruz,37,0.03215,15336,13.32546,115088
183,shun0102,37,0.03215,15373,13.35760,115088
184,cmoad,36,0.03128,15409,13.38889,115088
185,Jitsusama,36,0.03128,15445,13.42017,115088
186,kenrota,36,0.03128,15481,13.45145,115088
187,marckamerbeek,36,0.03128,15517,13.48273,115088
188,Neozaru,36,0.03128,15553,13.51401,115088
189,sowawa,36,0.03128,15589,13.54529,115088
190,sradco,36,0.03128,15625,13.57657,115088
191,breath-co2,35,0.03041,15660,13.60698,115088
192,idohalevi,35,0.03041,15695,13.63739,115088
193,jeremywu0127,35,0.03041,15730,13.66780,115088
194,amitdhawan,34,0.02954,15764,13.69734,115088
195,bmcfeely,34,0.02954,15798,13.72689,115088
196,cw-kuoka,34,0.02954,15832,13.75643,115088
197,jeremysuriel,34,0.02954,15866,13.78597,115088
198,nozino,34,0.02954,15900,13.81552,115088
199,pli01,34,0.02954,15934,13.84506,115088
200,seanmdick,34,0.02954,15968,13.87460,115088
201,takyoshi,34,0.02954,16002,13.90414,115088
202,wesyao,34,0.02954,16036,13.93369,115088
203,yudai09,34,0.02954,16070,13.96323,115088
204,yuuna,34,0.02954,16104,13.99277,115088
205,anthonymorrisjohnson,33,0.02867,16137,14.02144,115088
206,edwin-lai,33,0.02867,16170,14.05012,115088
207,gyamxxx,33,0.02867,16203,14.07879,115088
208,saicologic,33,0.02867,16236,14.10747,115088
209,trevrosen,33,0.02867,16269,14.13614,115088
210,tsuyoshizawa,33,0.02867,16302,14.16481,115088
211,udzura,33,0.02867,16335,14.19349,115088
212,gonsuke,32,0.02780,16367,14.22129,115088
213,gpolaert,32,0.02780,16399,14.24910,115088
214,kantica,32,0.02780,16431,14.27690,115088
215,kyleboyer-optum,32,0.02780,16463,14.30471,115088
216,mpas,32,0.02780,16495,14.33251,115088
217,msftclas,32,0.02780,16527,14.36032,115088
218,my-dev,32,0.02780,16559,14.38812,115088
219,SNakano,32,0.02780,16591,14.41593,115088
220,vigyanik,32,0.02780,16623,14.44373,115088
221,willbarrett,32,0.02780,16655,14.47153,115088
222,funkymonkeymonk,31,0.02694,16686,14.49847,115088
223,GAHila,31,0.02694,16717,14.52541,115088
224,gregsymons,31,0.02694,16748,14.55234,115088
225,huanggze,31,0.02694,16779,14.57928,115088
226,kubihie,31,0.02694,16810,14.60621,115088
227,kvitajakub,31,0.02694,16841,14.63315,115088
228,reevoo-samuel,31,0.02694,16872,14.66009,115088
229,shinebayar-g,31,0.02694,16903,14.68702,115088
230,sxd,31,0.02694,16934,14.71396,115088
231,timstott,31,0.02694,16965,14.74089,115088
232,aerickson,30,0.02607,16995,14.76696,115088
233,andreasung,30,0.02607,17025,14.79303,115088
234,ginobiliwang,30,0.02607,17055,14.81909,115088
235,jitran,30,0.02607,17085,14.84516,115088
236,jvymazal,30,0.02607,17115,14.87123,115088
237,macdjord,30,0.02607,17145,14.89730,115088
238,se-m,30,0.02607,17175,14.92336,115088
239,sesame,30,0.02607,17205,14.94943,115088
240,toshitanian,30,0.02607,17235,14.97550,115088
241,xiejiangzhi,30,0.02607,17265,15.00156,115088
242,caseyvu,29,0.02520,17294,15.02676,115088
243,dwoo4dwoo,29,0.02520,17323,15.05196,115088
244,giosakti,29,0.02520,17352,15.07716,115088
245,Ilanak,29,0.02520,17381,15.10236,115088
246,jain108shubhamtbt,29,0.02520,17410,15.12755,115088
247,jespersoderlund,29,0.02520,17439,15.15275,115088
248,kaorimatz,29,0.02520,17468,15.17795,115088
249,msysyamamoto,29,0.02520,17497,15.20315,115088
250,NBParis,29,0.02520,17526,15.22835,115088
251,rmacian,29,0.02520,17555,15.25355,115088
252,scheuk,29,0.02520,17584,15.27874,115088
253,tatsu-yam,29,0.02520,17613,15.30394,115088
254,vichargrave,29,0.02520,17642,15.32914,115088
255,yechanpark,29,0.02520,17671,15.35434,115088
256,yteraoka,29,0.02520,17700,15.37954,115088
257,atkinsj,28,0.02433,17728,15.40386,115088
258,BentCoder,28,0.02433,17756,15.42819,115088
259,bokowski,28,0.02433,17784,15.45252,115088
260,cooldaemon,28,0.02433,17812,15.47685,115088
261,genkami,28,0.02433,17840,15.50118,115088
262,hassaku,28,0.02433,17868,15.52551,115088
263,salewski,28,0.02433,17896,15.54984,115088
264,slk244,28,0.02433,17924,15.57417,115088
265,yoshiso,28,0.02433,17952,15.59850,115088
266,derjohn,27,0.02346,17979,15.62196,115088
267,fahimeh2010,27,0.02346,18006,15.64542,115088
268,fragtom,27,0.02346,18033,15.66888,115088
269,newtoncorp,27,0.02346,18060,15.69234,115088
270,pokehanai,27,0.02346,18087,15.71580,115088
271,quasipedia,27,0.02346,18114,15.73926,115088
272,shibug,27,0.02346,18141,15.76272,115088
273,stanaka,27,0.02346,18168,15.78618,115088
274,uchann2,27,0.02346,18195,15.80964,115088
275,deepakarumugham,26,0.02259,18221,15.83223,115088
276,ernestas-vinted,26,0.02259,18247,15.85482,115088
277,jeesim2,26,0.02259,18273,15.87742,115088
278,jenningsloy318,26,0.02259,18299,15.90001,115088
279,ogibayashi,26,0.02259,18325,15.92260,115088
280,tksmd,26,0.02259,18351,15.94519,115088
281,t-osakada,26,0.02259,18377,15.96778,115088
282,vvm-broadsoft,26,0.02259,18403,15.99037,115088
283,westongcooper,26,0.02259,18429,16.01296,115088
284,Yanson,26,0.02259,18455,16.03556,115088
285,yuku-t,26,0.02259,18481,16.05815,115088
286,ZMMWMY,26,0.02259,18507,16.08074,115088
287,adorechic,25,0.02172,18532,16.10246,115088
288,ArunMj,25,0.02172,18557,16.12418,115088
289,astj,25,0.02172,18582,16.14591,115088
290,bai,25,0.02172,18607,16.16763,115088
291,ctippur,25,0.02172,18632,16.18935,115088
292,dxdung,25,0.02172,18657,16.21107,115088
293,gaogj,25,0.02172,18682,16.23280,115088
294,HackToHell,25,0.02172,18707,16.25452,115088
295,hari9973,25,0.02172,18732,16.27624,115088
296,jdoss,25,0.02172,18757,16.29796,115088
297,JiHyunSong,25,0.02172,18782,16.31969,115088
298,kadzuya,25,0.02172,18807,16.34141,115088
299,keyolk,25,0.02172,18832,16.36313,115088
300,linxuanwei,25,0.02172,18857,16.38485,115088
301,lukasmrtvy,25,0.02172,18882,16.40658,115088
302,pavgup,25,0.02172,18907,16.42830,115088
303,stanhu,25,0.02172,18932,16.45002,115088
304,stevenjm,25,0.02172,18957,16.47174,115088
305,sugilog,25,0.02172,18982,16.49347,115088
306,swalkowski,25,0.02172,19007,16.51519,115088
307,Theoooooo,25,0.02172,19032,16.53691,115088
308,AkashKrDutta,24,0.02085,19056,16.55776,115088
309,bcharboneauiherb,24,0.02085,19080,16.57862,115088
310,cherrot,24,0.02085,19104,16.59947,115088
311,geek876,24,0.02085,19128,16.62033,115088
312,Hearen,24,0.02085,19152,16.64118,115088
313,kz0817,24,0.02085,19176,16.66203,115088
314,lenfree,24,0.02085,19200,16.68289,115088
315,marcy-terui,24,0.02085,19224,16.70374,115088
316,Misterhex,24,0.02085,19248,16.72459,115088
317,nakc,24,0.02085,19272,16.74545,115088
318,nchaugen,24,0.02085,19296,16.76630,115088
319,r4ravi2008,24,0.02085,19320,16.78715,115088
320,shojikai,24,0.02085,19344,16.80801,115088
321,ymattw,24,0.02085,19368,16.82886,115088
322,zarqman,24,0.02085,19392,16.84972,115088
323,alexfridlyand,23,0.01998,19415,16.86970,115088
324,clamoriniere,23,0.01998,19438,16.88968,115088
325,cosmok,23,0.01998,19461,16.90967,115088
326,danmx,23,0.01998,19484,16.92965,115088
327,dobachi,23,0.01998,19507,16.94964,115088
328,dotwilbert,23,0.01998,19530,16.96962,115088
329,jamesgoodhouse,23,0.01998,19553,16.98961,115088
330,kaizen1,23,0.01998,19576,17.00959,115088
331,reube,23,0.01998,19599,17.02958,115088
332,scottbuettner,23,0.01998,19622,17.04956,115088
333,shingo78,23,0.01998,19645,17.06955,115088
334,static-max,23,0.01998,19668,17.08953,115088
335,tarata,23,0.01998,19691,17.10952,115088
336,tmtk75,23,0.01998,19714,17.12950,115088
337,ashishtilara,22,0.01912,19736,17.14862,115088
338,aSquare14,22,0.01912,19758,17.16773,115088
339,a-venture,22,0.01912,19780,17.18685,115088
340,dongxiao1198,22,0.01912,19802,17.20596,115088
341,haritamar,22,0.01912,19824,17.22508,115088
342,hiroakis,22,0.01912,19846,17.24420,115088
343,jcerjak,22,0.01912,19868,17.26331,115088
344,jordanfbrown,22,0.01912,19890,17.28243,115088
345,lagalbra,22,0.01912,19912,17.30154,115088
346,nataly87s,22,0.01912,19934,17.32066,115088
347,njam,22,0.01912,19956,17.33977,115088
348,nkiri,22,0.01912,19978,17.35889,115088
349,rzilleruelo,22,0.01912,20000,17.37801,115088
350,tomity,22,0.01912,20022,17.39712,115088
351,Verhaeg,22,0.01912,20044,17.41624,115088
352,wshihadeh,22,0.01912,20066,17.43535,115088
353,yifriday,22,0.01912,20088,17.45447,115088
354,a4t,21,0.01825,20109,17.47272,115088
355,arewoonenco,21,0.01825,20130,17.49096,115088
356,deathowl,21,0.01825,20151,17.50921,115088
357,desdic,21,0.01825,20172,17.52746,115088
358,elain,21,0.01825,20193,17.54570,115088
359,golgoth31,21,0.01825,20214,17.56395,115088
360,herohde,21,0.01825,20235,17.58220,115088
361,kei-q,21,0.01825,20256,17.60044,115088
362,michaelgruber,21,0.01825,20277,17.61869,115088
363,nantani,21,0.01825,20298,17.63694,115088
364,Ponyboy47,21,0.01825,20319,17.65519,115088
365,scumola,21,0.01825,20340,17.67343,115088
366,sergeyarl,21,0.01825,20361,17.69168,115088
367,theasp,21,0.01825,20382,17.70993,115088
368,trekdemo,21,0.01825,20403,17.72817,115088
369,utun001,21,0.01825,20424,17.74642,115088
370,waniji,21,0.01825,20445,17.76467,115088
371,blaggacao,20,0.01738,20465,17.78205,115088
372,cnorthwood,20,0.01738,20485,17.79942,115088
373,dpippenger,20,0.01738,20505,17.81680,115088
374,eadasiak,20,0.01738,20525,17.83418,115088
375,eadred,20,0.01738,20545,17.85156,115088
376,elaurendeau,20,0.01738,20565,17.86894,115088
377,emacski,20,0.01738,20585,17.88631,115088
378,FlorianVeaux,20,0.01738,20605,17.90369,115088
379,flowl,20,0.01738,20625,17.92107,115088
380,freedragon,20,0.01738,20645,17.93845,115088
381,gitfool,20,0.01738,20665,17.95583,115088
382,joshk0,20,0.01738,20685,17.97320,115088
383,knqyf263,20,0.01738,20705,17.99058,115088
384,koshigoe,20,0.01738,20725,18.00796,115088
385,ksandrmatveyev,20,0.01738,20745,18.02534,115088
386,lxfontes,20,0.01738,20765,18.04272,115088
387,photom,20,0.01738,20785,18.06009,115088
388,rram,20,0.01738,20805,18.07747,115088
389,tomohisaota,20,0.01738,20825,18.09485,115088
390,yyamano,20,0.01738,20845,18.11223,115088
391,cclien,19,0.01651,20864,18.12874,115088
392,dainiusjocas,19,0.01651,20883,18.14525,115088
393,dieend,19,0.01651,20902,18.16175,115088
394,doron327,19,0.01651,20921,18.17826,115088
395,doul59,19,0.01651,20940,18.19477,115088
396,five-iron,19,0.01651,20959,18.21128,115088
397,gunyarakun,19,0.01651,20978,18.22779,115088
398,inthemuse,19,0.01651,20997,18.24430,115088
399,jbarreneche,19,0.01651,21016,18.26081,115088
400,jbhilton11,19,0.01651,21035,18.27732,115088
401,jurgenhaas,19,0.01651,21054,18.29383,115088
402,kakalo24,19,0.01651,21073,18.31034,115088
403,kikumoto,19,0.01651,21092,18.32685,115088
404,korya,19,0.01651,21111,18.34335,115088
405,matthewmodestino,19,0.01651,21130,18.35986,115088
406,mohitevishal,19,0.01651,21149,18.37637,115088
407,mozamimy,19,0.01651,21168,18.39288,115088
408,mylen,19,0.01651,21187,18.40939,115088
409,nishi13,19,0.01651,21206,18.42590,115088
410,rw-hub,19,0.01651,21225,18.44241,115088
411,Seraf,19,0.01651,21244,18.45892,115088
412,shahbour,19,0.01651,21263,18.47543,115088
413,takanabe,19,0.01651,21282,18.49194,115088
414,wonderful60,19,0.01651,21301,18.50845,115088
415,yonchin,19,0.01651,21320,18.52495,115088
416,yusukeyamatani,19,0.01651,21339,18.54146,115088
417,zw963,19,0.01651,21358,18.55797,115088
418,aensidhe,18,0.01564,21376,18.57361,115088
419,bolek,18,0.01564,21394,18.58925,115088
420,cbh34680,18,0.01564,21412,18.60489,115088
421,emptywee,18,0.01564,21430,18.62053,115088
422,himmatb,18,0.01564,21448,18.63617,115088
423,h-michael-z,18,0.01564,21466,18.65181,115088
424,iwilltry42,18,0.01564,21484,18.66745,115088
425,Jorge-Rodriguez,18,0.01564,21502,18.68309,115088
426,jushiyuan,18,0.01564,21520,18.69873,115088
427,ljt2016,18,0.01564,21538,18.71438,115088
428,llhhbc,18,0.01564,21556,18.73002,115088
429,ma2shita,18,0.01564,21574,18.74566,115088
430,millar,18,0.01564,21592,18.76130,115088
431,m-mizutani,18,0.01564,21610,18.77694,115088
432,puneetpahuja,18,0.01564,21628,18.79258,115088
433,redmcg,18,0.01564,21646,18.80822,115088
434,sakuma,18,0.01564,21664,18.82386,115088
435,shyouhei,18,0.01564,21682,18.83950,115088
436,s-wool,18,0.01564,21700,18.85514,115088
437,TaLoN1x,18,0.01564,21718,18.87078,115088
438,tomas-zemres,18,0.01564,21736,18.88642,115088
439,tschroeder-zendesk,18,0.01564,21754,18.90206,115088
440,ValFadeev,18,0.01564,21772,18.91770,115088
441,wst-casd,18,0.01564,21790,18.93334,115088
442,2x-bullet-time,17,0.01477,21807,18.94811,115088
443,binarylogic,17,0.01477,21824,18.96288,115088
444,BlackNight95,17,0.01477,21841,18.97765,115088
445,bpsizemore,17,0.01477,21858,18.99242,115088
446,ctbucha,17,0.01477,21875,19.00719,115088
447,dkowis,17,0.01477,21892,19.02197,115088
448,dogweather,17,0.01477,21909,19.03674,115088
449,gabfl,17,0.01477,21926,19.05151,115088
450,hc-chien,17,0.01477,21943,19.06628,115088
451,itiut,17,0.01477,21960,19.08105,115088
452,jaygorrell,17,0.01477,21977,19.09582,115088
453,jmikula,17,0.01477,21994,19.11059,115088
454,jwestbrook,17,0.01477,22011,19.12536,115088
455,kohend,17,0.01477,22028,19.14014,115088
456,komal-SkyNET,17,0.01477,22045,19.15491,115088
457,KrzysztofKowalczyk,17,0.01477,22062,19.16968,115088
458,larte,17,0.01477,22079,19.18445,115088
459,liujiawinds,17,0.01477,22096,19.19922,115088
460,Marcussk,17,0.01477,22113,19.21399,115088
461,n0nick,17,0.01477,22130,19.22876,115088
462,nidcode,17,0.01477,22147,19.24354,115088
463,novegit,17,0.01477,22164,19.25831,115088
464,nysalor,17,0.01477,22181,19.27308,115088
465,onet-git,17,0.01477,22198,19.28785,115088
466,orasik,17,0.01477,22215,19.30262,115088
467,sandstrom,17,0.01477,22232,19.31739,115088
468,sohaibmaroof,17,0.01477,22249,19.33216,115088
469,south37,17,0.01477,22266,19.34693,115088
470,tarom,17,0.01477,22283,19.36171,115088
471,VAveryanov8,17,0.01477,22300,19.37648,115088
472,yuuzi41,17,0.01477,22317,19.39125,115088
473,zhaohangbo,17,0.01477,22334,19.40602,115088
474,zhron4x,17,0.01477,22351,19.42079,115088
475,adbl,16,0.01390,22367,19.43469,115088
476,alitoufighi,16,0.01390,22383,19.44860,115088
477,andreycizov,16,0.01390,22399,19.46250,115088
478,bbruun,16,0.01390,22415,19.47640,115088
479,brava-vinh,16,0.01390,22431,19.49030,115088
480,chrisleck,16,0.01390,22447,19.50421,115088
481,FraLarghi,16,0.01390,22463,19.51811,115088
482,gabe-sorensen,16,0.01390,22479,19.53201,115088
483,gabrielvelo,16,0.01390,22495,19.54591,115088
484,Git-Rajkumar,16,0.01390,22511,19.55982,115088
485,godric,16,0.01390,22527,19.57372,115088
486,hdiass,16,0.01390,22543,19.58762,115088
487,iaintshine,16,0.01390,22559,19.60152,115088
488,JackQuincy,16,0.01390,22575,19.61542,115088
489,jesk78,16,0.01390,22591,19.62933,115088
490,lukas-vlcek,16,0.01390,22607,19.64323,115088
491,markuman,16,0.01390,22623,19.65713,115088
492,martin21,16,0.01390,22639,19.67103,115088
493,mitchellmaler,16,0.01390,22655,19.68494,115088
494,mothershipper,16,0.01390,22671,19.69884,115088
495,mtakemi,16,0.01390,22687,19.71274,115088
496,nagachika,16,0.01390,22703,19.72664,115088
497,psykhi,16,0.01390,22719,19.74055,115088
498,randyh0329,16,0.01390,22735,19.75445,115088
499,sergei-utinski,16,0.01390,22751,19.76835,115088
500,shkhisti,16,0.01390,22767,19.78225,115088
501,silviupanaite,16,0.01390,22783,19.79616,115088
502,skuwa229,16,0.01390,22799,19.81006,115088
503,wd,16,0.01390,22815,19.82396,115088
504,wlbhiro,16,0.01390,22831,19.83786,115088
505,yarinm,16,0.01390,22847,19.85177,115088
506,yui-knk,16,0.01390,22863,19.86567,115088
507,alex-litvak,15,0.01303,22878,19.87870,115088
508,blarghmatey,15,0.01303,22893,19.89174,115088
509,craiggenner,15,0.01303,22908,19.90477,115088
510,dzavalkinolx,15,0.01303,22923,19.91780,115088
511,fabasoad,15,0.01303,22938,19.93084,115088
512,Fabian-K,15,0.01303,22953,19.94387,115088
513,felixzh2015,15,0.01303,22968,19.95690,115088
514,jesseolsen,15,0.01303,22983,19.96994,115088
515,j-o-s-h,15,0.01303,22998,19.98297,115088
516,julioct,15,0.01303,23013,19.99600,115088
517,kevinkirkup,15,0.01303,23028,20.00904,115088
518,Kuckkuck,15,0.01303,23043,20.02207,115088
519,masutaka,15,0.01303,23058,20.03510,115088
520,mohit-soral,15,0.01303,23073,20.04814,115088
521,MrMMorris,15,0.01303,23088,20.06117,115088
522,nabil-bouillin,15,0.01303,23103,20.07420,115088
523,olicuzo,15,0.01303,23118,20.08724,115088
524,radcool,15,0.01303,23133,20.10027,115088
525,ryan-dyer-sp,15,0.01303,23148,20.11330,115088
526,sambaiz,15,0.01303,23163,20.12634,115088
527,sankujain,15,0.01303,23178,20.13937,115088
528,tantra35,15,0.01303,23193,20.15241,115088
529,taoeffect,15,0.01303,23208,20.16544,115088
530,tech-mocha,15,0.01303,23223,20.17847,115088
531,trstringer,15,0.01303,23238,20.19151,115088
532,tsgan,15,0.01303,23253,20.20454,115088
533,wmotti,15,0.01303,23268,20.21757,115088
534,xncbf,15,0.01303,23283,20.23061,115088
535,ykf,15,0.01303,23298,20.24364,115088
536,zerthimon,15,0.01303,23313,20.25667,115088
537,899,14,0.01216,23327,20.26884,115088
538,andbuitra,14,0.01216,23341,20.28100,115088
539,arabustams,14,0.01216,23355,20.29317,115088
540,ash0080,14,0.01216,23369,20.30533,115088
541,attila123,14,0.01216,23383,20.31750,115088
542,baronomasia,14,0.01216,23397,20.32966,115088
543,bragi92,14,0.01216,23411,20.34183,115088
544,candlerb,14,0.01216,23425,20.35399,115088
545,cvuillemez,14,0.01216,23439,20.36615,115088
546,dennis-tra,14,0.01216,23453,20.37832,115088
547,dmgcodevil,14,0.01216,23467,20.39048,115088
548,edvakf,14,0.01216,23481,20.40265,115088
549,endhrk,14,0.01216,23495,20.41481,115088
550,ErebusBat,14,0.01216,23509,20.42698,115088
551,evmin,14,0.01216,23523,20.43914,115088
552,fabregas4you,14,0.01216,23537,20.45131,115088
553,Fl0rianH,14,0.01216,23551,20.46347,115088
554,ghicks-rmn,14,0.01216,23565,20.47564,115088
555,gjobin,14,0.01216,23579,20.48780,115088
556,gorilych,14,0.01216,23593,20.49997,115088
557,guilhermef,14,0.01216,23607,20.51213,115088
558,hjet,14,0.01216,23621,20.52429,115088
559,hochdorf,14,0.01216,23635,20.53646,115088
560,jlpettersson,14,0.01216,23649,20.54862,115088
561,john-dodson,14,0.01216,23663,20.56079,115088
562,johnjmaguire,14,0.01216,23677,20.57295,115088
563,logachev,14,0.01216,23691,20.58512,115088
564,mfornasa,14,0.01216,23705,20.59728,115088
565,mseka1,14,0.01216,23719,20.60945,115088
566,naiduarvind,14,0.01216,23733,20.62161,115088
567,nori3tsu,14,0.01216,23747,20.63378,115088
568,Nuru,14,0.01216,23761,20.64594,115088
569,phiremande,14,0.01216,23775,20.65811,115088
570,phstudy,14,0.01216,23789,20.67027,115088
571,prasenforu,14,0.01216,23803,20.68243,115088
572,primeroz,14,0.01216,23817,20.69460,115088
573,Quarky9,14,0.01216,23831,20.70676,115088
574,rvmiller89,14,0.01216,23845,20.71893,115088
575,scrwr,14,0.01216,23859,20.73109,115088
576,spatialvlad,14,0.01216,23873,20.74326,115088
577,StevTheDev,14,0.01216,23887,20.75542,115088
578,talonx,14,0.01216,23901,20.76759,115088
579,ted222,14,0.01216,23915,20.77975,115088
580,thorikiri,14,0.01216,23929,20.79192,115088
581,toebbel,14,0.01216,23943,20.80408,115088
582,tonymeng,14,0.01216,23957,20.81624,115088
583,wkruse,14,0.01216,23971,20.82841,115088
584,yubobo,14,0.01216,23985,20.84057,115088
585,yvesbd,14,0.01216,23999,20.85274,115088
586,alhails,13,0.01130,24012,20.86403,115088
587,amyth,13,0.01130,24025,20.87533,115088
588,andrews32,13,0.01130,24038,20.88663,115088
589,anthonyhaussman,13,0.01130,24051,20.89792,115088
590,bamb00,13,0.01130,24064,20.90922,115088
591,BananaWanted,13,0.01130,24077,20.92051,115088
592,banyan,13,0.01130,24090,20.93181,115088
593,bat9r,13,0.01130,24103,20.94310,115088
594,bidmath-gsulymosi,13,0.01130,24116,20.95440,115088
595,dave7373,13,0.01130,24129,20.96570,115088
596,discostur,13,0.01130,24142,20.97699,115088
597,dkuntz2,13,0.01130,24155,20.98829,115088
598,dlbarduzzi,13,0.01130,24168,20.99958,115088
599,ermaker,13,0.01130,24181,21.01088,115088
600,f0,13,0.01130,24194,21.02217,115088
601,gaetan-deputier,13,0.01130,24207,21.03347,115088
602,gitrc,13,0.01130,24220,21.04477,115088
603,hoozecn,13,0.01130,24233,21.05606,115088
604,jklap,13,0.01130,24246,21.06736,115088
605,josh-tepper,13,0.01130,24259,21.07865,115088
606,kaija,13,0.01130,24272,21.08995,115088
607,ken39arg,13,0.01130,24285,21.10124,115088
608,kenatbasis,13,0.01130,24298,21.11254,115088
609,k-hal,13,0.01130,24311,21.12384,115088
610,kikuchi-d,13,0.01130,24324,21.13513,115088
611,kyanagimoto,13,0.01130,24337,21.14643,115088
612,MaheshKReddy,13,0.01130,24350,21.15772,115088
613,mfowlewebs,13,0.01130,24363,21.16902,115088
614,mjourard,13,0.01130,24376,21.18031,115088
615,moodygit,13,0.01130,24389,21.19161,115088
616,nsaud01,13,0.01130,24402,21.20291,115088
617,ogontaro,13,0.01130,24415,21.21420,115088
618,olafnorge,13,0.01130,24428,21.22550,115088
619,pgrm,13,0.01130,24441,21.23679,115088
620,rubensmabueno,13,0.01130,24454,21.24809,115088
621,sasezaki,13,0.01130,24467,21.25938,115088
622,Sikwan,13,0.01130,24480,21.27068,115088
623,stachdude,13,0.01130,24493,21.28198,115088
624,summerwind,13,0.01130,24506,21.29327,115088
625,tanan,13,0.01130,24519,21.30457,115088
626,thinkerbot,13,0.01130,24532,21.31586,115088
627,torbjorn2000,13,0.01130,24545,21.32716,115088
628,toshihirock,13,0.01130,24558,21.33845,115088
629,tzmfreedom,13,0.01130,24571,21.34975,115088
630,urin,13,0.01130,24584,21.36105,115088
631,varun-da,13,0.01130,24597,21.37234,115088
632,vishnuvg1984,13,0.01130,24610,21.38364,115088
633,vixns,13,0.01130,24623,21.39493,115088
634,vvk,13,0.01130,24636,21.40623,115088
635,xia0pin9,13,0.01130,24649,21.41752,115088
636,yiwork,13,0.01130,24662,21.42882,115088
637,yoshida-mediba,13,0.01130,24675,21.44012,115088
638,yusufcan141,13,0.01130,24688,21.45141,115088
639,zuk,13,0.01130,24701,21.46271,115088
640,aclowkey,12,0.01043,24713,21.47313,115088
641,adiazgalache,12,0.01043,24725,21.48356,115088
642,adrianlzt,12,0.01043,24737,21.49399,115088
643,alikhil,12,0.01043,24749,21.50441,115088
644,alterx,12,0.01043,24761,21.51484,115088
645,AndrewChubatiuk,12,0.01043,24773,21.52527,115088
646,arpit-singhal,12,0.01043,24785,21.53569,115088
647,baskaran-md,12,0.01043,24797,21.54612,115088
648,bchew,12,0.01043,24809,21.55655,115088
649,benschwarz,12,0.01043,24821,21.56697,115088
650,berlincount,12,0.01043,24833,21.57740,115088
651,betazep,12,0.01043,24845,21.58783,115088
652,beth2016,12,0.01043,24857,21.59826,115088
653,bhavsi,12,0.01043,24869,21.60868,115088
654,CaDs,12,0.01043,24881,21.61911,115088
655,chaurwu,12,0.01043,24893,21.62954,115088
656,clarsen,12,0.01043,24905,21.63996,115088
657,dmamalis,12,0.01043,24917,21.65039,115088
658,DocX,12,0.01043,24929,21.66082,115088
659,donato,12,0.01043,24941,21.67124,115088
660,ecristea,12,0.01043,24953,21.68167,115088
661,elafontaine,12,0.01043,24965,21.69210,115088
662,eramuk,12,0.01043,24977,21.70252,115088
663,fangli,12,0.01043,24989,21.71295,115088
664,FearTheBadger,12,0.01043,25001,21.72338,115088
665,fhoy,12,0.01043,25013,21.73380,115088
666,flurreN,12,0.01043,25025,21.74423,115088
667,galanoff,12,0.01043,25037,21.75466,115088
668,gaui,12,0.01043,25049,21.76508,115088
669,georgegoh,12,0.01043,25061,21.77551,115088
670,GerryLon,12,0.01043,25073,21.78594,115088
671,girgen,12,0.01043,25085,21.79636,115088
672,gszadkow,12,0.01043,25097,21.80679,115088
673,iShiBin,12,0.01043,25109,21.81722,115088
674,JayTeli,12,0.01043,25121,21.82764,115088
675,jaywayjayway,12,0.01043,25133,21.83807,115088
676,jdrydn,12,0.01043,25145,21.84850,115088
677,jonapich,12,0.01043,25157,21.85893,115088
678,kmotrebski,12,0.01043,25169,21.86935,115088
679,konstantin-kornienko,12,0.01043,25181,21.87978,115088
680,larsf,12,0.01043,25193,21.89021,115088
681,mabsimms,12,0.01043,25205,21.90063,115088
682,mahdi-asadpour-rr,12,0.01043,25217,21.91106,115088
683,manuel220x,12,0.01043,25229,21.92149,115088
684,marktheunissen,12,0.01043,25241,21.93191,115088
685,MasahikoSawada,12,0.01043,25253,21.94234,115088
686,maxwellzdm,12,0.01043,25265,21.95277,115088
687,memorycraft,12,0.01043,25277,21.96319,115088
688,mpergament,12,0.01043,25289,21.97362,115088
689,myokoym,12,0.01043,25301,21.98405,115088
690,ndevvy,12,0.01043,25313,21.99447,115088
691,nhosoi,12,0.01043,25325,22.00490,115088
692,nicksabol,12,0.01043,25337,22.01533,115088
693,openbsod,12,0.01043,25349,22.02575,115088
694,orfah,12,0.01043,25361,22.03618,115088
695,osamunmun,12,0.01043,25373,22.04661,115088
696,osimmasgard,12,0.01043,25385,22.05703,115088
697,perchten,12,0.01043,25397,22.06746,115088
698,phaothu,12,0.01043,25409,22.07789,115088
699,Ranger-X,12,0.01043,25421,22.08832,115088
700,shavo007,12,0.01043,25433,22.09874,115088
701,shutaked,12,0.01043,25445,22.10917,115088
702,sredni,12,0.01043,25457,22.11960,115088
703,Thoro,12,0.01043,25469,22.13002,115088
704,tkimura,12,0.01043,25481,22.14045,115088
705,TrevorFoster,12,0.01043,25493,22.15088,115088
706,trongnhanbmt,12,0.01043,25505,22.16130,115088
707,vanke-renzhe,12,0.01043,25517,22.17173,115088
708,wangyuehong,12,0.01043,25529,22.18216,115088
709,wimnat,12,0.01043,25541,22.19258,115088
710,xjz19901211,12,0.01043,25553,22.20301,115088
711,ymurata,12,0.01043,25565,22.21344,115088
712,adam-hart,11,0.00956,25576,22.22299,115088
713,airtoxin,11,0.00956,25587,22.23255,115088
714,AKoetsier,11,0.00956,25598,22.24211,115088
715,akomic,11,0.00956,25609,22.25167,115088
716,alanyee,11,0.00956,25620,22.26123,115088
717,aldnav,11,0.00956,25631,22.27078,115088
718,ameyrk18,11,0.00956,25642,22.28034,115088
719,amread,11,0.00956,25653,22.28990,115088
720,annaborja,11,0.00956,25664,22.29946,115088
721,apu1111,11,0.00956,25675,22.30902,115088
722,austenLacy,11,0.00956,25686,22.31857,115088
723,awaage,11,0.00956,25697,22.32813,115088
724,ben-scully,11,0.00956,25708,22.33769,115088
725,benwh,11,0.00956,25719,22.34725,115088
726,black-roland,11,0.00956,25730,22.35681,115088
727,comtef,11,0.00956,25741,22.36636,115088
728,czerwingithub,11,0.00956,25752,22.37592,115088
729,daijiro,11,0.00956,25763,22.38548,115088
730,diclophis,11,0.00956,25774,22.39504,115088
731,eeddaann,11,0.00956,25785,22.40459,115088
732,efueger,11,0.00956,25796,22.41415,115088
733,eisuke,11,0.00956,25807,22.42371,115088
734,firegrass,11,0.00956,25818,22.43327,115088
735,fradee,11,0.00956,25829,22.44283,115088
736,gabrielduarte88,11,0.00956,25840,22.45238,115088
737,giammy2290,11,0.00956,25851,22.46194,115088
738,griff,11,0.00956,25862,22.47150,115088
739,hiepsikhokhao,11,0.00956,25873,22.48106,115088
740,hiloki0529,11,0.00956,25884,22.49062,115088
741,hkailantzis,11,0.00956,25895,22.50017,115088
742,houndci,11,0.00956,25906,22.50973,115088
743,imantung,11,0.00956,25917,22.51929,115088
744,INFINIDATA,11,0.00956,25928,22.52885,115088
745,jamesmmchugh,11,0.00956,25939,22.53841,115088
746,jezeniel,11,0.00956,25950,22.54796,115088
747,jmoseley,11,0.00956,25961,22.55752,115088
748,JoeOrtiz,11,0.00956,25972,22.56708,115088
749,jonmoter,11,0.00956,25983,22.57664,115088
750,joycechangeorg,11,0.00956,25994,22.58619,115088
751,kazunori279,11,0.00956,26005,22.59575,115088
752,khteh,11,0.00956,26016,22.60531,115088
753,kkniffin,11,0.00956,26027,22.61487,115088
754,kmkswamy,11,0.00956,26038,22.62443,115088
755,kvitali,11,0.00956,26049,22.63398,115088
756,MacoTasu,11,0.00956,26060,22.64354,115088
757,mariusgrigaitis,11,0.00956,26071,22.65310,115088
758,marksawersw,11,0.00956,26082,22.66266,115088
759,maxkochubey,11,0.00956,26093,22.67222,115088
760,mgartner,11,0.00956,26104,22.68177,115088
761,mightwork,11,0.00956,26115,22.69133,115088
762,mitsos1os,11,0.00956,26126,22.70089,115088
763,moaikids,11,0.00956,26137,22.71045,115088
764,mocyuto,11,0.00956,26148,22.72001,115088
765,nanaal,11,0.00956,26159,22.72956,115088
766,nel215,11,0.00956,26170,22.73912,115088
767,ntanh1,11,0.00956,26181,22.74868,115088
768,opklnm102,11,0.00956,26192,22.75824,115088
769,paihu,11,0.00956,26203,22.76780,115088
770,pentium10,11,0.00956,26214,22.77735,115088
771,PhilGrayson,11,0.00956,26225,22.78691,115088
772,raihanhbh,11,0.00956,26236,22.79647,115088
773,Renz2018,11,0.00956,26247,22.80603,115088
774,reversi-fun,11,0.00956,26258,22.81558,115088
775,robdiciuccio,11,0.00956,26269,22.82514,115088
776,rolele,11,0.00956,26280,22.83470,115088
777,sasasin,11,0.00956,26291,22.84426,115088
778,shawnbutts,11,0.00956,26302,22.85382,115088
779,shidokamo,11,0.00956,26313,22.86337,115088
780,SilverDragon135,11,0.00956,26324,22.87293,115088
781,simonasr,11,0.00956,26335,22.88249,115088
782,spackle0,11,0.00956,26346,22.89205,115088
783,szaharici,11,0.00956,26357,22.90161,115088
784,szhem,11,0.00956,26368,22.91116,115088
785,TamerDev,11,0.00956,26379,22.92072,115088
786,TetianaKuziaieva,11,0.00956,26390,22.93028,115088
787,tily,11,0.00956,26401,22.93984,115088
788,toddc-vmware,11,0.00956,26412,22.94940,115088
789,tommarute,11,0.00956,26423,22.95895,115088
790,turettn,11,0.00956,26434,22.96851,115088
791,ulandj,11,0.00956,26445,22.97807,115088
792,vdavidoff,11,0.00956,26456,22.98763,115088
793,VinkDong,11,0.00956,26467,22.99718,115088
794,vinzent,11,0.00956,26478,23.00674,115088
795,vlvasilev,11,0.00956,26489,23.01630,115088
796,voloyev,11,0.00956,26500,23.02586,115088
797,wangzhuzhen,11,0.00956,26511,23.03542,115088
798,wejick,11,0.00956,26522,23.04497,115088
799,withsmilo,11,0.00956,26533,23.05453,115088
800,wtan825,11,0.00956,26544,23.06409,115088
801,Yuji-Yamamoto-Recruit,11,0.00956,26555,23.07365,115088
802,adambom,10,0.00869,26565,23.08234,115088
803,adrianchifor,10,0.00869,26575,23.09103,115088
804,afking,10,0.00869,26585,23.09972,115088
805,amattn,10,0.00869,26595,23.10840,115088
806,arrowfeng,10,0.00869,26605,23.11709,115088
807,asafpelegcodes,10,0.00869,26615,23.12578,115088
808,benkap,10,0.00869,26625,23.13447,115088
809,beorc,10,0.00869,26635,23.14316,115088
810,ccheek21,10,0.00869,26645,23.15185,115088
811,chrisrecalis,10,0.00869,26655,23.16054,115088
812,cve-reporting,10,0.00869,26665,23.16923,115088
813,darek-dymek-i,10,0.00869,26675,23.17792,115088
814,dblN,10,0.00869,26685,23.18661,115088
815,digikin,10,0.00869,26695,23.19529,115088
816,dsbrng25b,10,0.00869,26705,23.20398,115088
817,eredding-rmn,10,0.00869,26715,23.21267,115088
818,ernestas-poskus,10,0.00869,26725,23.22136,115088
819,EthanLiou,10,0.00869,26735,23.23005,115088
820,filippovdenis,10,0.00869,26745,23.23874,115088
821,ggaall,10,0.00869,26755,23.24743,115088
822,gshively11,10,0.00869,26765,23.25612,115088
823,hikouki,10,0.00869,26775,23.26481,115088
824,IssuehuntBot,10,0.00869,26785,23.27350,115088
825,jakeswenson,10,0.00869,26795,23.28218,115088
826,jamessantos10,10,0.00869,26805,23.29087,115088
827,JavaCS3,10,0.00869,26815,23.29956,115088
828,jchannon,10,0.00869,26825,23.30825,115088
829,jdrago999,10,0.00869,26835,23.31694,115088
830,JohnStarich,10,0.00869,26845,23.32563,115088
831,jpraet,10,0.00869,26855,23.33432,115088
832,jrthrawny,10,0.00869,26865,23.34301,115088
833,jstaffans,10,0.00869,26875,23.35170,115088
834,k24d,10,0.00869,26885,23.36039,115088
835,kdabir,10,0.00869,26895,23.36907,115088
836,kosuke-hida,10,0.00869,26905,23.37776,115088
837,Lawouach,10,0.00869,26915,23.38645,115088
838,lobeck,10,0.00869,26925,23.39514,115088
839,loz,10,0.00869,26935,23.40383,115088
840,manicminer,10,0.00869,26945,23.41252,115088
841,mareban,10,0.00869,26955,23.42121,115088
842,martin308,10,0.00869,26965,23.42990,115088
843,MatteoMori,10,0.00869,26975,23.43859,115088
844,Maxpain177,10,0.00869,26985,23.44728,115088
845,mchesler,10,0.00869,26995,23.45596,115088
846,mhf-ir,10,0.00869,27005,23.46465,115088
847,michi-covalent,10,0.00869,27015,23.47334,115088
848,mohitkhanna,10,0.00869,27025,23.48203,115088
849,moleskin-smile,10,0.00869,27035,23.49072,115088
850,munangst,10,0.00869,27045,23.49941,115088
851,naomichi-y,10,0.00869,27055,23.50810,115088
852,navstev0,10,0.00869,27065,23.51679,115088
853,ninadpage,10,0.00869,27075,23.52548,115088
854,nraddy,10,0.00869,27085,23.53417,115088
855,nritholtz,10,0.00869,27095,23.54285,115088
856,ofirnn,10,0.00869,27105,23.55154,115088
857,pbenefice,10,0.00869,27115,23.56023,115088
858,phendryx,10,0.00869,27125,23.56892,115088
859,pirasakat,10,0.00869,27135,23.57761,115088
860,porkbeans,10,0.00869,27145,23.58630,115088
861,pyama86,10,0.00869,27155,23.59499,115088
862,ramyala,10,0.00869,27165,23.60368,115088
863,robertfirek,10,0.00869,27175,23.61237,115088
864,rootd00d,10,0.00869,27185,23.62106,115088
865,salilgupta1,10,0.00869,27195,23.62974,115088
866,seratch,10,0.00869,27205,23.63843,115088
867,shii-take,10,0.00869,27215,23.64712,115088
868,shivpathak,10,0.00869,27225,23.65581,115088
869,shou10152208,10,0.00869,27235,23.66450,115088
870,sphansekar-cci,10,0.00869,27245,23.67319,115088
871,tobio,10,0.00869,27255,23.68188,115088
872,ton31337,10,0.00869,27265,23.69057,115088
873,ualtinok,10,0.00869,27275,23.69926,115088
874,ulfurinn,10,0.00869,27285,23.70795,115088
875,uohzxela,10,0.00869,27295,23.71663,115088
876,vatine,10,0.00869,27305,23.72532,115088
877,wittenst,10,0.00869,27315,23.73401,115088
878,yanrong1990,10,0.00869,27325,23.74270,115088
879,yeruvass,10,0.00869,27335,23.75139,115088
880,Zaki-XL,10,0.00869,27345,23.76008,115088
881,zffocussss,10,0.00869,27355,23.76877,115088
882,zmmille2,10,0.00869,27365,23.77746,115088
883,AlexSc,9,0.00782,27374,23.78528,115088
884,amagnus,9,0.00782,27383,23.79310,115088
885,asteen-nexcess,9,0.00782,27392,23.80092,115088
886,atfujiwara,9,0.00782,27401,23.80874,115088
887,bacoboy,9,0.00782,27410,23.81656,115088
888,barrytam20,9,0.00782,27419,23.82438,115088
889,bernii,9,0.00782,27428,23.83220,115088
890,blemale,9,0.00782,27437,23.84002,115088
891,bobykus31,9,0.00782,27446,23.84784,115088
892,bpesics,9,0.00782,27455,23.85566,115088
893,Brandl,9,0.00782,27464,23.86348,115088
894,bryntruscott,9,0.00782,27473,23.87130,115088
895,bwnyasse,9,0.00782,27482,23.87912,115088
896,cdaringe,9,0.00782,27491,23.88694,115088
897,cdwertmann,9,0.00782,27500,23.89476,115088
898,ceecko,9,0.00782,27509,23.90258,115088
899,cmarodrigues,9,0.00782,27518,23.91040,115088
900,DanKans,9,0.00782,27527,23.91822,115088
901,dataviruset,9,0.00782,27536,23.92604,115088
902,dcheney-atlassian,9,0.00782,27545,23.93386,115088
903,dgc-wh,9,0.00782,27554,23.94168,115088
904,dougneal,9,0.00782,27563,23.94950,115088
905,dsapala,9,0.00782,27572,23.95732,115088
906,elfring,9,0.00782,27581,23.96514,115088
907,emalihin,9,0.00782,27590,23.97296,115088
908,Ewocker,9,0.00782,27599,23.98078,115088
909,ezean21,9,0.00782,27608,23.98860,115088
910,farmermel,9,0.00782,27617,23.99642,115088
911,FeiYao,9,0.00782,27626,24.00424,115088
912,ferminromero,9,0.00782,27635,24.01206,115088
913,fgreinacher,9,0.00782,27644,24.01988,115088
914,fleischer932,9,0.00782,27653,24.02770,115088
915,Gabedlm,9,0.00782,27662,24.03552,115088
916,GaoyangWang,9,0.00782,27671,24.04334,115088
917,garysmith-github,9,0.00782,27680,24.05116,115088
918,gerhard-strauss,9,0.00782,27689,24.05898,115088
919,hassanfarid,9,0.00782,27698,24.06680,115088
920,hexecute,9,0.00782,27707,24.07462,115088
921,hiscal2015,9,0.00782,27716,24.08244,115088
922,hkarasek,9,0.00782,27725,24.09026,115088
923,hmac,9,0.00782,27734,24.09808,115088
924,icalvete,9,0.00782,27743,24.10590,115088
925,igal-stratoscale,9,0.00782,27752,24.11372,115088
926,iyuuya,9,0.00782,27761,24.12154,115088
927,jaisharma0009,9,0.00782,27770,24.12936,115088
928,jankeirse,9,0.00782,27779,24.13718,115088
929,japzio,9,0.00782,27788,24.14500,115088
930,jdevalk2,9,0.00782,27797,24.15282,115088
931,jiaqianjing,9,0.00782,27806,24.16064,115088
932,jleinfors,9,0.00782,27815,24.16846,115088
933,jmmgr,9,0.00782,27824,24.17628,115088
934,joechromo,9,0.00782,27833,24.18410,115088
935,jomach,9,0.00782,27842,24.19192,115088
936,jonmchan,9,0.00782,27851,24.19974,115088
937,jperkelens,9,0.00782,27860,24.20756,115088
938,jpgonzalez1985,9,0.00782,27869,24.21538,115088
939,jseely,9,0.00782,27878,24.22320,115088
940,jwyjoy,9,0.00782,27887,24.23102,115088
941,kam1sh,9,0.00782,27896,24.23884,115088
942,keithjohnhowe,9,0.00782,27905,24.24666,115088
943,keperry,9,0.00782,27914,24.25448,115088
944,kiddingl,9,0.00782,27923,24.26230,115088
945,kpmbro,9,0.00782,27932,24.27012,115088
946,ksss,9,0.00782,27941,24.27794,115088
947,kyleroot,9,0.00782,27950,24.28576,115088
948,langzi-zmg,9,0.00782,27959,24.29358,115088
949,linbingdouzhe,9,0.00782,27968,24.30140,115088
950,lixianyang,9,0.00782,27977,24.30922,115088
951,lp060,9,0.00782,27986,24.31704,115088
952,lyiase,9,0.00782,27995,24.32486,115088
953,Ma-Dan,9,0.00782,28004,24.33268,115088
954,maglun2,9,0.00782,28013,24.34050,115088
955,maoyuanh,9,0.00782,28022,24.34832,115088
956,martinhynar,9,0.00782,28031,24.35614,115088
957,mazeika,9,0.00782,28040,24.36396,115088
958,mbolek,9,0.00782,28049,24.37179,115088
959,metheglin,9,0.00782,28058,24.37961,115088
960,mew109,9,0.00782,28067,24.38743,115088
961,mightyguava,9,0.00782,28076,24.39525,115088
962,mobilesfinks,9,0.00782,28085,24.40307,115088
963,mohitanchlia,9,0.00782,28094,24.41089,115088
964,msproact,9,0.00782,28103,24.41871,115088
965,neguse,9,0.00782,28112,24.42653,115088
966,ngotim,9,0.00782,28121,24.43435,115088
967,nicofff,9,0.00782,28130,24.44217,115088
968,nnovikov,9,0.00782,28139,24.44999,115088
969,nreddy67,9,0.00782,28148,24.45781,115088
970,onurbaran,9,0.00782,28157,24.46563,115088
971,osela,9,0.00782,28166,24.47345,115088
972,peter-moffatt,9,0.00782,28175,24.48127,115088
973,Phrozyn,9,0.00782,28184,24.48909,115088
974,prashant407,9,0.00782,28193,24.49691,115088
975,quaelin,9,0.00782,28202,24.50473,115088
976,rahul007ashok,9,0.00782,28211,24.51255,115088
977,rahulwa,9,0.00782,28220,24.52037,115088
978,rakvat,9,0.00782,28229,24.52819,115088
979,renaudboutet,9,0.00782,28238,24.53601,115088
980,robbwagoner,9,0.00782,28247,24.54383,115088
981,scuzhanglei,9,0.00782,28256,24.55165,115088
982,seii-saintway,9,0.00782,28265,24.55947,115088
983,sett4,9,0.00782,28274,24.56729,115088
984,singhravi1,9,0.00782,28283,24.57511,115088
985,sivaparams,9,0.00782,28292,24.58293,115088
986,skwp,9,0.00782,28301,24.59075,115088
987,smallcreep,9,0.00782,28310,24.59857,115088
988,soultemple,9,0.00782,28319,24.60639,115088
989,spacewander,9,0.00782,28328,24.61421,115088
990,superdump,9,0.00782,28337,24.62203,115088
991,syst0m,9,0.00782,28346,24.62985,115088
992,tbrosman,9,0.00782,28355,24.63767,115088
993,tchelovilar,9,0.00782,28364,24.64549,115088
994,tetsusat,9,0.00782,28373,24.65331,115088
995,TheRealDwright,9,0.00782,28382,24.66113,115088
996,tjamet,9,0.00782,28391,24.66895,115088
997,tmatsuo,9,0.00782,28400,24.67677,115088
998,toan-hf,9,0.00782,28409,24.68459,115088
999,tobiasmuehl,9,0.00782,28418,24.69241,115088
1000,travail,9,0.00782,28427,24.70023,115088
1001,traxo-xx,9,0.00782,28436,24.70805,115088
1002,TrickyMonkey,9,0.00782,28445,24.71587,115088
1003,unquietwiki,9,0.00782,28454,24.72369,115088
1004,vaibhavt19,9,0.00782,28463,24.73151,115088
1005,wizpra-koyasu,9,0.00782,28472,24.73933,115088
1006,xxwassyxx,9,0.00782,28481,24.74715,115088
1007,zette,9,0.00782,28490,24.75497,115088
1008,zhulinwei,9,0.00782,28499,24.76279,115088
1009,zozzz,9,0.00782,28508,24.77061,115088
1010,zs787,9,0.00782,28517,24.77843,115088
1011,aarunkushwahaa,8,0.00695,28525,24.78538,115088
1012,aeber,8,0.00695,28533,24.79233,115088
1013,afshinm,8,0.00695,28541,24.79928,115088
1014,akiraimafuji,8,0.00695,28549,24.80624,115088
1015,andreaslang,8,0.00695,28557,24.81319,115088
1016,anphung,8,0.00695,28565,24.82014,115088
1017,anupamkamal01,8,0.00695,28573,24.82709,115088
1018,aperigault,8,0.00695,28581,24.83404,115088
1019,aplsms,8,0.00695,28589,24.84099,115088
1020,apollo13,8,0.00695,28597,24.84794,115088
1021,armchairlinguist,8,0.00695,28605,24.85489,115088
1022,Arvon2014,8,0.00695,28613,24.86184,115088
1023,authorNari,8,0.00695,28621,24.86880,115088
1024,ayenter,8,0.00695,28629,24.87575,115088
1025,azrle,8,0.00695,28637,24.88270,115088
1026,bernhardttom,8,0.00695,28645,24.88965,115088
1027,bigwheel,8,0.00695,28653,24.89660,115088
1028,bizlevel,8,0.00695,28661,24.90355,115088
1029,bmandrade,8,0.00695,28669,24.91050,115088
1030,bsnisar,8,0.00695,28677,24.91745,115088
1031,btucker,8,0.00695,28685,24.92441,115088
1032,carlos-montiers,8,0.00695,28693,24.93136,115088
1033,Charith32,8,0.00695,28701,24.93831,115088
1034,charlesnagy,8,0.00695,28709,24.94526,115088
1035,cynipe,8,0.00695,28717,24.95221,115088
1036,danielward,8,0.00695,28725,24.95916,115088
1037,datawrangl3r,8,0.00695,28733,24.96611,115088
1038,dhalai,8,0.00695,28741,24.97306,115088
1039,dperetti,8,0.00695,28749,24.98002,115088
1040,eddycharly,8,0.00695,28757,24.98697,115088
1041,edude03,8,0.00695,28765,24.99392,115088
1042,eldargab,8,0.00695,28773,25.00087,115088
1043,emillg,8,0.00695,28781,25.00782,115088
1044,Engerim,8,0.00695,28789,25.01477,115088
1045,ferbar,8,0.00695,28797,25.02172,115088
1046,fetaro,8,0.00695,28805,25.02867,115088
1047,fmax,8,0.00695,28813,25.03562,115088
1048,fwojciak,8,0.00695,28821,25.04258,115088
1049,Gabriel1688,8,0.00695,28829,25.04953,115088
1050,gcaracuel,8,0.00695,28837,25.05648,115088
1051,george-angel,8,0.00695,28845,25.06343,115088
1052,geosone,8,0.00695,28853,25.07038,115088
1053,gom,8,0.00695,28861,25.07733,115088
1054,hajimeni,8,0.00695,28869,25.08428,115088
1055,heidemn,8,0.00695,28877,25.09123,115088
1056,hlakshmi,8,0.00695,28885,25.09819,115088
1057,hlx98007,8,0.00695,28893,25.10514,115088
1058,hobbsh,8,0.00695,28901,25.11209,115088
1059,homer6,8,0.00695,28909,25.11904,115088
1060,hustshawn,8,0.00695,28917,25.12599,115088
1061,ibrasec,8,0.00695,28925,25.13294,115088
1062,igortin,8,0.00695,28933,25.13989,115088
1063,Indrius,8,0.00695,28941,25.14684,115088
1064,iwasakims,8,0.00695,28949,25.15380,115088
1065,ixai,8,0.00695,28957,25.16075,115088
1066,jakubbujny,8,0.00695,28965,25.16770,115088
1067,jeffsink,8,0.00695,28973,25.17465,115088
1068,jgehrcke,8,0.00695,28981,25.18160,115088
1069,jottos,8,0.00695,28989,25.18855,115088
1070,kakakakakku,8,0.00695,28997,25.19550,115088
1071,kamalama,8,0.00695,29005,25.20245,115088
1072,kamirendawkins,8,0.00695,29013,25.20940,115088
1073,kavu,8,0.00695,29021,25.21636,115088
1074,kazuki1213,8,0.00695,29029,25.22331,115088
1075,keir-rex,8,0.00695,29037,25.23026,115088
1076,krrrr38,8,0.00695,29045,25.23721,115088
1077,kumudt,8,0.00695,29053,25.24416,115088
1078,kvidhya,8,0.00695,29061,25.25111,115088
1079,LanceNorskog,8,0.00695,29069,25.25806,115088
1080,LarryLo,8,0.00695,29077,25.26501,115088
1081,lktslionel,8,0.00695,29085,25.27197,115088
1082,mananyuki,8,0.00695,29093,25.27892,115088
1083,maplebed,8,0.00695,29101,25.28587,115088
1084,martin-ducar-gd,8,0.00695,29109,25.29282,115088
1085,MartinHerrman,8,0.00695,29117,25.29977,115088
1086,matsuzj,8,0.00695,29125,25.30672,115088
1087,mattbillenstein,8,0.00695,29133,25.31367,115088
1088,mbenabda,8,0.00695,29141,25.32062,115088
1089,megamk,8,0.00695,29149,25.32758,115088
1090,meggarr,8,0.00695,29157,25.33453,115088
1091,metal-hed,8,0.00695,29165,25.34148,115088
1092,mhrabovcin,8,0.00695,29173,25.34843,115088
1093,michaeltravisuk,8,0.00695,29181,25.35538,115088
1094,MingqingLi,8,0.00695,29189,25.36233,115088
1095,mojoTX,8,0.00695,29197,25.36928,115088
1096,mortenk,8,0.00695,29205,25.37623,115088
1097,mrkurt,8,0.00695,29213,25.38319,115088
1098,musaprg,8,0.00695,29221,25.39014,115088
1099,mwpeterson,8,0.00695,29229,25.39709,115088
1100,nathanhruby,8,0.00695,29237,25.40404,115088
1101,Nepoxx,8,0.00695,29245,25.41099,115088
1102,nevill,8,0.00695,29253,25.41794,115088
1103,ngiallelis,8,0.00695,29261,25.42489,115088
1104,NicholasK13,8,0.00695,29269,25.43184,115088
1105,notmaxx,8,0.00695,29277,25.43879,115088
1106,nvanheuverzwijn,8,0.00695,29285,25.44575,115088
1107,okumin,8,0.00695,29293,25.45270,115088
1108,ota42y,8,0.00695,29301,25.45965,115088
1109,pangxudong,8,0.00695,29309,25.46660,115088
1110,pappnase99,8,0.00695,29317,25.47355,115088
1111,patrikbeno,8,0.00695,29325,25.48050,115088
1112,pef-secure,8,0.00695,29333,25.48745,115088
1113,petertornyi,8,0.00695,29341,25.49440,115088
1114,phagunbaya,8,0.00695,29349,25.50136,115088
1115,pierce300,8,0.00695,29357,25.50831,115088
1116,pjaitken,8,0.00695,29365,25.51526,115088
1117,plinkable,8,0.00695,29373,25.52221,115088
1118,polidog,8,0.00695,29381,25.52916,115088
1119,precs-sasaki,8,0.00695,29389,25.53611,115088
1120,ramiayoub-priv,8,0.00695,29397,25.54306,115088
1121,rashidng,8,0.00695,29405,25.55001,115088
1122,reinerRubin,8,0.00695,29413,25.55697,115088
1123,reireias,8,0.00695,29421,25.56392,115088
1124,rtartler-desres,8,0.00695,29429,25.57087,115088
1125,rudolf-focuscura,8,0.00695,29437,25.57782,115088
1126,ryanjjung,8,0.00695,29445,25.58477,115088
1127,samitpal,8,0.00695,29453,25.59172,115088
1128,sebastianmacarescu,8,0.00695,29461,25.59867,115088
1129,seikai,8,0.00695,29469,25.60562,115088
1130,sharmmoh1983,8,0.00695,29477,25.61257,115088
1131,shivaken,8,0.00695,29485,25.61953,115088
1132,sjoeboo,8,0.00695,29493,25.62648,115088
1133,sysword,8,0.00695,29501,25.63343,115088
1134,tako774,8,0.00695,29509,25.64038,115088
1135,terev,8,0.00695,29517,25.64733,115088
1136,Tesseract242,8,0.00695,29525,25.65428,115088
1137,thodquach,8,0.00695,29533,25.66123,115088
1138,tiagodeoliveira,8,0.00695,29541,25.66818,115088
1139,tiwakawa,8,0.00695,29549,25.67514,115088
1140,tmshn,8,0.00695,29557,25.68209,115088
1141,Tom-Fawcett,8,0.00695,29565,25.68904,115088
1142,tsingakbar,8,0.00695,29573,25.69599,115088
1143,turbotankist,8,0.00695,29581,25.70294,115088
1144,tyronedougherty,8,0.00695,29589,25.70989,115088
1145,vguaglione,8,0.00695,29597,25.71684,115088
1146,vide,8,0.00695,29605,25.72379,115088
1147,vitalvas,8,0.00695,29613,25.73075,115088
1148,woostundy,8,0.00695,29621,25.73770,115088
1149,xanonid,8,0.00695,29629,25.74465,115088
1150,yangmillstheory,8,0.00695,29637,25.75160,115088
1151,yohei1126,8,0.00695,29645,25.75855,115088
1152,yugunji,8,0.00695,29653,25.76550,115088
1153,zenglian,8,0.00695,29661,25.77245,115088
1154,zgolus,8,0.00695,29669,25.77940,115088
1155,zhelyan,8,0.00695,29677,25.78635,115088
1156,zsoltf,8,0.00695,29685,25.79331,115088
1157,4hiziri,7,0.00608,29692,25.79939,115088
1158,advidi-alex,7,0.00608,29699,25.80547,115088
1159,ajthenewguy,7,0.00608,29706,25.81155,115088
1160,ajturner,7,0.00608,29713,25.81764,115088
1161,akuchins,7,0.00608,29720,25.82372,115088
1162,allantin,7,0.00608,29727,25.82980,115088
1163,alsmith,7,0.00608,29734,25.83588,115088
1164,amatellanes,7,0.00608,29741,25.84196,115088
1165,amphibithen,7,0.00608,29748,25.84805,115088
1166,andye2004,7,0.00608,29755,25.85413,115088
1167,ap4y,7,0.00608,29762,25.86021,115088
1168,ara-ta3,7,0.00608,29769,25.86629,115088
1169,ashutoshdhundhara,7,0.00608,29776,25.87238,115088
1170,avikam,7,0.00608,29783,25.87846,115088
1171,azman0101,7,0.00608,29790,25.88454,115088
1172,bappr,7,0.00608,29797,25.89062,115088
1173,Barbazoo,7,0.00608,29804,25.89671,115088
1174,BDuelz,7,0.00608,29811,25.90279,115088
1175,bhperry,7,0.00608,29818,25.90887,115088
1176,bohyn,7,0.00608,29825,25.91495,115088
1177,cabiad,7,0.00608,29832,25.92103,115088
1178,Caiyeon,7,0.00608,29839,25.92712,115088
1179,calinah,7,0.00608,29846,25.93320,115088
1180,cccdemon,7,0.00608,29853,25.93928,115088
1181,chetan-happyness,7,0.00608,29860,25.94536,115088
1182,chicken231,7,0.00608,29867,25.95145,115088
1183,ChSch3000,7,0.00608,29874,25.95753,115088
1184,cl0udf0x,7,0.00608,29881,25.96361,115088
1185,Coac,7,0.00608,29888,25.96969,115088
1186,craibuc,7,0.00608,29895,25.97578,115088
1187,dgrala,7,0.00608,29902,25.98186,115088
1188,disigma,7,0.00608,29909,25.98794,115088
1189,do-aki,7,0.00608,29916,25.99402,115088
1190,dominique-pfister,7,0.00608,29923,26.00010,115088
1191,dpatekar,7,0.00608,29930,26.00619,115088
1192,drughi,7,0.00608,29937,26.01227,115088
1193,dshmatov,7,0.00608,29944,26.01835,115088
1194,dtmistry,7,0.00608,29951,26.02443,115088
1195,eakarsu,7,0.00608,29958,26.03052,115088
1196,eastlondoner,7,0.00608,29965,26.03660,115088
1197,eredi93,7,0.00608,29972,26.04268,115088
1198,EricFortin,7,0.00608,29979,26.04876,115088
1199,Erouan50,7,0.00608,29986,26.05484,115088
1200,et304383,7,0.00608,29993,26.06093,115088
1201,Falconxx,7,0.00608,30000,26.06701,115088
1202,fogine,7,0.00608,30007,26.07309,115088
1203,foxracle,7,0.00608,30014,26.07917,115088
1204,g3kr,7,0.00608,30021,26.08526,115088
1205,gamunu,7,0.00608,30028,26.09134,115088
1206,GodofGurus,7,0.00608,30035,26.09742,115088
1207,HansMeijer-AvidentIT,7,0.00608,30042,26.10350,115088
1208,harikum,7,0.00608,30049,26.10959,115088
1209,hatfarm,7,0.00608,30056,26.11567,115088
1210,heartrobotninja,7,0.00608,30063,26.12175,115088
1211,henrich,7,0.00608,30070,26.12783,115088
1212,henriklb,7,0.00608,30077,26.13391,115088
1213,herby,7,0.00608,30084,26.14000,115088
1214,hiraro,7,0.00608,30091,26.14608,115088
1215,hjdr4,7,0.00608,30098,26.15216,115088
1216,hokuts,7,0.00608,30105,26.15824,115088
1217,hyserver,7,0.00608,30112,26.16433,115088
1218,icio,7,0.00608,30119,26.17041,115088
1219,icpenguins,7,0.00608,30126,26.17649,115088
1220,ilyakam,7,0.00608,30133,26.18257,115088
1221,intelliguy,7,0.00608,30140,26.18866,115088
1222,itchyny,7,0.00608,30147,26.19474,115088
1223,jicong,7,0.00608,30154,26.20082,115088
1224,johan-g,7,0.00608,30161,26.20690,115088
1225,keitap,7,0.00608,30168,26.21298,115088
1226,ken1ma,7,0.00608,30175,26.21907,115088
1227,koid,7,0.00608,30182,26.22515,115088
1228,komeda-shinji,7,0.00608,30189,26.23123,115088
1229,kureikain,7,0.00608,30196,26.23731,115088
1230,kyu999,7,0.00608,30203,26.24340,115088
1231,l-53,7,0.00608,30210,26.24948,115088
1232,lee2014,7,0.00608,30217,26.25556,115088
1233,lht,7,0.00608,30224,26.26164,115088
1234,limitusus,7,0.00608,30231,26.26773,115088
1235,ljou,7,0.00608,30238,26.27381,115088
1236,M22an,7,0.00608,30245,26.27989,115088
1237,macavity23,7,0.00608,30252,26.28597,115088
1238,marcofranssen,7,0.00608,30259,26.29205,115088
1239,mariomarin,7,0.00608,30266,26.29814,115088
1240,MasayukiKiyota,7,0.00608,30273,26.30422,115088
1241,mattk42,7,0.00608,30280,26.31030,115088
1242,mazerty,7,0.00608,30287,26.31638,115088
1243,megamorf,7,0.00608,30294,26.32247,115088
1244,mentalblock,7,0.00608,30301,26.32855,115088
1245,meveno,7,0.00608,30308,26.33463,115088
1246,micdah,7,0.00608,30315,26.34071,115088
1247,michaelcrunch,7,0.00608,30322,26.34680,115088
1248,miguelortize,7,0.00608,30329,26.35288,115088
1249,mikeshi80,7,0.00608,30336,26.35896,115088
1250,minusbat,7,0.00608,30343,26.36504,115088
1251,monson,7,0.00608,30350,26.37112,115088
1252,moog-stephen,7,0.00608,30357,26.37721,115088
1253,MOZGIII,7,0.00608,30364,26.38329,115088
1254,mperriere,7,0.00608,30371,26.38937,115088
1255,mvernimmen,7,0.00608,30378,26.39545,115088
1256,Mvpanswer7,7,0.00608,30385,26.40154,115088
1257,MyOldSkyGrandfather,7,0.00608,30392,26.40762,115088
1258,navono,7,0.00608,30399,26.41370,115088
1259,ndench,7,0.00608,30406,26.41978,115088
1260,negativeOne1,7,0.00608,30413,26.42587,115088
1261,ngocson2vn,7,0.00608,30420,26.43195,115088
1262,nhoughto,7,0.00608,30427,26.43803,115088
1263,NikitaGl,7,0.00608,30434,26.44411,115088
1264,ofer-velich,7,0.00608,30441,26.45019,115088
1265,ostojicmilica,7,0.00608,30448,26.45628,115088
1266,paran01d,7,0.00608,30455,26.46236,115088
1267,paroga,7,0.00608,30462,26.46844,115088
1268,pepov,7,0.00608,30469,26.47452,115088
1269,piotrkochan,7,0.00608,30476,26.48061,115088
1270,pkaeding,7,0.00608,30483,26.48669,115088
1271,pocke,7,0.00608,30490,26.49277,115088
1272,pranavgaikwad,7,0.00608,30497,26.49885,115088
1273,remeh,7,0.00608,30504,26.50494,115088
1274,respectus,7,0.00608,30511,26.51102,115088
1275,rgarcia,7,0.00608,30518,26.51710,115088
1276,rodvdka,7,0.00608,30525,26.52318,115088
1277,ruseel,7,0.00608,30532,26.52926,115088
1278,sachintaware,7,0.00608,30539,26.53535,115088
1279,Sam123ben,7,0.00608,30546,26.54143,115088
1280,saorio,7,0.00608,30553,26.54751,115088
1281,schakrava,7,0.00608,30560,26.55359,115088
1282,senthilkumar-kj,7,0.00608,30567,26.55968,115088
1283,shagabutdinov,7,0.00608,30574,26.56576,115088
1284,sharadkejriwal,7,0.00608,30581,26.57184,115088
1285,skythink,7,0.00608,30588,26.57792,115088
1286,snowjunkie,7,0.00608,30595,26.58401,115088
1287,sonofachamp,7,0.00608,30602,26.59009,115088
1288,soulware,7,0.00608,30609,26.59617,115088
1289,splushii,7,0.00608,30616,26.60225,115088
1290,stankud,7,0.00608,30623,26.60833,115088
1291,stephenkingsley,7,0.00608,30630,26.61442,115088
1292,sullerandras,7,0.00608,30637,26.62050,115088
1293,summer0nguyen,7,0.00608,30644,26.62658,115088
1294,suprememoocow,7,0.00608,30651,26.63266,115088
1295,talawahtech,7,0.00608,30658,26.63875,115088
1296,Telmo,7,0.00608,30665,26.64483,115088
1297,thokari,7,0.00608,30672,26.65091,115088
1298,tmeinlschmidt,7,0.00608,30679,26.65699,115088
1299,to30,7,0.00608,30686,26.66308,115088
1300,tomfitzhenry,7,0.00608,30693,26.66916,115088
1301,tomohiro-n,7,0.00608,30700,26.67524,115088
1302,tomschlenkhoff,7,0.00608,30707,26.68132,115088
1303,tredman,7,0.00608,30714,26.68740,115088
1304,trombik,7,0.00608,30721,26.69349,115088
1305,upinetree,7,0.00608,30728,26.69957,115088
1306,usamaahmadkhan,7,0.00608,30735,26.70565,115088
1307,venkat-rafay,7,0.00608,30742,26.71173,115088
1308,viztastic,7,0.00608,30749,26.71782,115088
1309,xingxing9688,7,0.00608,30756,26.72390,115088
1310,xnike,7,0.00608,30763,26.72998,115088
1311,yahharo,7,0.00608,30770,26.73606,115088
1312,yangsongx,7,0.00608,30777,26.74215,115088
1313,yawboateng,7,0.00608,30784,26.74823,115088
1314,ysgard,7,0.00608,30791,26.75431,115088
1315,yuki24,7,0.00608,30798,26.76039,115088
1316,YuzuruS,7,0.00608,30805,26.76647,115088
1317,zhigang,7,0.00608,30812,26.77256,115088
1318,zlwu,7,0.00608,30819,26.77864,115088
1319,zopanix,7,0.00608,30826,26.78472,115088
1320,27bharath,6,0.00521,30832,26.78993,115088
1321,6pongi,6,0.00521,30838,26.79515,115088
1322,9teen90nine,6,0.00521,30844,26.80036,115088
1323,abhishekkr,6,0.00521,30850,26.80557,115088
1324,acarsercan,6,0.00521,30856,26.81079,115088
1325,achntrl,6,0.00521,30862,26.81600,115088
1326,addozhang,6,0.00521,30868,26.82122,115088
1327,adinaclaudia,6,0.00521,30874,26.82643,115088
1328,ahaikal,6,0.00521,30880,26.83164,115088
1329,a-hat,6,0.00521,30886,26.83686,115088
1330,aibou,6,0.00521,30892,26.84207,115088
1331,ainame,6,0.00521,30898,26.84728,115088
1332,aj-jester,6,0.00521,30904,26.85250,115088
1333,akihiro17,6,0.00521,30910,26.85771,115088
1334,akira-kuriyama,6,0.00521,30916,26.86292,115088
1335,AlenJun,6,0.00521,30922,26.86814,115088
1336,alexandersm,6,0.00521,30928,26.87335,115088
1337,alter,6,0.00521,30934,26.87856,115088
1338,amcastror,6,0.00521,30940,26.88378,115088
1339,amiraBN,6,0.00521,30946,26.88899,115088
1340,anandsinghkunwar,6,0.00521,30952,26.89420,115088
1341,ananth07reddy,6,0.00521,30958,26.89942,115088
1342,angel-manuel,6,0.00521,30964,26.90463,115088
1343,aniketoss,6,0.00521,30970,26.90984,115088
1344,antoninblanc,6,0.00521,30976,26.91506,115088
1345,apigirl,6,0.00521,30982,26.92027,115088
1346,asafm,6,0.00521,30988,26.92548,115088
1347,bayaro,6,0.00521,30994,26.93070,115088
1348,beatlejuse,6,0.00521,31000,26.93591,115088
1349,Bekt,6,0.00521,31006,26.94112,115088
1350,BernhardBerbuir,6,0.00521,31012,26.94634,115088
1351,bhaveshmodiatekaplus,6,0.00521,31018,26.95155,115088
1352,bkupidura,6,0.00521,31024,26.95676,115088
1353,bnyu,6,0.00521,31030,26.96198,115088
1354,bohacekm,6,0.00521,31036,26.96719,115088
1355,bratislavml,6,0.00521,31042,26.97240,115088
1356,buarmin,6,0.00521,31048,26.97762,115088
1357,canfikret,6,0.00521,31054,26.98283,115088
1358,caosiyang,6,0.00521,31060,26.98804,115088
1359,capt-abhi,6,0.00521,31066,26.99326,115088
1360,cgspeck,6,0.00521,31072,26.99847,115088
1361,chansanto,6,0.00521,31078,27.00368,115088
1362,ChipmunkV,6,0.00521,31084,27.00890,115088
1363,chris060986,6,0.00521,31090,27.01411,115088
1364,chriskirkland,6,0.00521,31096,27.01932,115088
1365,cj74,6,0.00521,31102,27.02454,115088
1366,codespill,6,0.00521,31108,27.02975,115088
1367,commanderrikker,6,0.00521,31114,27.03496,115088
1368,craig-miskell-fluxfederation,6,0.00521,31120,27.04018,115088
1369,cristiklein,6,0.00521,31126,27.04539,115088
1370,croemmich,6,0.00521,31132,27.05060,115088
1371,ctyjrsy,6,0.00521,31138,27.05582,115088
1372,czchen,6,0.00521,31144,27.06103,115088
1373,daniel-ciaglia,6,0.00521,31150,27.06624,115088
1374,danielporfirio,6,0.00521,31156,27.07146,115088
1375,davidsayers,6,0.00521,31162,27.07667,115088
1376,dbluxo,6,0.00521,31168,27.08189,115088
1377,dcvtruong,6,0.00521,31174,27.08710,115088
1378,dennusb,6,0.00521,31180,27.09231,115088
1379,dennyzhang,6,0.00521,31186,27.09753,115088
1380,detfis,6,0.00521,31192,27.10274,115088
1381,dlaidlaw,6,0.00521,31198,27.10795,115088
1382,dmfenton,6,0.00521,31204,27.11317,115088
1383,dmke,6,0.00521,31210,27.11838,115088
1384,dusty73,6,0.00521,31216,27.12359,115088
1385,echoby,6,0.00521,31222,27.12881,115088
1386,eddgrant,6,0.00521,31228,27.13402,115088
1387,ehsanmasdar,6,0.00521,31234,27.13923,115088
1388,eino-makitalo,6,0.00521,31240,27.14445,115088
1389,eyalzek,6,0.00521,31246,27.14966,115088
1390,ezolnbl,6,0.00521,31252,27.15487,115088
1391,faberge-eggs,6,0.00521,31258,27.16009,115088
1392,fatum,6,0.00521,31264,27.16530,115088
1393,fenicks,6,0.00521,31270,27.17051,115088
1394,fessmage,6,0.00521,31276,27.17573,115088
1395,freedomofkeima,6,0.00521,31282,27.18094,115088
1396,fullee,6,0.00521,31288,27.18615,115088
1397,gajus,6,0.00521,31294,27.19137,115088
1398,gamer22026,6,0.00521,31300,27.19658,115088
1399,gauravcdac,6,0.00521,31306,27.20179,115088
1400,geerlingguy,6,0.00521,31312,27.20701,115088
1401,genehand,6,0.00521,31318,27.21222,115088
1402,gregoryguillou,6,0.00521,31324,27.21743,115088
1403,gsarrica,6,0.00521,31330,27.22265,115088
1404,guedressel,6,0.00521,31336,27.22786,115088
1405,Guent4,6,0.00521,31342,27.23307,115088
1406,gurunathj,6,0.00521,31348,27.23829,115088
1407,hankjacobs,6,0.00521,31354,27.24350,115088
1408,hawkblade124,6,0.00521,31360,27.24871,115088
1409,hellobhaskar,6,0.00521,31366,27.25393,115088
1410,henry0312,6,0.00521,31372,27.25914,115088
1411,heocoi,6,0.00521,31378,27.26435,115088
1412,hfm,6,0.00521,31384,27.26957,115088
1413,hokiegeek2,6,0.00521,31390,27.27478,115088
1414,iceone,6,0.00521,31396,27.27999,115088
1415,iconeb,6,0.00521,31402,27.28521,115088
1416,Imunhatep,6,0.00521,31408,27.29042,115088
1417,IppX,6,0.00521,31414,27.29563,115088
1418,itielshwartz,6,0.00521,31420,27.30085,115088
1419,ivankennethwang,6,0.00521,31426,27.30606,115088
1420,jacknagz,6,0.00521,31432,27.31127,115088
1421,james-crowley,6,0.00521,31438,27.31649,115088
1422,janerikcarlsen,6,0.00521,31444,27.32170,115088
1423,jansiwy,6,0.00521,31450,27.32692,115088
1424,jayhding,6,0.00521,31456,27.33213,115088
1425,jc89,6,0.00521,31462,27.33734,115088
1426,jenworthington,6,0.00521,31468,27.34256,115088
1427,jganoff,6,0.00521,31474,27.34777,115088
1428,jigetage,6,0.00521,31480,27.35298,115088
1429,JimiSmith,6,0.00521,31486,27.35820,115088
1430,jiuchongxiao,6,0.00521,31492,27.36341,115088
1431,jlgoolsbee,6,0.00521,31498,27.36862,115088
1432,josh-padnick,6,0.00521,31504,27.37384,115088
1433,joshuacox,6,0.00521,31510,27.37905,115088
1434,jupitercl,6,0.00521,31516,27.38426,115088
1435,JustinHead,6,0.00521,31522,27.38948,115088
1436,jwp23,6,0.00521,31528,27.39469,115088
1437,kaz,6,0.00521,31534,27.39990,115088
1438,kazeichev,6,0.00521,31540,27.40512,115088
1439,kerinin,6,0.00521,31546,27.41033,115088
1440,konstantin-kornienko-epam,6,0.00521,31552,27.41554,115088
1441,kop,6,0.00521,31558,27.42076,115088
1442,kouk,6,0.00521,31564,27.42597,115088
1443,krystiannowak,6,0.00521,31570,27.43118,115088
1444,kvborodin,6,0.00521,31576,27.43640,115088
1445,KYannick,6,0.00521,31582,27.44161,115088
1446,leandropadua,6,0.00521,31588,27.44682,115088
1447,leesmith110,6,0.00521,31594,27.45204,115088
1448,lintingbin2009,6,0.00521,31600,27.45725,115088
1449,lucasas,6,0.00521,31606,27.46246,115088
1450,luqasz,6,0.00521,31612,27.46768,115088
1451,m15o,6,0.00521,31618,27.47289,115088
1452,masato25,6,0.00521,31624,27.47810,115088
1453,MattiDeGrauwe,6,0.00521,31630,27.48332,115088
1454,mcarbonneaux,6,0.00521,31636,27.48853,115088
1455,mcarriere-seedbox,6,0.00521,31642,27.49374,115088
1456,mdalley,6,0.00521,31648,27.49896,115088
1457,megamind79,6,0.00521,31654,27.50417,115088
1458,meltsufin,6,0.00521,31660,27.50938,115088
1459,merugu,6,0.00521,31666,27.51460,115088
1460,metalfork,6,0.00521,31672,27.51981,115088
1461,mihaibuzgau,6,0.00521,31678,27.52502,115088
1462,mikeatlas,6,0.00521,31684,27.53024,115088
1463,minamijoyo,6,0.00521,31690,27.53545,115088
1464,mineblue,6,0.00521,31696,27.54066,115088
1465,mleneveut,6,0.00521,31702,27.54588,115088
1466,mokaymakci,6,0.00521,31708,27.55109,115088
1467,mookjp,6,0.00521,31714,27.55630,115088
1468,mredivo,6,0.00521,31720,27.56152,115088
1469,mthssdrbrg,6,0.00521,31726,27.56673,115088
1470,mxk1235,6,0.00521,31732,27.57194,115088
1471,mzahidriaz,6,0.00521,31738,27.57716,115088
1472,nareshnani529,6,0.00521,31744,27.58237,115088
1473,naumanrana,6,0.00521,31750,27.58759,115088
1474,nerzhul,6,0.00521,31756,27.59280,115088
1475,nickchang,6,0.00521,31762,27.59801,115088
1476,nikhilkakade2108,6,0.00521,31768,27.60323,115088
1477,nikinaydenov,6,0.00521,31774,27.60844,115088
1478,nikolaiderzhak,6,0.00521,31780,27.61365,115088
1479,nmaludy,6,0.00521,31786,27.61887,115088
1480,nunofernandes,6,0.00521,31792,27.62408,115088
1481,nyamairi,6,0.00521,31798,27.62929,115088
1482,osamingo,6,0.00521,31804,27.63451,115088
1483,owen,6,0.00521,31810,27.63972,115088
1484,parishs73,6,0.00521,31816,27.64493,115088
1485,parolkar,6,0.00521,31822,27.65015,115088
1486,Passpes,6,0.00521,31828,27.65536,115088
1487,patsevanton,6,0.00521,31834,27.66057,115088
1488,paulqi,6,0.00521,31840,27.66579,115088
1489,pawelbojanowski,6,0.00521,31846,27.67100,115088
1490,penuel-leo,6,0.00521,31852,27.67621,115088
1491,perk,6,0.00521,31858,27.68143,115088
1492,petastream,6,0.00521,31864,27.68664,115088
1493,pfremm,6,0.00521,31870,27.69185,115088
1494,pfriel-bcs,6,0.00521,31876,27.69707,115088
1495,placydo,6,0.00521,31882,27.70228,115088
1496,potato2003,6,0.00521,31888,27.70749,115088
1497,pydolan,6,0.00521,31894,27.71271,115088
1498,quick-sort,6,0.00521,31900,27.71792,115088
1499,rahuldahiya,6,0.00521,31906,27.72313,115088
1500,rakd,6,0.00521,31912,27.72835,115088
1501,ramynasr,6,0.00521,31918,27.73356,115088
1502,Raznak,6,0.00521,31924,27.73877,115088
1503,rewiko,6,0.00521,31930,27.74399,115088
1504,ricardojover,6,0.00521,31936,27.74920,115088
1505,rljie,6,0.00521,31942,27.75441,115088
1506,sabueso,6,0.00521,31948,27.75963,115088
1507,sam701,6,0.00521,31954,27.76484,115088
1508,SamirFarhat,6,0.00521,31960,27.77005,115088
1509,sandeepbhojwani,6,0.00521,31966,27.77527,115088
1510,sandstonewater,6,0.00521,31972,27.78048,115088
1511,sangwook,6,0.00521,31978,27.78569,115088
1512,sanjivr007,6,0.00521,31984,27.79091,115088
1513,schmidtjohannes,6,0.00521,31990,27.79612,115088
1514,sebryu,6,0.00521,31996,27.80133,115088
1515,SergeyD,6,0.00521,32002,27.80655,115088
1516,Set4now,6,0.00521,32008,27.81176,115088
1517,sfrostick,6,0.00521,32014,27.81697,115088
1518,s-kostyaev,6,0.00521,32020,27.82219,115088
1519,smcavoy-b,6,0.00521,32026,27.82740,115088
1520,spsusbilla,6,0.00521,32032,27.83262,115088
1521,Spycomb,6,0.00521,32038,27.83783,115088
1522,srkiNZ84,6,0.00521,32044,27.84304,115088
1523,steynovich,6,0.00521,32050,27.84826,115088
1524,sugi,6,0.00521,32056,27.85347,115088
1525,summit,6,0.00521,32062,27.85868,115088
1526,superwangvip,6,0.00521,32068,27.86390,115088
1527,svett,6,0.00521,32074,27.86911,115088
1528,t4ku,6,0.00521,32080,27.87432,115088
1529,taku333,6,0.00521,32086,27.87954,115088
1530,takuan-osho,6,0.00521,32092,27.88475,115088
1531,tamtam180,6,0.00521,32098,27.88996,115088
1532,tannaga,6,0.00521,32104,27.89518,115088
1533,tanner-bruce,6,0.00521,32110,27.90039,115088
1534,tatobi,6,0.00521,32116,27.90560,115088
1535,tbe,6,0.00521,32122,27.91082,115088
1536,TheConnMan,6,0.00521,32128,27.91603,115088
1537,thepeak99,6,0.00521,32134,27.92124,115088
1538,therealgambo,6,0.00521,32140,27.92646,115088
1539,tilfin,6,0.00521,32146,27.93167,115088
1540,tjratch,6,0.00521,32152,27.93688,115088
1541,tkob,6,0.00521,32158,27.94210,115088
1542,tmichelet,6,0.00521,32164,27.94731,115088
1543,u-ichi,6,0.00521,32170,27.95252,115088
1544,uryyyyyyy,6,0.00521,32176,27.95774,115088
1545,userguy,6,0.00521,32182,27.96295,115088
1546,w821881341,6,0.00521,32188,27.96816,115088
1547,wanderaBrno,6,0.00521,32194,27.97338,115088
1548,wjzhangcsu,6,0.00521,32200,27.97859,115088
1549,xarsh,6,0.00521,32206,27.98380,115088
1550,yatirdagan,6,0.00521,32212,27.98902,115088
1551,YerisAntonio,6,0.00521,32218,27.99423,115088
1552,ymatsiuk,6,0.00521,32224,27.99944,115088
1553,yudppp,6,0.00521,32230,28.00466,115088
1554,yuya373,6,0.00521,32236,28.00987,115088
1555,zachabrahams,6,0.00521,32242,28.01508,115088
1556,zephinzer,6,0.00521,32248,28.02030,115088
1557,zhangchao2015,6,0.00521,32254,28.02551,115088
1558,zoneofjin,6,0.00521,32260,28.03072,115088
1559,010akv,5,0.00434,32265,28.03507,115088
1560,13567436138,5,0.00434,32270,28.03941,115088
1561,2n3906,5,0.00434,32275,28.04376,115088
1562,97-109-107,5,0.00434,32280,28.04810,115088
1563,aa23,5,0.00434,32285,28.05245,115088
1564,abh,5,0.00434,32290,28.05679,115088
1565,adie,5,0.00434,32295,28.06114,115088
1566,AdrienKuhn,5,0.00434,32300,28.06548,115088
1567,aeoluswing,5,0.00434,32305,28.06982,115088
1568,ahughes02,5,0.00434,32310,28.07417,115088
1569,aiharak,5,0.00434,32315,28.07851,115088
1570,airtank,5,0.00434,32320,28.08286,115088
1571,aiwantaozi,5,0.00434,32325,28.08720,115088
1572,akhon,5,0.00434,32330,28.09155,115088
1573,alanchchen,5,0.00434,32335,28.09589,115088
1574,alexanderGalushka,5,0.00434,32340,28.10024,115088
1575,alexpts,5,0.00434,32345,28.10458,115088
1576,AlexRiedler,5,0.00434,32350,28.10893,115088
1577,Allenhaozi,5,0.00434,32355,28.11327,115088
1578,altenhof,5,0.00434,32360,28.11761,115088
1579,amanmahajan26,5,0.00434,32365,28.12196,115088
1580,andreaslangsays,5,0.00434,32370,28.12630,115088
1581,andrea-spoldi,5,0.00434,32375,28.13065,115088
1582,AndryBray,5,0.00434,32380,28.13499,115088
1583,andyzhuangyy,5,0.00434,32385,28.13934,115088
1584,Apple-a-Day,5,0.00434,32390,28.14368,115088
1585,arjun921,5,0.00434,32395,28.14803,115088
1586,artempronevskiy,5,0.00434,32400,28.15237,115088
1587,arun057,5,0.00434,32405,28.15671,115088
1588,atskimura,5,0.00434,32410,28.16106,115088
1589,baconz,5,0.00434,32415,28.16540,115088
1590,barrachri,5,0.00434,32420,28.16975,115088
1591,bcollard,5,0.00434,32425,28.17409,115088
1592,bidiudiu,5,0.00434,32430,28.17844,115088
1593,bivas6,5,0.00434,32435,28.18278,115088
1594,bortok,5,0.00434,32440,28.18713,115088
1595,boynet,5,0.00434,32445,28.19147,115088
1596,brycefisher,5,0.00434,32450,28.19582,115088
1597,butla,5,0.00434,32455,28.20016,115088
1598,bwilliams,5,0.00434,32460,28.20450,115088
1599,c0ze,5,0.00434,32465,28.20885,115088
1600,cadyb,5,0.00434,32470,28.21319,115088
1601,cakrit,5,0.00434,32475,28.21754,115088
1602,canertosuner,5,0.00434,32480,28.22188,115088
1603,castomer,5,0.00434,32485,28.22623,115088
1604,cdugz,5,0.00434,32490,28.23057,115088
1605,chaodhib,5,0.00434,32495,28.23492,115088
1606,chewi,5,0.00434,32500,28.23926,115088
1607,chs-bnet,5,0.00434,32505,28.24360,115088
1608,cite,5,0.00434,32510,28.24795,115088
1609,civik,5,0.00434,32515,28.25229,115088
1610,cjcc1,5,0.00434,32520,28.25664,115088
1611,colourmeamused,5,0.00434,32525,28.26098,115088
1612,comozo,5,0.00434,32530,28.26533,115088
1613,crazw,5,0.00434,32535,28.26967,115088
1614,cronolio,5,0.00434,32540,28.27402,115088
1615,damianprzygodzki,5,0.00434,32545,28.27836,115088
1616,danielzepp,5,0.00434,32550,28.28271,115088
1617,darashenka,5,0.00434,32555,28.28705,115088
1618,DarrienG,5,0.00434,32560,28.29139,115088
1619,DaveSlinn,5,0.00434,32565,28.29574,115088
1620,davgibney1,5,0.00434,32570,28.30008,115088
1621,davidglvn,5,0.00434,32575,28.30443,115088
1622,davidwtf,5,0.00434,32580,28.30877,115088
1623,dborysenko,5,0.00434,32585,28.31312,115088
1624,DianthuDia,5,0.00434,32590,28.31746,115088
1625,dkalashnik,5,0.00434,32595,28.32181,115088
1626,dmurvihill,5,0.00434,32600,28.32615,115088
1627,dometec,5,0.00434,32605,28.33049,115088
1628,dominicbecker,5,0.00434,32610,28.33484,115088
1629,ducky-hong,5,0.00434,32615,28.33918,115088
1630,eldadvcita,5,0.00434,32620,28.34353,115088
1631,elinshu,5,0.00434,32625,28.34787,115088
1632,ermitovski,5,0.00434,32630,28.35222,115088
1633,ethanliou,5,0.00434,32635,28.35656,115088
1634,euangreen,5,0.00434,32640,28.36091,115088
1635,fengyingjie2018,5,0.00434,32645,28.36525,115088
1636,fevlake,5,0.00434,32650,28.36960,115088
1637,firemax,5,0.00434,32655,28.37394,115088
1638,floriankoch,5,0.00434,32660,28.37828,115088
1639,freddiefujiwara,5,0.00434,32665,28.38263,115088
1640,frots,5,0.00434,32670,28.38697,115088
1641,f-ueno,5,0.00434,32675,28.39132,115088
1642,gbagnoli,5,0.00434,32680,28.39566,115088
1643,geota,5,0.00434,32685,28.40001,115088
1644,gerricchaplin,5,0.00434,32690,28.40435,115088
1645,ggpaue,5,0.00434,32695,28.40870,115088
1646,ghostylee,5,0.00434,32700,28.41304,115088
1647,gitvc,5,0.00434,32705,28.41738,115088
1648,gmpuran,5,0.00434,32710,28.42173,115088
1649,gmr,5,0.00434,32715,28.42607,115088
1650,goakley,5,0.00434,32720,28.43042,115088
1651,gws,5,0.00434,32725,28.43476,115088
1652,haoyujiang1994,5,0.00434,32730,28.43911,115088
1653,HarishHothi,5,0.00434,32735,28.44345,115088
1654,hetile-ssense,5,0.00434,32740,28.44780,115088
1655,hfinucane,5,0.00434,32745,28.45214,115088
1656,hichamuntitled,5,0.00434,32750,28.45649,115088
1657,Hi-king,5,0.00434,32755,28.46083,115088
1658,hiren1771,5,0.00434,32760,28.46517,115088
1659,hitochan777,5,0.00434,32765,28.46952,115088
1660,holajoyce,5,0.00434,32770,28.47386,115088
1661,holidayworking,5,0.00434,32775,28.47821,115088
1662,holysugar,5,0.00434,32780,28.48255,115088
1663,hongbk,5,0.00434,32785,28.48690,115088
1664,Horkyze,5,0.00434,32790,28.49124,115088
1665,ierceg,5,0.00434,32795,28.49559,115088
1666,ikeda-yuko,5,0.00434,32800,28.49993,115088
1667,iktiar,5,0.00434,32805,28.50427,115088
1668,ikuwow,5,0.00434,32810,28.50862,115088
1669,imaemo,5,0.00434,32815,28.51296,115088
1670,IngoS11,5,0.00434,32820,28.51731,115088
1671,ingvarm-gr,5,0.00434,32825,28.52165,115088
1672,itoffshore,5,0.00434,32830,28.52600,115088
1673,jakshi,5,0.00434,32835,28.53034,115088
1674,jalalahmad,5,0.00434,32840,28.53469,115088
1675,jamesweb1,5,0.00434,32845,28.53903,115088
1676,JanKowalik,5,0.00434,32850,28.54338,115088
1677,jcotado,5,0.00434,32855,28.54772,115088
1678,jdeglopper,5,0.00434,32860,28.55206,115088
1679,jefimm,5,0.00434,32865,28.55641,115088
1680,jgmchan,5,0.00434,32870,28.56075,115088
1681,jhinklew,5,0.00434,32875,28.56510,115088
1682,jiangfengbing,5,0.00434,32880,28.56944,115088
1683,joakim,5,0.00434,32885,28.57379,115088
1684,joerx,5,0.00434,32890,28.57813,115088
1685,johnnason,5,0.00434,32895,28.58248,115088
1686,jonathanibers,5,0.00434,32900,28.58682,115088
1687,jonathanjuursema,5,0.00434,32905,28.59117,115088
1688,Jonnymcc,5,0.00434,32910,28.59551,115088
1689,josephsu,5,0.00434,32915,28.59985,115088
1690,joshiggins,5,0.00434,32920,28.60420,115088
1691,jpackagejasonc,5,0.00434,32925,28.60854,115088
1692,judexzhu,5,0.00434,32930,28.61289,115088
1693,jujugrrr,5,0.00434,32935,28.61723,115088
1694,juliantaylor,5,0.00434,32940,28.62158,115088
1695,juliuskrah,5,0.00434,32945,28.62592,115088
1696,justaskz,5,0.00434,32950,28.63027,115088
1697,j-walker23,5,0.00434,32955,28.63461,115088
1698,k63207,5,0.00434,32960,28.63895,115088
1699,kaakaa,5,0.00434,32965,28.64330,115088
1700,kailashyogeshwar85,5,0.00434,32970,28.64764,115088
1701,Kanshiroron,5,0.00434,32975,28.65199,115088
1702,kapodes,5,0.00434,32980,28.65633,115088
1703,karupanerura,5,0.00434,32985,28.66068,115088
1704,katriel,5,0.00434,32990,28.66502,115088
1705,katrielt,5,0.00434,32995,28.66937,115088
1706,kazeburo,5,0.00434,33000,28.67371,115088
1707,kazsakai,5,0.00434,33005,28.67806,115088
1708,keijiyoshida,5,0.00434,33010,28.68240,115088
1709,Kesslerb2,5,0.00434,33015,28.68674,115088
1710,kgf,5,0.00434,33020,28.69109,115088
1711,kgrodzicki,5,0.00434,33025,28.69543,115088
1712,khilman,5,0.00434,33030,28.69978,115088
1713,kimamula,5,0.00434,33035,28.70412,115088
1714,k-kawa,5,0.00434,33040,28.70847,115088
1715,kladiv,5,0.00434,33045,28.71281,115088
1716,kono,5,0.00434,33050,28.71716,115088
1717,korprulu,5,0.00434,33055,28.72150,115088
1718,krithiga90,5,0.00434,33060,28.72584,115088
1719,Kumaravel2904,5,0.00434,33065,28.73019,115088
1720,KunalAggarwal,5,0.00434,33070,28.73453,115088
1721,KunalArora,5,0.00434,33075,28.73888,115088
1722,L3n41c,5,0.00434,33080,28.74322,115088
1723,lakshmi-kannan,5,0.00434,33085,28.74757,115088
1724,LarsKumbier,5,0.00434,33090,28.75191,115088
1725,laurentiu92,5,0.00434,33095,28.75626,115088
1726,laurrentt,5,0.00434,33100,28.76060,115088
1727,Lavakush7,5,0.00434,33105,28.76495,115088
1728,lcrash,5,0.00434,33110,28.76929,115088
1729,liutao6869,5,0.00434,33115,28.77363,115088
1730,lswith,5,0.00434,33120,28.77798,115088
1731,lubegamark,5,0.00434,33125,28.78232,115088
1732,lw8008,5,0.00434,33130,28.78667,115088
1733,macgahe,5,0.00434,33135,28.79101,115088
1734,machytkafitanalytics,5,0.00434,33140,28.79536,115088
1735,majst01,5,0.00434,33145,28.79970,115088
1736,majwang,5,0.00434,33150,28.80405,115088
1737,manicole,5,0.00434,33155,28.80839,115088
1738,mansinahar,5,0.00434,33160,28.81273,115088
1739,marcuslindfeldt,5,0.00434,33165,28.81708,115088
1740,MariePMcGarry,5,0.00434,33170,28.82142,115088
1741,markokostovski,5,0.00434,33175,28.82577,115088
1742,marqc,5,0.00434,33180,28.83011,115088
1743,MartinsThiago,5,0.00434,33185,28.83446,115088
1744,martiyanov,5,0.00434,33190,28.83880,115088
1745,matiji66,5,0.00434,33195,28.84315,115088
1746,mburns,5,0.00434,33200,28.84749,115088
1747,melya,5,0.00434,33205,28.85184,115088
1748,mguryanov,5,0.00434,33210,28.85618,115088
1749,mihir2402,5,0.00434,33215,28.86052,115088
1750,mikkohoo,5,0.00434,33220,28.86487,115088
1751,mitrakanuri,5,0.00434,33225,28.86921,115088
1752,mkarlesky,5,0.00434,33230,28.87356,115088
1753,mlohstroh,5,0.00434,33235,28.87790,115088
1754,mmariani,5,0.00434,33240,28.88225,115088
1755,mohit5540,5,0.00434,33245,28.88659,115088
1756,montanaflynn,5,0.00434,33250,28.89094,115088
1757,mpucholblasco,5,0.00434,33255,28.89528,115088
1758,mtaylor91,5,0.00434,33260,28.89962,115088
1759,muhahacz,5,0.00434,33265,28.90397,115088
1760,murata100,5,0.00434,33270,28.90831,115088
1761,mwestber,5,0.00434,33275,28.91266,115088
1762,Nabilliban14,5,0.00434,33280,28.91700,115088
1763,Nafer17,5,0.00434,33285,28.92135,115088
1764,nagas,5,0.00434,33290,28.92569,115088
1765,NathanPower,5,0.00434,33295,28.93004,115088
1766,nathanwebb,5,0.00434,33300,28.93438,115088
1767,naveennadhv,5,0.00434,33305,28.93873,115088
1768,ncrothe,5,0.00434,33310,28.94307,115088
1769,neko-neko,5,0.00434,33315,28.94741,115088
1770,neurogenesis,5,0.00434,33320,28.95176,115088
1771,nguyenvulong,5,0.00434,33325,28.95610,115088
1772,NickMortimer,5,0.00434,33330,28.96045,115088
1773,nicosto,5,0.00434,33335,28.96479,115088
1774,ninja-,5,0.00434,33340,28.96914,115088
1775,nitzanav,5,0.00434,33345,28.97348,115088
1776,NixM0nk3y,5,0.00434,33350,28.97783,115088
1777,NorihisaNakai,5,0.00434,33355,28.98217,115088
1778,ntavares,5,0.00434,33360,28.98651,115088
1779,nullkarma,5,0.00434,33365,28.99086,115088
1780,otaki-ryuta,5,0.00434,33370,28.99520,115088
1781,panage,5,0.00434,33375,28.99955,115088
1782,pandora2000,5,0.00434,33380,29.00389,115088
1783,pankajtalk,5,0.00434,33385,29.00824,115088
1784,pathikritmodak,5,0.00434,33390,29.01258,115088
1785,Paul-Rupe-sp,5,0.00434,33395,29.01693,115088
1786,pgodot,5,0.00434,33400,29.02127,115088
1787,Ping-GAO,5,0.00434,33405,29.02562,115088
1788,poiati,5,0.00434,33410,29.02996,115088
1789,port22,5,0.00434,33415,29.03430,115088
1790,PP700,5,0.00434,33420,29.03865,115088
1791,pyinx,5,0.00434,33425,29.04299,115088
1792,r0039,5,0.00434,33430,29.04734,115088
1793,Raboo,5,0.00434,33435,29.05168,115088
1794,rameshVeeramani,5,0.00434,33440,29.05603,115088
1795,ramsateesh,5,0.00434,33445,29.06037,115088
1796,randude,5,0.00434,33450,29.06472,115088
1797,rangken,5,0.00434,33455,29.06906,115088
1798,rdumi7ru,5,0.00434,33460,29.07340,115088
1799,reedflinch,5,0.00434,33465,29.07775,115088
1800,reidrac,5,0.00434,33470,29.08209,115088
1801,richelam,5,0.00434,33475,29.08644,115088
1802,roche-d,5,0.00434,33480,29.09078,115088
1803,rohitnick,5,0.00434,33485,29.09513,115088
1804,RonnyLV,5,0.00434,33490,29.09947,115088
1805,rrichardson,5,0.00434,33495,29.10382,115088
1806,sahilsareen,5,0.00434,33500,29.10816,115088
1807,sanjitsaluja,5,0.00434,33505,29.11251,115088
1808,sathishkumar64,5,0.00434,33510,29.11685,115088
1809,sazo,5,0.00434,33515,29.12119,115088
1810,sbkg0002,5,0.00434,33520,29.12554,115088
1811,seandilda,5,0.00434,33525,29.12988,115088
1812,seapy,5,0.00434,33530,29.13423,115088
1813,sei-jmattson,5,0.00434,33535,29.13857,115088
1814,servomac,5,0.00434,33540,29.14292,115088
1815,sethest,5,0.00434,33545,29.14726,115088
1816,shellemech,5,0.00434,33550,29.15161,115088
1817,sidprak,5,0.00434,33555,29.15595,115088
1818,silverbp,5,0.00434,33560,29.16029,115088
1819,simonklb,5,0.00434,33565,29.16464,115088
1820,singhjagmohan1000,5,0.00434,33570,29.16898,115088
1821,sjoerdmulder,5,0.00434,33575,29.17333,115088
1822,skizot722,5,0.00434,33580,29.17767,115088
1823,slimee,5,0.00434,33585,29.18202,115088
1824,smithtopher,5,0.00434,33590,29.18636,115088
1825,sneko,5,0.00434,33595,29.19071,115088
1826,sokoow,5,0.00434,33600,29.19505,115088
1827,Spazzy757,5,0.00434,33605,29.19940,115088
1828,spynode,5,0.00434,33610,29.20374,115088
1829,sriramana,5,0.00434,33615,29.20808,115088
1830,s-shubh,5,0.00434,33620,29.21243,115088
1831,StanikLukasz,5,0.00434,33625,29.21677,115088
1832,stvnwrgs,5,0.00434,33630,29.22112,115088
1833,sudeep-quantelai,5,0.00434,33635,29.22546,115088
1834,Sunanda-S2,5,0.00434,33640,29.22981,115088
1835,tahoward,5,0.00434,33645,29.23415,115088
1836,takesato,5,0.00434,33650,29.23850,115088
1837,tanjunchen,5,0.00434,33655,29.24284,115088
1838,tankovicsg,5,0.00434,33660,29.24718,115088
1839,tboothman,5,0.00434,33665,29.25153,115088
1840,test-account-0,5,0.00434,33670,29.25587,115088
1841,thefirstofthe300,5,0.00434,33675,29.26022,115088
1842,thrift24,5,0.00434,33680,29.26456,115088
1843,timesking,5,0.00434,33685,29.26891,115088
1844,tlytg456,5,0.00434,33690,29.27325,115088
1845,tomaszulgis,5,0.00434,33695,29.27760,115088
1846,tomotake-koike,5,0.00434,33700,29.28194,115088
1847,tomykaira,5,0.00434,33705,29.28629,115088
1848,tratch,5,0.00434,33710,29.29063,115088
1849,tsn77130,5,0.00434,33715,29.29497,115088
1850,TYsewyn,5,0.00434,33720,29.29932,115088
1851,UncleTawnos,5,0.00434,33725,29.30366,115088
1852,VAdamec,5,0.00434,33730,29.30801,115088
1853,vaseeharan,5,0.00434,33735,29.31235,115088
1854,vdm,5,0.00434,33740,29.31670,115088
1855,viquar22,5,0.00434,33745,29.32104,115088
1856,viveksoundrapandi,5,0.00434,33750,29.32539,115088
1857,voxxit,5,0.00434,33755,29.32973,115088
1858,w5750584,5,0.00434,33760,29.33407,115088
1859,Wadikkk,5,0.00434,33765,29.33842,115088
1860,WangMingJue,5,0.00434,33770,29.34276,115088
1861,whaon,5,0.00434,33775,29.34711,115088
1862,wiktor2200,5,0.00434,33780,29.35145,115088
1863,wsorenson,5,0.00434,33785,29.35580,115088
1864,xdays,5,0.00434,33790,29.36014,115088
1865,xPB12,5,0.00434,33795,29.36449,115088
1866,xprom,5,0.00434,33800,29.36883,115088
1867,xv-jesus-g,5,0.00434,33805,29.37318,115088
1868,yamada-shinji,5,0.00434,33810,29.37752,115088
1869,Y-Asahi-dev,5,0.00434,33815,29.38186,115088
1870,yoojioh,5,0.00434,33820,29.38621,115088
1871,yusufcangurkan,5,0.00434,33825,29.39055,115088
1872,yuxiaobo96,5,0.00434,33830,29.39490,115088
1873,zagvym,5,0.00434,33835,29.39924,115088
1874,zeiler,5,0.00434,33840,29.40359,115088
1875,zgwmike,5,0.00434,33845,29.40793,115088
1876,zot24,5,0.00434,33850,29.41228,115088
1877,467754239,4,0.00348,33854,29.41575,115088
1878,9diov,4,0.00348,33858,29.41923,115088
1879,aardelean,4,0.00348,33862,29.42270,115088
1880,abhigp27,4,0.00348,33866,29.42618,115088
1881,abhishek-buragadda,4,0.00348,33870,29.42965,115088
1882,aboyett,4,0.00348,33874,29.43313,115088
1883,adalrsjr1,4,0.00348,33878,29.43661,115088
1884,adamcheney,4,0.00348,33882,29.44008,115088
1885,adamthedeveloper,4,0.00348,33886,29.44356,115088
1886,AdamVB,4,0.00348,33890,29.44703,115088
1887,adilr00t,4,0.00348,33894,29.45051,115088
1888,AdimUser,4,0.00348,33898,29.45398,115088
1889,a-elita,4,0.00348,33902,29.45746,115088
1890,aiueo4u,4,0.00348,33906,29.46093,115088
1891,ajmulhollan1,4,0.00348,33910,29.46441,115088
1892,akashagrawal,4,0.00348,33914,29.46789,115088
1893,akgunjal,4,0.00348,33918,29.47136,115088
1894,Akhisar,4,0.00348,33922,29.47484,115088
1895,akrus,4,0.00348,33926,29.47831,115088
1896,alexander-stepanov,4,0.00348,33930,29.48179,115088
1897,alexandreweiss,4,0.00348,33934,29.48526,115088
1898,AlexHeylin,4,0.00348,33938,29.48874,115088
1899,alogoc,4,0.00348,33942,29.49221,115088
1900,althepcman,4,0.00348,33946,29.49569,115088
1901,Amanjain1612,4,0.00348,33950,29.49917,115088
1902,amarcionek,4,0.00348,33954,29.50264,115088
1903,amarkelov,4,0.00348,33958,29.50612,115088
1904,amdelamar,4,0.00348,33962,29.50959,115088
1905,analogrithems,4,0.00348,33966,29.51307,115088
1906,anhldbk,4,0.00348,33970,29.51654,115088
1907,an-matviyevich,4,0.00348,33974,29.52002,115088
1908,antoinep92,4,0.00348,33978,29.52350,115088
1909,AntonioAlfrz,4,0.00348,33982,29.52697,115088
1910,anton-kachurin,4,0.00348,33986,29.53045,115088
1911,aonamrata,4,0.00348,33990,29.53392,115088
1912,AranVinkItility,4,0.00348,33994,29.53740,115088
1913,archiebartleman,4,0.00348,33998,29.54087,115088
1914,arodriguezdlc,4,0.00348,34002,29.54435,115088
1915,artysidorenko,4,0.00348,34006,29.54782,115088
1916,arunakalla,4,0.00348,34010,29.55130,115088
1917,arunv707,4,0.00348,34014,29.55478,115088
1918,asahu569,4,0.00348,34018,29.55825,115088
1919,Ashraf-Hassan,4,0.00348,34022,29.56173,115088
1920,athom,4,0.00348,34026,29.56520,115088
1921,avii-wix,4,0.00348,34030,29.56868,115088
1922,bahchis,4,0.00348,34034,29.57215,115088
1923,balan2010,4,0.00348,34038,29.57563,115088
1924,banderas07,4,0.00348,34042,29.57910,115088
1925,bdentino,4,0.00348,34046,29.58258,115088
1926,beckjim,4,0.00348,34050,29.58606,115088
1927,benkiefer,4,0.00348,34054,29.58953,115088
1928,bernie4321,4,0.00348,34058,29.59301,115088
1929,bhargavamin,4,0.00348,34062,29.59648,115088
1930,binarybana,4,0.00348,34066,29.59996,115088
1931,blaryjp,4,0.00348,34070,29.60343,115088
1932,bodik,4,0.00348,34074,29.60691,115088
1933,boldt,4,0.00348,34078,29.61039,115088
1934,brandonmp,4,0.00348,34082,29.61386,115088
1935,briandeheus,4,0.00348,34086,29.61734,115088
1936,briggleman,4,0.00348,34090,29.62081,115088
1937,bshy522,4,0.00348,34094,29.62429,115088
1938,buom,4,0.00348,34098,29.62776,115088
1939,burkaygur,4,0.00348,34102,29.63124,115088
1940,burningalchemist,4,0.00348,34106,29.63471,115088
1941,byplayer,4,0.00348,34110,29.63819,115088
1942,calvinx408,4,0.00348,34114,29.64167,115088
1943,cassador,4,0.00348,34118,29.64514,115088
1944,catweisun,4,0.00348,34122,29.64862,115088
1945,cazorla19,4,0.00348,34126,29.65209,115088
1946,cde0,4,0.00348,34130,29.65557,115088
1947,centurysys,4,0.00348,34134,29.65904,115088
1948,cgspohn,4,0.00348,34138,29.66252,115088
1949,chaitanyagupta,4,0.00348,34142,29.66599,115088
1950,Charles-WYC,4,0.00348,34146,29.66947,115088
1951,Chili-Man,4,0.00348,34150,29.67295,115088
1952,chkt,4,0.00348,34154,29.67642,115088
1953,chorny,4,0.00348,34158,29.67990,115088
1954,chrfergen,4,0.00348,34162,29.68337,115088
1955,chrisolido,4,0.00348,34166,29.68685,115088
1956,ClementDy,4,0.00348,34170,29.69032,115088
1957,comicfans,4,0.00348,34174,29.69380,115088
1958,cpfriend1721994,4,0.00348,34178,29.69728,115088
1959,cswilliams,4,0.00348,34182,29.70075,115088
1960,ctison,4,0.00348,34186,29.70423,115088
1961,cwiggs,4,0.00348,34190,29.70770,115088
1962,CyberSeppi,4,0.00348,34194,29.71118,115088
1963,danil-fomichev,4,0.00348,34198,29.71465,115088
1964,Darkheir,4,0.00348,34202,29.71813,115088
1965,darknighthunder,4,0.00348,34206,29.72160,115088
1966,darrug,4,0.00348,34210,29.72508,115088
1967,daviddyball,4,0.00348,34214,29.72856,115088
1968,DavidTPate,4,0.00348,34218,29.73203,115088
1969,davidwin93,4,0.00348,34222,29.73551,115088
1970,dcosson,4,0.00348,34226,29.73898,115088
1971,deg84,4,0.00348,34230,29.74246,115088
1972,dehatanes,4,0.00348,34234,29.74593,115088
1973,den-is,4,0.00348,34238,29.74941,115088
1974,devent,4,0.00348,34242,29.75288,115088
1975,devopsjonas,4,0.00348,34246,29.75636,115088
1976,dgonzalezruiz,4,0.00348,34250,29.75984,115088
1977,dhellemans,4,0.00348,34254,29.76331,115088
1978,docebo,4,0.00348,34258,29.76679,115088
1979,DonMartin76,4,0.00348,34262,29.77026,115088
1980,dontub,4,0.00348,34266,29.77374,115088
1981,dpmills,4,0.00348,34270,29.77721,115088
1982,dresnick-sf,4,0.00348,34274,29.78069,115088
1983,dtjm,4,0.00348,34278,29.78417,115088
1984,dylan-cooper,4,0.00348,34282,29.78764,115088
1985,dyson,4,0.00348,34286,29.79112,115088
1986,eastebry,4,0.00348,34290,29.79459,115088
1987,edannenberg,4,0.00348,34294,29.79807,115088
1988,edgegoldberg,4,0.00348,34298,29.80154,115088
1989,edwardchuang,4,0.00348,34302,29.80502,115088
1990,eirslett,4,0.00348,34306,29.80849,115088
1991,ekimekim,4,0.00348,34310,29.81197,115088
1992,elmalto,4,0.00348,34314,29.81545,115088
1993,enekofb,4,0.00348,34318,29.81892,115088
1994,enod,4,0.00348,34322,29.82240,115088
1995,ericln,4,0.00348,34326,29.82587,115088
1996,erikbgithub,4,0.00348,34330,29.82935,115088
1997,esselius,4,0.00348,34334,29.83282,115088
1998,evgeny-myasishchev,4,0.00348,34338,29.83630,115088
1999,evgkrsk,4,0.00348,34342,29.83977,115088
2000,exquisitus,4,0.00348,34346,29.84325,115088
2001,FabianFrank,4,0.00348,34350,29.84673,115088
2002,fabianmenges,4,0.00348,34354,29.85020,115088
2003,fadlinurhasan,4,0.00348,34358,29.85368,115088
2004,farman1855,4,0.00348,34362,29.85715,115088
2005,fcnrk,4,0.00348,34366,29.86063,115088
2006,fghorbel,4,0.00348,34370,29.86410,115088
2007,Filirom1,4,0.00348,34374,29.86758,115088
2008,fire,4,0.00348,34378,29.87106,115088
2009,fotinakis,4,0.00348,34382,29.87453,115088
2010,fouts-bnet,4,0.00348,34386,29.87801,115088
2011,foxtrot9,4,0.00348,34390,29.88148,115088
2012,frankyaorenjie,4,0.00348,34394,29.88496,115088
2013,fujibee,4,0.00348,34398,29.88843,115088
2014,gasmith-nutanix,4,0.00348,34402,29.89191,115088
2015,geofffranks,4,0.00348,34406,29.89538,115088
2016,gganssauge,4,0.00348,34410,29.89886,115088
2017,gimmi,4,0.00348,34414,29.90234,115088
2018,giner,4,0.00348,34418,29.90581,115088
2019,Goddywu,4,0.00348,34422,29.90929,115088
2020,goodservicedev,4,0.00348,34426,29.91276,115088
2021,grachevko,4,0.00348,34430,29.91624,115088
2022,grenzr,4,0.00348,34434,29.91971,115088
2023,gvisniuc,4,0.00348,34438,29.92319,115088
2024,hanazuki,4,0.00348,34442,29.92666,115088
2025,hansmeijerprotegrity,4,0.00348,34446,29.93014,115088
2026,happysiro,4,0.00348,34450,29.93362,115088
2027,harmw,4,0.00348,34454,29.93709,115088
2028,haru01,4,0.00348,34458,29.94057,115088
2029,hassanf1,4,0.00348,34462,29.94404,115088
2030,helli0n,4,0.00348,34466,29.94752,115088
2031,higumachan,4,0.00348,34470,29.95099,115088
2032,hikhvar,4,0.00348,34474,29.95447,115088
2033,hirokikana,4,0.00348,34478,29.95795,115088
2034,hixichen,4,0.00348,34482,29.96142,115088
2035,hmorgado,4,0.00348,34486,29.96490,115088
2036,hombres95,4,0.00348,34490,29.96837,115088
2037,homma-takamasa,4,0.00348,34494,29.97185,115088
2038,horan-geeker,4,0.00348,34498,29.97532,115088
2039,howardkr,4,0.00348,34502,29.97880,115088
2040,hrl,4,0.00348,34506,29.98227,115088
2041,hundt,4,0.00348,34510,29.98575,115088
2042,iamleet,4,0.00348,34514,29.98923,115088
2043,idanto,4,0.00348,34518,29.99270,115088
2044,ikegami-yukino,4,0.00348,34522,29.99618,115088
2045,ISChetverikov,4,0.00348,34526,29.99965,115088
2046,ishizaghi,4,0.00348,34530,30.00313,115088
2047,ivan-mjch,4,0.00348,34534,30.00660,115088
2048,ivan-shaporov,4,0.00348,34538,30.01008,115088
2049,izaakschroeder,4,0.00348,34542,30.01355,115088
2050,j30ng,4,0.00348,34546,30.01703,115088
2051,jack2ngon,4,0.00348,34550,30.02051,115088
2052,JacobHeidelbach,4,0.00348,34554,30.02398,115088
2053,jamroks,4,0.00348,34558,30.02746,115088
2054,januswel,4,0.00348,34562,30.03093,115088
2055,jasonsmithj,4,0.00348,34566,30.03441,115088
2056,jaynblue,4,0.00348,34570,30.03788,115088
2057,jcardoso-bv,4,0.00348,34574,30.04136,115088
2058,jeremydonahue,4,0.00348,34578,30.04484,115088
2059,jernyreverb,4,0.00348,34582,30.04831,115088
2060,jessecollier,4,0.00348,34586,30.05179,115088
2061,jet1276,4,0.00348,34590,30.05526,115088
2062,jgrexa,4,0.00348,34594,30.05874,115088
2063,jhaohai,4,0.00348,34598,30.06221,115088
2064,jiachenzhong,4,0.00348,34602,30.06569,115088
2065,jicowan,4,0.00348,34606,30.06916,115088
2066,Jimflip,4,0.00348,34610,30.07264,115088
2067,jinghzhu,4,0.00348,34614,30.07612,115088
2068,jkawamoto,4,0.00348,34618,30.07959,115088
2069,jmellor,4,0.00348,34622,30.08307,115088
2070,jnmly,4,0.00348,34626,30.08654,115088
2071,joell,4,0.00348,34630,30.09002,115088
2072,joeweoj,4,0.00348,34634,30.09349,115088
2073,joeyfromspace,4,0.00348,34638,30.09697,115088
2074,johntrabelsi,4,0.00348,34642,30.10044,115088
2075,jojotheboss,4,0.00348,34646,30.10392,115088
2076,jondoe1337,4,0.00348,34650,30.10740,115088
2077,joostcoelingh,4,0.00348,34654,30.11087,115088
2078,jorgebirck,4,0.00348,34658,30.11435,115088
2079,josephine-rueckert,4,0.00348,34662,30.11782,115088
2080,jpaulodit,4,0.00348,34666,30.12130,115088
2081,jp-gc,4,0.00348,34670,30.12477,115088
2082,jrottenberg,4,0.00348,34674,30.12825,115088
2083,jwerak,4,0.00348,34678,30.13173,115088
2084,k1nger,4,0.00348,34682,30.13520,115088
2085,kaihar4,4,0.00348,34686,30.13868,115088
2086,kalexii,4,0.00348,34690,30.14215,115088
2087,kalinin-k-a,4,0.00348,34694,30.14563,115088
2088,karatekidandy,4,0.00348,34698,30.14910,115088
2089,katsew,4,0.00348,34702,30.15258,115088
2090,kaxap,4,0.00348,34706,30.15605,115088
2091,kazuya-igarashi,4,0.00348,34710,30.15953,115088
2092,keithseahus,4,0.00348,34714,30.16301,115088
2093,kenju,4,0.00348,34718,30.16648,115088
2094,kevinburkenotion,4,0.00348,34722,30.16996,115088
2095,kevinscholz,4,0.00348,34726,30.17343,115088
2096,killerfish16,4,0.00348,34730,30.17691,115088
2097,kinghuang,4,0.00348,34734,30.18038,115088
2098,kjmrknsn,4,0.00348,34738,30.18386,115088
2099,kjvarga,4,0.00348,34742,30.18733,115088
2100,knonomura,4,0.00348,34746,30.19081,115088
2101,kochp,4,0.00348,34750,30.19429,115088
2102,kohey18,4,0.00348,34754,30.19776,115088
2103,koolok,4,0.00348,34758,30.20124,115088
2104,kprasad99,4,0.00348,34762,30.20471,115088
2105,ksRaffaelSenn,4,0.00348,34766,30.20819,115088
2106,kusakari,4,0.00348,34770,30.21166,115088
2107,lamanotrama,4,0.00348,34774,30.21514,115088
2108,LamCiuLoeng,4,0.00348,34778,30.21862,115088
2109,lam-juice,4,0.00348,34782,30.22209,115088
2110,lcorsini,4,0.00348,34786,30.22557,115088
2111,leandroandrade-hotmart,4,0.00348,34790,30.22904,115088
2112,leesa123,4,0.00348,34794,30.23252,115088
2113,leesmith,4,0.00348,34798,30.23599,115088
2114,leo1515416043,4,0.00348,34802,30.23947,115088
2115,liaoyupeng,4,0.00348,34806,30.24294,115088
2116,lingethan,4,0.00348,34810,30.24642,115088
2117,liuxin95,4,0.00348,34814,30.24990,115088
2118,liveaverage,4,0.00348,34818,30.25337,115088
2119,ljuaneda,4,0.00348,34822,30.25685,115088
2120,lorenmh,4,0.00348,34826,30.26032,115088
2121,lruslan,4,0.00348,34830,30.26380,115088
2122,lstiebel,4,0.00348,34834,30.26727,115088
2123,lucasfernando,4,0.00348,34838,30.27075,115088
2124,luoweb,4,0.00348,34842,30.27422,115088
2125,luweiv9988,4,0.00348,34846,30.27770,115088
2126,lycis,4,0.00348,34850,30.28118,115088
2127,lynattemm,4,0.00348,34854,30.28465,115088
2128,mailtoraja18,4,0.00348,34858,30.28813,115088
2129,MajedFarhat,4,0.00348,34862,30.29160,115088
2130,makknife,4,0.00348,34866,30.29508,115088
2131,malingaraj,4,0.00348,34870,30.29855,115088
2132,manjunathramesh,4,0.00348,34874,30.30203,115088
2133,mariozski,4,0.00348,34878,30.30551,115088
2134,markgergely,4,0.00348,34882,30.30898,115088
2135,martindanko,4,0.00348,34886,30.31246,115088
2136,masaomoc,4,0.00348,34890,30.31593,115088
2137,mateusz-blaszkowski,4,0.00348,34894,30.31941,115088
2138,mathpl,4,0.00348,34898,30.32288,115088
2139,matsumoto-r,4,0.00348,34902,30.32636,115088
2140,matthewhou3588,4,0.00348,34906,30.32983,115088
2141,matti,4,0.00348,34910,30.33331,115088
2142,mcbain,4,0.00348,34914,30.33679,115088
2143,mdimas,4,0.00348,34918,30.34026,115088
2144,mdnix,4,0.00348,34922,30.34374,115088
2145,Mengying-Li,4,0.00348,34926,30.34721,115088
2146,meoooh,4,0.00348,34930,30.35069,115088
2147,meskai,4,0.00348,34934,30.35416,115088
2148,meyeet,4,0.00348,34938,30.35764,115088
2149,MihaiAnei,4,0.00348,34942,30.36111,115088
2150,mijime,4,0.00348,34946,30.36459,115088
2151,miketsts,4,0.00348,34950,30.36807,115088
2152,mogman1,4,0.00348,34954,30.37154,115088
2153,MohdAhmad,4,0.00348,34958,30.37502,115088
2154,moranmathias,4,0.00348,34962,30.37849,115088
2155,moserke,4,0.00348,34966,30.38197,115088
2156,mparienti,4,0.00348,34970,30.38544,115088
2157,mpon,4,0.00348,34974,30.38892,115088
2158,MrMarshall,4,0.00348,34978,30.39240,115088
2159,msergg,4,0.00348,34982,30.39587,115088
2160,mshibuya,4,0.00348,34986,30.39935,115088
2161,mukkusonic,4,0.00348,34990,30.40282,115088
2162,nacholopez,4,0.00348,34994,30.40630,115088
2163,naerymdan,4,0.00348,34998,30.40977,115088
2164,nakechi,4,0.00348,35002,30.41325,115088
2165,NareshAnaparthi,4,0.00348,35006,30.41672,115088
2166,nderzhak,4,0.00348,35010,30.42020,115088
2167,nemodija,4,0.00348,35014,30.42368,115088
2168,nEosAg007,4,0.00348,35018,30.42715,115088
2169,nesl247,4,0.00348,35022,30.43063,115088
2170,Netbulae,4,0.00348,35026,30.43410,115088
2171,nicktgr15,4,0.00348,35030,30.43758,115088
2172,nico2610,4,0.00348,35034,30.44105,115088
2173,nikitka,4,0.00348,35038,30.44453,115088
2174,nikoskalenzis,4,0.00348,35042,30.44801,115088
2175,NitinRanjan,4,0.00348,35046,30.45148,115088
2176,nkawa,4,0.00348,35050,30.45496,115088
2177,nlawson,4,0.00348,35054,30.45843,115088
2178,nobuyukioishi,4,0.00348,35058,30.46191,115088
2179,nyilmaz,4,0.00348,35062,30.46538,115088
2180,o1da,4,0.00348,35066,30.46886,115088
2181,oemdaro,4,0.00348,35070,30.47233,115088
2182,ogis-uematsu,4,0.00348,35074,30.47581,115088
2183,oogali,4,0.00348,35078,30.47929,115088
2184,openchung,4,0.00348,35082,30.48276,115088
2185,operaun,4,0.00348,35086,30.48624,115088
2186,orenzp,4,0.00348,35090,30.48971,115088
2187,ostkrok,4,0.00348,35094,30.49319,115088
2188,otokunaga2,4,0.00348,35098,30.49666,115088
2189,PACordonnier,4,0.00348,35102,30.50014,115088
2190,pankajgrovertt,4,0.00348,35106,30.50361,115088
2191,panlilu,4,0.00348,35110,30.50709,115088
2192,pantocrator27,4,0.00348,35114,30.51057,115088
2193,paritosh16,4,0.00348,35118,30.51404,115088
2194,parkhyeonghwa,4,0.00348,35122,30.51752,115088
2195,peter-slovak,4,0.00348,35126,30.52099,115088
2196,phoefflin,4,0.00348,35130,30.52447,115088
2197,pi3ch,4,0.00348,35134,30.52794,115088
2198,Pigmalion,4,0.00348,35138,30.53142,115088
2199,pirankashani,4,0.00348,35142,30.53490,115088
2200,pivelpin,4,0.00348,35146,30.53837,115088
2201,pranavmarla,4,0.00348,35150,30.54185,115088
2202,Projoke,4,0.00348,35154,30.54532,115088
2203,purva1192,4,0.00348,35158,30.54880,115088
2204,puyuan,4,0.00348,35162,30.55227,115088
2205,qasmi,4,0.00348,35166,30.55575,115088
2206,qburst-anoop,4,0.00348,35170,30.55922,115088
2207,qdtuvx,4,0.00348,35174,30.56270,115088
2208,qqbuby,4,0.00348,35178,30.56618,115088
2209,radenui,4,0.00348,35182,30.56965,115088
2210,RafaelSzefler,4,0.00348,35186,30.57313,115088
2211,rail44,4,0.00348,35190,30.57660,115088
2212,rajmechi,4,0.00348,35194,30.58008,115088
2213,rchady,4,0.00348,35198,30.58355,115088
2214,recipedude,4,0.00348,35202,30.58703,115088
2215,redlolgeerf,4,0.00348,35206,30.59050,115088
2216,ReenaAcharya,4,0.00348,35210,30.59398,115088
2217,Reifier,4,0.00348,35214,30.59746,115088
2218,renaudguerin,4,0.00348,35218,30.60093,115088
2219,reneklacan,4,0.00348,35222,30.60441,115088
2220,renrenfree,4,0.00348,35226,30.60788,115088
2221,replay,4,0.00348,35230,30.61136,115088
2222,reubentonna,4,0.00348,35234,30.61483,115088
2223,rgomesf,4,0.00348,35238,30.61831,115088
2224,RiANOl,4,0.00348,35242,30.62179,115088
2225,richardburakowski,4,0.00348,35246,30.62526,115088
2226,rjsorensen,4,0.00348,35250,30.62874,115088
2227,rkooo567,4,0.00348,35254,30.63221,115088
2228,robertchen,4,0.00348,35258,30.63569,115088
2229,rodaan,4,0.00348,35262,30.63916,115088
2230,roemsi,4,0.00348,35266,30.64264,115088
2231,RolphH,4,0.00348,35270,30.64611,115088
2232,romainr,4,0.00348,35274,30.64959,115088
2233,ronhopper,4,0.00348,35278,30.65307,115088
2234,roycarser,4,0.00348,35282,30.65654,115088
2235,rpgarcia,4,0.00348,35286,30.66002,115088
2236,rsilva-nk,4,0.00348,35290,30.66349,115088
2237,ruanwz,4,0.00348,35294,30.66697,115088
2238,rud,4,0.00348,35298,30.67044,115088
2239,RyanMcDonald,4,0.00348,35302,30.67392,115088
2240,rykov,4,0.00348,35306,30.67739,115088
2241,sagarinitcron,4,0.00348,35310,30.68087,115088
2242,salla2,4,0.00348,35314,30.68435,115088
2243,sallespro,4,0.00348,35318,30.68782,115088
2244,sami9gag,4,0.00348,35322,30.69130,115088
2245,sandats,4,0.00348,35326,30.69477,115088
2246,sanemat,4,0.00348,35330,30.69825,115088
2247,sanju090,4,0.00348,35334,30.70172,115088
2248,SatyabrataPadhi,4,0.00348,35338,30.70520,115088
2249,sayap,4,0.00348,35342,30.70868,115088
2250,sbruggeman,4,0.00348,35346,30.71215,115088
2251,ScottyFillups,4,0.00348,35350,30.71563,115088
2252,Screwland,4,0.00348,35354,30.71910,115088
2253,sdanieru,4,0.00348,35358,30.72258,115088
2254,seancurran157,4,0.00348,35362,30.72605,115088
2255,sehanko,4,0.00348,35366,30.72953,115088
2256,Seitanas,4,0.00348,35370,30.73300,115088
2257,semoac,4,0.00348,35374,30.73648,115088
2258,Seobeeee,4,0.00348,35378,30.73996,115088
2259,sestrel,4,0.00348,35382,30.74343,115088
2260,shaunwarman,4,0.00348,35386,30.74691,115088
2261,Shell32-Natsu,4,0.00348,35390,30.75038,115088
2262,shohelk,4,0.00348,35394,30.75386,115088
2263,shrinaththube,4,0.00348,35398,30.75733,115088
2264,shunsukeaihara,4,0.00348,35402,30.76081,115088
2265,singalravi,4,0.00348,35406,30.76428,115088
2266,sio2k,4,0.00348,35410,30.76776,115088
2267,SkyV0x,4,0.00348,35414,30.77124,115088
2268,smanpathak,4,0.00348,35418,30.77471,115088
2269,songshuone,4,0.00348,35422,30.77819,115088
2270,sonirahul,4,0.00348,35426,30.78166,115088
2271,soukicz,4,0.00348,35430,30.78514,115088
2272,spanktar,4,0.00348,35434,30.78861,115088
2273,spladug,4,0.00348,35438,30.79209,115088
2274,spohn-acc,4,0.00348,35442,30.79557,115088
2275,sri-05,4,0.00348,35446,30.79904,115088
2276,srlps,4,0.00348,35450,30.80252,115088
2277,stayman,4,0.00348,35454,30.80599,115088
2278,stevenc81,4,0.00348,35458,30.80947,115088
2279,stoshiya,4,0.00348,35462,30.81294,115088
2280,stszap,4,0.00348,35466,30.81642,115088
2281,suchisubhra,4,0.00348,35470,30.81989,115088
2282,sudabon,4,0.00348,35474,30.82337,115088
2283,syepes,4,0.00348,35478,30.82685,115088
2284,syohex,4,0.00348,35482,30.83032,115088
2285,syucream,4,0.00348,35486,30.83380,115088
2286,takai,4,0.00348,35490,30.83727,115088
2287,takamario,4,0.00348,35494,30.84075,115088
2288,takanamito,4,0.00348,35498,30.84422,115088
2289,takehito-kogure,4,0.00348,35502,30.84770,115088
2290,takeshiyako2,4,0.00348,35506,30.85117,115088
2291,talkraghu,4,0.00348,35510,30.85465,115088
2292,tamer-hassan,4,0.00348,35514,30.85813,115088
2293,tanermelikoglu,4,0.00348,35518,30.86160,115088
2294,Tatsuya-Yazaki,4,0.00348,35522,30.86508,115088
2295,tboerger,4,0.00348,35526,30.86855,115088
2296,tech-talks-india,4,0.00348,35530,30.87203,115088
2297,tevjef,4,0.00348,35534,30.87550,115088
2298,thadamski,4,0.00348,35538,30.87898,115088
2299,TheRealJoeLinux,4,0.00348,35542,30.88246,115088
2300,threewordphrase,4,0.00348,35546,30.88593,115088
2301,thrucker,4,0.00348,35550,30.88941,115088
2302,timuckun,4,0.00348,35554,30.89288,115088
2303,tjstansell,4,0.00348,35558,30.89636,115088
2304,tmsrjs,4,0.00348,35562,30.89983,115088
2305,toidi,4,0.00348,35566,30.90331,115088
2306,tokyowizard,4,0.00348,35570,30.90678,115088
2307,tom932,4,0.00348,35574,30.91026,115088
2308,TomekLacina,4,0.00348,35578,30.91374,115088
2309,tomelliff,4,0.00348,35582,30.91721,115088
2310,tomstreet,4,0.00348,35586,30.92069,115088
2311,toruuetani,4,0.00348,35590,30.92416,115088
2312,toya256,4,0.00348,35594,30.92764,115088
2313,trevorrowe,4,0.00348,35598,30.93111,115088
2314,troy,4,0.00348,35602,30.93459,115088
2315,trungduyvu,4,0.00348,35606,30.93806,115088
2316,tsailiming,4,0.00348,35610,30.94154,115088
2317,ttyz,4,0.00348,35614,30.94502,115088
2318,tux-00,4,0.00348,35618,30.94849,115088
2319,UberMouse,4,0.00348,35622,30.95197,115088
2320,uncycler,4,0.00348,35626,30.95544,115088
2321,urg,4,0.00348,35630,30.95892,115088
2322,urtho,4,0.00348,35634,30.96239,115088
2323,uttamanand,4,0.00348,35638,30.96587,115088
2324,uudashr,4,0.00348,35642,30.96935,115088
2325,v1r7u,4,0.00348,35646,30.97282,115088
2326,valdas406,4,0.00348,35650,30.97630,115088
2327,varmad,4,0.00348,35654,30.97977,115088
2328,varuns-zetaris,4,0.00348,35658,30.98325,115088
2329,varun-tdt,4,0.00348,35662,30.98672,115088
2330,vasi-grigo,4,0.00348,35666,30.99020,115088
2331,vigasin,4,0.00348,35670,30.99367,115088
2332,vitclone,4,0.00348,35674,30.99715,115088
2333,vladm,4,0.00348,35678,31.00063,115088
2334,vwbusguy,4,0.00348,35682,31.00410,115088
2335,w32-blaster,4,0.00348,35686,31.00758,115088
2336,wanghonglei5181,4,0.00348,35690,31.01105,115088
2337,wangjiqing,4,0.00348,35694,31.01453,115088
2338,wcarlsen,4,0.00348,35698,31.01800,115088
2339,wgzhao,4,0.00348,35702,31.02148,115088
2340,wofeiwo,4,0.00348,35706,31.02495,115088
2341,Wolodija,4,0.00348,35710,31.02843,115088
2342,wujinhu,4,0.00348,35714,31.03191,115088
2343,wydream,4,0.00348,35718,31.03538,115088
2344,wyTrivail,4,0.00348,35722,31.03886,115088
2345,wzyplus,4,0.00348,35726,31.04233,115088
2346,x1-,4,0.00348,35730,31.04581,115088
2347,xeno010,4,0.00348,35734,31.04928,115088
2348,xh9,4,0.00348,35738,31.05276,115088
2349,yanif,4,0.00348,35742,31.05624,115088
2350,yasuoza,4,0.00348,35746,31.05971,115088
2351,yichenghuang,4,0.00348,35750,31.06319,115088
2352,ymotongpoo,4,0.00348,35754,31.06666,115088
2353,youyo,4,0.00348,35758,31.07014,115088
2354,ysksn,4,0.00348,35762,31.07361,115088
2355,ysundar,4,0.00348,35766,31.07709,115088
2356,yuchen9459,4,0.00348,35770,31.08056,115088
2357,zensh,4,0.00348,35774,31.08404,115088
2358,zerdliu,4,0.00348,35778,31.08752,115088
2359,ZhangSIming-blyq,4,0.00348,35782,31.09099,115088
2360,zjesse713,4,0.00348,35786,31.09447,115088
2361,178inaba,3,0.00261,35789,31.09707,115088
2362,7FX,3,0.00261,35792,31.09968,115088
2363,acgustafson,3,0.00261,35795,31.10229,115088
2364,achinchen,3,0.00261,35798,31.10489,115088
2365,achin-netskope,3,0.00261,35801,31.10750,115088
2366,ackintosh,3,0.00261,35804,31.11011,115088
2367,adejongh,3,0.00261,35807,31.11271,115088
2368,admssa,3,0.00261,35810,31.11532,115088
2369,adq,3,0.00261,35813,31.11793,115088
2370,ae-dg,3,0.00261,35816,31.12053,115088
2371,aehlke,3,0.00261,35819,31.12314,115088
2372,aftabnaveed,3,0.00261,35822,31.12575,115088
2373,agaffney,3,0.00261,35825,31.12835,115088
2374,ajcrowe,3,0.00261,35828,31.13096,115088
2375,AjeetK,3,0.00261,35831,31.13357,115088
2376,ajleslie,3,0.00261,35834,31.13617,115088
2377,AJouaneau-CS,3,0.00261,35837,31.13878,115088
2378,akalbhor,3,0.00261,35840,31.14139,115088
2379,akatsukitsubomi,3,0.00261,35843,31.14399,115088
2380,akensho,3,0.00261,35846,31.14660,115088
2381,akhan4u,3,0.00261,35849,31.14921,115088
2382,akshatsharma4,3,0.00261,35852,31.15181,115088
2383,alandtsang,3,0.00261,35855,31.15442,115088
2384,AlejoAsd,3,0.00261,35858,31.15703,115088
2385,alexanderoot,3,0.00261,35861,31.15963,115088
2386,alexandrz,3,0.00261,35864,31.16224,115088
2387,alexcurtin,3,0.00261,35867,31.16485,115088
2388,AlexMorreale,3,0.00261,35870,31.16745,115088
2389,alexnguyen91,3,0.00261,35873,31.17006,115088
2390,alex-vmw,3,0.00261,35876,31.17267,115088
2391,alice02,3,0.00261,35879,31.17527,115088
2392,alihushyar,3,0.00261,35882,31.17788,115088
2393,aluong,3,0.00261,35885,31.18049,115088
2394,alwinmarkcf,3,0.00261,35888,31.18309,115088
2395,amanjain08,3,0.00261,35891,31.18570,115088
2396,amitkumarjha,3,0.00261,35894,31.18831,115088
2397,andersosthus,3,0.00261,35897,31.19091,115088
2398,andrzejwp,3,0.00261,35900,31.19352,115088
2399,AniGarikipati,3,0.00261,35903,31.19613,115088
2400,anjanimax,3,0.00261,35906,31.19873,115088
2401,antofran22,3,0.00261,35909,31.20134,115088
2402,antonionappi88,3,0.00261,35912,31.20395,115088
2403,antonshi,3,0.00261,35915,31.20655,115088
2404,anup3000,3,0.00261,35918,31.20916,115088
2405,anuragensemble,3,0.00261,35921,31.21177,115088
2406,apurvis,3,0.00261,35924,31.21438,115088
2407,AqD,3,0.00261,35927,31.21698,115088
2408,arangyupgrade,3,0.00261,35930,31.21959,115088
2409,arcsr,3,0.00261,35933,31.22220,115088
2410,ardikabs,3,0.00261,35936,31.22480,115088
2411,arikunbotify,3,0.00261,35939,31.22741,115088
2412,arnitolog,3,0.00261,35942,31.23002,115088
2413,artheus,3,0.00261,35945,31.23262,115088
2414,asdf2014,3,0.00261,35948,31.23523,115088
2415,asdonation,3,0.00261,35951,31.23784,115088
2416,ashlineldridge,3,0.00261,35954,31.24044,115088
2417,ashutalewar,3,0.00261,35957,31.24305,115088
2418,autumnw,3,0.00261,35960,31.24566,115088
2419,Avanzato,3,0.00261,35963,31.24826,115088
2420,AvnerCohen,3,0.00261,35966,31.25087,115088
2421,AyliD,3,0.00261,35969,31.25348,115088
2422,az3,3,0.00261,35972,31.25608,115088
2423,azamara,3,0.00261,35975,31.25869,115088
2424,azihsoyn,3,0.00261,35978,31.26130,115088
2425,baldeynz,3,0.00261,35981,31.26390,115088
2426,balraj111,3,0.00261,35984,31.26651,115088
2427,bbfoto,3,0.00261,35987,31.26912,115088
2428,bbkgh,3,0.00261,35990,31.27172,115088
2429,bcg,3,0.00261,35993,31.27433,115088
2430,bderickson,3,0.00261,35996,31.27694,115088
2431,becrsh,3,0.00261,35999,31.27954,115088
2432,bernardd,3,0.00261,36002,31.28215,115088
2433,betawaffle,3,0.00261,36005,31.28476,115088
2434,bgagnon,3,0.00261,36008,31.28736,115088
2435,bgola-signalfx,3,0.00261,36011,31.28997,115088
2436,Bhavithrask,3,0.00261,36014,31.29258,115088
2437,bilalusean,3,0.00261,36017,31.29518,115088
2438,bingxunali,3,0.00261,36020,31.29779,115088
2439,Bizzelicious,3,0.00261,36023,31.30040,115088
2440,Blasterdick,3,0.00261,36026,31.30300,115088
2441,brainlid,3,0.00261,36029,31.30561,115088
2442,brendanhill,3,0.00261,36032,31.30822,115088
2443,BrunoAndrade,3,0.00261,36035,31.31082,115088
2444,bryanchapman9999,3,0.00261,36038,31.31343,115088
2445,btwood,3,0.00261,36041,31.31604,115088
2446,campbel,3,0.00261,36044,31.31864,115088
2447,caquino,3,0.00261,36047,31.32125,115088
2448,cbharathnoor,3,0.00261,36050,31.32386,115088
2449,cessien,3,0.00261,36053,31.32646,115088
2450,ch1aki,3,0.00261,36056,31.32907,115088
2451,chapmonkey,3,0.00261,36059,31.33168,115088
2452,cheer1hao,3,0.00261,36062,31.33428,115088
2453,chen-anders,3,0.00261,36065,31.33689,115088
2454,chenguolin,3,0.00261,36068,31.33950,115088
2455,chentom88,3,0.00261,36071,31.34210,115088
2456,ChenZheOnePiece,3,0.00261,36074,31.34471,115088
2457,chriskinsman,3,0.00261,36077,31.34732,115088
2458,chrislee87,3,0.00261,36080,31.34992,115088
2459,ChristianTrolleMikkelsen,3,0.00261,36083,31.35253,115088
2460,christidis,3,0.00261,36086,31.35514,115088
2461,chroche,3,0.00261,36089,31.35774,115088
2462,chrono,3,0.00261,36092,31.36035,115088
2463,cimframe,3,0.00261,36095,31.36296,115088
2464,Cisneiros,3,0.00261,36098,31.36556,115088
2465,ckannon,3,0.00261,36101,31.36817,115088
2466,clauzewitz,3,0.00261,36104,31.37078,115088
2467,clear10,3,0.00261,36107,31.37338,115088
2468,clintkim88,3,0.00261,36110,31.37599,115088
2469,cloud-sec,3,0.00261,36113,31.37860,115088
2470,clu-0x80,3,0.00261,36116,31.38120,115088
2471,codepainters,3,0.00261,36119,31.38381,115088
2472,Code-ReaQtor,3,0.00261,36122,31.38642,115088
2473,ColDog,3,0.00261,36125,31.38902,115088
2474,colin-streicher,3,0.00261,36128,31.39163,115088
2475,compucandi,3,0.00261,36131,31.39424,115088
2476,computeracer,3,0.00261,36134,31.39684,115088
2477,coreyt,3,0.00261,36137,31.39945,115088
2478,cristgl,3,0.00261,36140,31.40206,115088
2479,cscollett,3,0.00261,36143,31.40466,115088
2480,csdaraujo,3,0.00261,36146,31.40727,115088
2481,cyberabis,3,0.00261,36149,31.40988,115088
2482,cyberroadie,3,0.00261,36152,31.41248,115088
2483,daic-h,3,0.00261,36155,31.41509,115088
2484,daigoroz,3,0.00261,36158,31.41770,115088
2485,DaisukeHayata,3,0.00261,36161,31.42030,115088
2486,daliclass,3,0.00261,36164,31.42291,115088
2487,dalizard,3,0.00261,36167,31.42552,115088
2488,damluji,3,0.00261,36170,31.42812,115088
2489,danfoxley,3,0.00261,36173,31.43073,115088
2490,danielsig727,3,0.00261,36176,31.43334,115088
2491,danischroeter,3,0.00261,36179,31.43594,115088
2492,danmassie,3,0.00261,36182,31.43855,115088
2493,darkdep,3,0.00261,36185,31.44116,115088
2494,Darrelk,3,0.00261,36188,31.44376,115088
2495,darrylb-github,3,0.00261,36191,31.44637,115088
2496,dartvaper,3,0.00261,36194,31.44898,115088
2497,davideagle,3,0.00261,36197,31.45158,115088
2498,davidhybner,3,0.00261,36200,31.45419,115088
2499,dbaldwin-splunk,3,0.00261,36203,31.45680,115088
2500,dbeal-wiser,3,0.00261,36206,31.45940,115088
2501,dcrn,3,0.00261,36209,31.46201,115088
2502,d-dmitry,3,0.00261,36212,31.46462,115088
2503,ddzero2c,3,0.00261,36215,31.46723,115088
2504,DeepakShivamurthy,3,0.00261,36218,31.46983,115088
2505,DEGoodman,3,0.00261,36221,31.47244,115088
2506,DengTin,3,0.00261,36224,31.47505,115088
2507,denis-singh,3,0.00261,36227,31.47765,115088
2508,derryos,3,0.00261,36230,31.48026,115088
2509,dev-e,3,0.00261,36233,31.48287,115088
2510,devin-hpcnt,3,0.00261,36236,31.48547,115088
2511,dgomesbr,3,0.00261,36239,31.48808,115088
2512,dguendisch,3,0.00261,36242,31.49069,115088
2513,didodido85,3,0.00261,36245,31.49329,115088
2514,diegodf,3,0.00261,36248,31.49590,115088
2515,digitalsanity,3,0.00261,36251,31.49851,115088
2516,disq,3,0.00261,36254,31.50111,115088
2517,diwakergupta,3,0.00261,36257,31.50372,115088
2518,dixentw,3,0.00261,36260,31.50633,115088
2519,dkavraal,3,0.00261,36263,31.50893,115088
2520,dkirrane,3,0.00261,36266,31.51154,115088
2521,dmigous,3,0.00261,36269,31.51415,115088
2522,dminca,3,0.00261,36272,31.51675,115088
2523,dmxlsj,3,0.00261,36275,31.51936,115088
2524,Dom-R,3,0.00261,36278,31.52197,115088
2525,dorongutman,3,0.00261,36281,31.52457,115088
2526,dshackith,3,0.00261,36284,31.52718,115088
2527,dukex,3,0.00261,36287,31.52979,115088
2528,dvydra,3,0.00261,36290,31.53239,115088
2529,edify42,3,0.00261,36293,31.53500,115088
2530,edmeister,3,0.00261,36296,31.53761,115088
2531,ekarisky,3,0.00261,36299,31.54021,115088
2532,ekesken,3,0.00261,36302,31.54282,115088
2533,eKIK,3,0.00261,36305,31.54543,115088
2534,ekosilitonga,3,0.00261,36308,31.54803,115088
2535,elvisgiv,3,0.00261,36311,31.55064,115088
2536,emanueleliardo,3,0.00261,36314,31.55325,115088
2537,enarciso,3,0.00261,36317,31.55585,115088
2538,EndlessPancake,3,0.00261,36320,31.55846,115088
2539,epelc,3,0.00261,36323,31.56107,115088
2540,eplodn,3,0.00261,36326,31.56367,115088
2541,erez-rabih,3,0.00261,36329,31.56628,115088
2542,eric,3,0.00261,36332,31.56889,115088
2543,ericsage,3,0.00261,36335,31.57149,115088
2544,ericy-jana,3,0.00261,36338,31.57410,115088
2545,erms77,3,0.00261,36341,31.57671,115088
2546,eskuai,3,0.00261,36344,31.57931,115088
2547,estuart,3,0.00261,36347,31.58192,115088
2548,Evan-S,3,0.00261,36350,31.58453,115088
2549,evenh,3,0.00261,36353,31.58713,115088
2550,EverGreen5455,3,0.00261,36356,31.58974,115088
2551,Evertvz,3,0.00261,36359,31.59235,115088
2552,everythings-gonna-be-alright,3,0.00261,36362,31.59495,115088
2553,falau,3,0.00261,36365,31.59756,115088
2554,fatfatson,3,0.00261,36368,31.60017,115088
2555,faust64,3,0.00261,36371,31.60277,115088
2556,fazil1987,3,0.00261,36374,31.60538,115088
2557,fekigor,3,0.00261,36377,31.60799,115088
2558,femueller,3,0.00261,36380,31.61059,115088
2559,ffahri,3,0.00261,36383,31.61320,115088
2560,fgranato,3,0.00261,36386,31.61581,115088
2561,fideloper,3,0.00261,36389,31.61841,115088
2562,fieryvova,3,0.00261,36392,31.62102,115088
2563,fireboy1919,3,0.00261,36395,31.62363,115088
2564,fkgre,3,0.00261,36398,31.62623,115088
2565,Flashdown,3,0.00261,36401,31.62884,115088
2566,flaviotorres,3,0.00261,36404,31.63145,115088
2567,fleprovost,3,0.00261,36407,31.63405,115088
2568,flippyflap,3,0.00261,36410,31.63666,115088
2569,florimondmanca,3,0.00261,36413,31.63927,115088
2570,frahe,3,0.00261,36416,31.64187,115088
2571,from-nibly,3,0.00261,36419,31.64448,115088
2572,fukayatsu,3,0.00261,36422,31.64709,115088
2573,fukuiretu,3,0.00261,36425,31.64969,115088
2574,gamkiller77,3,0.00261,36428,31.65230,115088
2575,gappan,3,0.00261,36431,31.65491,115088
2576,GauravRai-GSLab,3,0.00261,36434,31.65751,115088
2577,gcavalcante8808,3,0.00261,36437,31.66012,115088
2578,george-unbotify,3,0.00261,36440,31.66273,115088
2579,GeorgiMateev,3,0.00261,36443,31.66533,115088
2580,gfawcett22,3,0.00261,36446,31.66794,115088
2581,ggoinden-rms,3,0.00261,36449,31.67055,115088
2582,githubskipper,3,0.00261,36452,31.67315,115088
2583,glbyers,3,0.00261,36455,31.67576,115088
2584,glesperance,3,0.00261,36458,31.67837,115088
2585,gma-git-admin,3,0.00261,36461,31.68097,115088
2586,gmsecrieru,3,0.00261,36464,31.68358,115088
2587,goodard,3,0.00261,36467,31.68619,115088
2588,gordonlee,3,0.00261,36470,31.68879,115088
2589,graysonc,3,0.00261,36473,31.69140,115088
2590,grepory,3,0.00261,36476,31.69401,115088
2591,grigorov,3,0.00261,36479,31.69661,115088
2592,groulot,3,0.00261,36482,31.69922,115088
2593,grv231,3,0.00261,36485,31.70183,115088
2594,Guyverix,3,0.00261,36488,31.70443,115088
2595,gyant,3,0.00261,36491,31.70704,115088
2596,GypsyCosmonaut,3,0.00261,36494,31.70965,115088
2597,hagaeru3sei,3,0.00261,36497,31.71225,115088
2598,HaiTo,3,0.00261,36500,31.71486,115088
2599,hanachin,3,0.00261,36503,31.71747,115088
2600,hanyijun,3,0.00261,36506,31.72008,115088
2601,hao7860286,3,0.00261,36509,31.72268,115088
2602,haoxiaoci,3,0.00261,36512,31.72529,115088
2603,harsxv,3,0.00261,36515,31.72790,115088
2604,hectorhuertas,3,0.00261,36518,31.73050,115088
2605,helix,3,0.00261,36521,31.73311,115088
2606,holycheater,3,0.00261,36524,31.73572,115088
2607,hoperays,3,0.00261,36527,31.73832,115088
2608,hrdcdr,3,0.00261,36530,31.74093,115088
2609,huacnlee,3,0.00261,36533,31.74354,115088
2610,huangyingting,3,0.00261,36536,31.74614,115088
2611,huegelc,3,0.00261,36539,31.74875,115088
2612,huembi,3,0.00261,36542,31.75136,115088
2613,hugegreenbug,3,0.00261,36545,31.75396,115088
2614,hunshenshi,3,0.00261,36548,31.75657,115088
2615,huynq0911,3,0.00261,36551,31.75918,115088
2616,Hwting,3,0.00261,36554,31.76178,115088
2617,hyadav5,3,0.00261,36557,31.76439,115088
2618,hychen,3,0.00261,36560,31.76700,115088
2619,hythloday,3,0.00261,36563,31.76960,115088
2620,i02sopop,3,0.00261,36566,31.77221,115088
2621,iamshreeram,3,0.00261,36569,31.77482,115088
2622,ianjoneill,3,0.00261,36572,31.77742,115088
2623,IBUMBLEBEE,3,0.00261,36575,31.78003,115088
2624,ictcorebiz,3,0.00261,36578,31.78264,115088
2625,igtsekov,3,0.00261,36581,31.78524,115088
2626,iitenkida7,3,0.00261,36584,31.78785,115088
2627,iliecz,3,0.00261,36587,31.79046,115088
2628,ilovemysillybanana,3,0.00261,36590,31.79306,115088
2629,imkira,3,0.00261,36593,31.79567,115088
2630,imranrazakhan,3,0.00261,36596,31.79828,115088
2631,inthuriel,3,0.00261,36599,31.80088,115088
2632,ioquatix,3,0.00261,36602,31.80349,115088
2633,ippei-fukamatsu,3,0.00261,36605,31.80610,115088
2634,ishkanan,3,0.00261,36608,31.80870,115088
2635,itkq,3,0.00261,36611,31.81131,115088
2636,j3grewal,3,0.00261,36614,31.81392,115088
2637,jace,3,0.00261,36617,31.81652,115088
2638,jacekszubert,3,0.00261,36620,31.81913,115088
2639,Jacky2,3,0.00261,36623,31.82174,115088
2640,jacoelho,3,0.00261,36626,31.82434,115088
2641,JaeGeunBang,3,0.00261,36629,31.82695,115088
2642,jalberto,3,0.00261,36632,31.82956,115088
2643,jamesongithub,3,0.00261,36635,31.83216,115088
2644,Jamlee,3,0.00261,36638,31.83477,115088
2645,janekolszak,3,0.00261,36641,31.83738,115088
2646,janosroden,3,0.00261,36644,31.83998,115088
2647,jantzenallphin,3,0.00261,36647,31.84259,115088
2648,jardiacaj,3,0.00261,36650,31.84520,115088
2649,jasimmk,3,0.00261,36653,31.84780,115088
2650,jaul,3,0.00261,36656,31.85041,115088
2651,jayeshnazre,3,0.00261,36659,31.85302,115088
2652,JBury-rms,3,0.00261,36662,31.85562,115088
2653,j-chao,3,0.00261,36665,31.85823,115088
2654,jeffdesc,3,0.00261,36668,31.86084,115088
2655,jerry924,3,0.00261,36671,31.86344,115088
2656,jhuntwork,3,0.00261,36674,31.86605,115088
2657,jiaxuanzhou,3,0.00261,36677,31.86866,115088
2658,jjanier,3,0.00261,36680,31.87126,115088
2659,jkupferer,3,0.00261,36683,31.87387,115088
2660,jlsalmon,3,0.00261,36686,31.87648,115088
2661,jmalobicky,3,0.00261,36689,31.87908,115088
2662,jmcastellote,3,0.00261,36692,31.88169,115088
2663,jmglsn,3,0.00261,36695,31.88430,115088
2664,joelthompson,3,0.00261,36698,31.88690,115088
2665,joesonw,3,0.00261,36701,31.88951,115088
2666,jogendrajangid1,3,0.00261,36704,31.89212,115088
2667,JohannWeging,3,0.00261,36707,31.89472,115088
2668,johnr-spindance,3,0.00261,36710,31.89733,115088
2669,jonahb,3,0.00261,36713,31.89994,115088
2670,jonathancrosmer,3,0.00261,36716,31.90254,115088
2671,jonathanhle,3,0.00261,36719,31.90515,115088
2672,jondot,3,0.00261,36722,31.90776,115088
2673,jonhadfield,3,0.00261,36725,31.91036,115088
2674,jordanwu97,3,0.00261,36728,31.91297,115088
2675,jorgerod,3,0.00261,36731,31.91558,115088
2676,jose-cieni-movile,3,0.00261,36734,31.91818,115088
2677,josefernandes,3,0.00261,36737,31.92079,115088
2678,josefjanda,3,0.00261,36740,31.92340,115088
2679,joseph-lum,3,0.00261,36743,31.92600,115088
2680,josselinchevalay,3,0.00261,36746,31.92861,115088
2681,joyarzun,3,0.00261,36749,31.93122,115088
2682,jpdenford,3,0.00261,36752,31.93382,115088
2683,jpds,3,0.00261,36755,31.93643,115088
2684,jpelletier-dad,3,0.00261,36758,31.93904,115088
2685,jpke,3,0.00261,36761,31.94164,115088
2686,jregovic,3,0.00261,36764,31.94425,115088
2687,jshen28,3,0.00261,36767,31.94686,115088
2688,jt1,3,0.00261,36770,31.94946,115088
2689,JTabel,3,0.00261,36773,31.95207,115088
2690,jtwile2,3,0.00261,36776,31.95468,115088
2691,julienvincent,3,0.00261,36779,31.95728,115088
2692,j-un,3,0.00261,36782,31.95989,115088
2693,juntagabor,3,0.00261,36785,31.96250,115088
2694,JustDolanIt,3,0.00261,36788,31.96510,115088
2695,jvassev,3,0.00261,36791,31.96771,115088
2696,kabali12345,3,0.00261,36794,31.97032,115088
2697,Kakakakakku,3,0.00261,36797,31.97293,115088
2698,kamikaseda,3,0.00261,36800,31.97553,115088
2699,karol-brejna-i,3,0.00261,36803,31.97814,115088
2700,Kartik-28,3,0.00261,36806,31.98075,115088
2701,kasiprasad,3,0.00261,36809,31.98335,115088
2702,katzchang,3,0.00261,36812,31.98596,115088
2703,kaznishi,3,0.00261,36815,31.98857,115088
2704,Kefa7y,3,0.00261,36818,31.99117,115088
2705,kelassar-zodis,3,0.00261,36821,31.99378,115088
2706,kelonye,3,0.00261,36824,31.99639,115088
2707,kendi,3,0.00261,36827,31.99899,115088
2708,kesuzuki,3,0.00261,36830,32.00160,115088
2709,kevinchiu,3,0.00261,36833,32.00421,115088
2710,kilya11,3,0.00261,36836,32.00681,115088
2711,kishoreck,3,0.00261,36839,32.00942,115088
2712,kishorramanan,3,0.00261,36842,32.01203,115088
2713,kmevissen,3,0.00261,36845,32.01463,115088
2714,kmizu,3,0.00261,36848,32.01724,115088
2715,KobacDice,3,0.00261,36851,32.01985,115088
2716,Konboi,3,0.00261,36854,32.02245,115088
2717,Korkd,3,0.00261,36857,32.02506,115088
2718,kozz,3,0.00261,36860,32.02767,115088
2719,kplimack,3,0.00261,36863,32.03027,115088
2720,krankin,3,0.00261,36866,32.03288,115088
2721,krishnatrivedi,3,0.00261,36869,32.03549,115088
2722,ksauzz,3,0.00261,36872,32.03809,115088
2723,ksemaev,3,0.00261,36875,32.04070,115088
2724,kukai,3,0.00261,36878,32.04331,115088
2725,kumai,3,0.00261,36881,32.04591,115088
2726,kxuanCeltik,3,0.00261,36884,32.04852,115088
2727,LakshithadeSilva,3,0.00261,36887,32.05113,115088
2728,lala7573,3,0.00261,36890,32.05373,115088
2729,lancelakey,3,0.00261,36893,32.05634,115088
2730,ldelossa,3,0.00261,36896,32.05895,115088
2731,leafchild0,3,0.00261,36899,32.06155,115088
2732,leandrol,3,0.00261,36902,32.06416,115088
2733,ledroide,3,0.00261,36905,32.06677,115088
2734,lee-byeoksan,3,0.00261,36908,32.06937,115088
2735,lei-sumo,3,0.00261,36911,32.07198,115088
2736,lesovsky,3,0.00261,36914,32.07459,115088
2737,LesTR,3,0.00261,36917,32.07719,115088
2738,leverich,3,0.00261,36920,32.07980,115088
2739,lidocaineus,3,0.00261,36923,32.08241,115088
2740,lijunyong,3,0.00261,36926,32.08501,115088
2741,liviaerxin,3,0.00261,36929,32.08762,115088
2742,llarsson,3,0.00261,36932,32.09023,115088
2743,llchen223,3,0.00261,36935,32.09283,115088
2744,llou,3,0.00261,36938,32.09544,115088
2745,Lokicity,3,0.00261,36941,32.09805,115088
2746,loposk,3,0.00261,36944,32.10065,115088
2747,Losakoa,3,0.00261,36947,32.10326,115088
2748,lsadehaan,3,0.00261,36950,32.10587,115088
2749,lucas-aragno,3,0.00261,36953,32.10847,115088
2750,lucasbasquerotto,3,0.00261,36956,32.11108,115088
2751,lucasteles22,3,0.00261,36959,32.11369,115088
2752,madkote,3,0.00261,36962,32.11629,115088
2753,malinoff,3,0.00261,36965,32.11890,115088
2754,Manikandan-Raj,3,0.00261,36968,32.12151,115088
2755,mansours,3,0.00261,36971,32.12411,115088
2756,MarcelHillmann,3,0.00261,36974,32.12672,115088
2757,MarkHeddaeus,3,0.00261,36977,32.12933,115088
2758,Marki4711,3,0.00261,36980,32.13193,115088
2759,marobson,3,0.00261,36983,32.13454,115088
2760,marono,3,0.00261,36986,32.13715,115088
2761,MartinForReal,3,0.00261,36989,32.13975,115088
2762,masterkain,3,0.00261,36992,32.14236,115088
2763,mattpardee,3,0.00261,36995,32.14497,115088
2764,maust,3,0.00261,36998,32.14757,115088
2765,maverick-racheal,3,0.00261,37001,32.15018,115088
2766,maxd,3,0.00261,37004,32.15279,115088
2767,mbelchin,3,0.00261,37007,32.15539,115088
2768,mbennett-zendesk,3,0.00261,37010,32.15800,115088
2769,mcdoker18,3,0.00261,37013,32.16061,115088
2770,mclarke47,3,0.00261,37016,32.16321,115088
2771,mdasilva,3,0.00261,37019,32.16582,115088
2772,mduncan26,3,0.00261,37022,32.16843,115088
2773,Mehonoshin,3,0.00261,37025,32.17103,115088
2774,meotimdihia,3,0.00261,37028,32.17364,115088
2775,mercuriev,3,0.00261,37031,32.17625,115088
2776,mgcrea,3,0.00261,37034,32.17885,115088
2777,mhoshino,3,0.00261,37037,32.18146,115088
2778,mhowsden,3,0.00261,37040,32.18407,115088
2779,michaelarick,3,0.00261,37043,32.18667,115088
2780,michnmi,3,0.00261,37046,32.18928,115088
2781,mickey,3,0.00261,37049,32.19189,115088
2782,micklonge,3,0.00261,37052,32.19449,115088
2783,mikehu,3,0.00261,37055,32.19710,115088
2784,mikeleeme,3,0.00261,37058,32.19971,115088
2785,mikesphar,3,0.00261,37061,32.20231,115088
2786,miketonks,3,0.00261,37064,32.20492,115088
2787,milan-koudelka,3,0.00261,37067,32.20753,115088
2788,miono,3,0.00261,37070,32.21013,115088
2789,missourian55,3,0.00261,37073,32.21274,115088
2790,misteryiz,3,0.00261,37076,32.21535,115088
2791,mitch-sge,3,0.00261,37079,32.21795,115088
2792,miyaichi,3,0.00261,37082,32.22056,115088
2793,mjhoffman65,3,0.00261,37085,32.22317,115088
2794,mkazlouski,3,0.00261,37088,32.22578,115088
2795,moduspwnens,3,0.00261,37091,32.22838,115088
2796,mohit-gupta,3,0.00261,37094,32.23099,115088
2797,MouceL,3,0.00261,37097,32.23360,115088
2798,mpackard-tracelink,3,0.00261,37100,32.23620,115088
2799,mrmainnet,3,0.00261,37103,32.23881,115088
2800,mrodriguezio,3,0.00261,37106,32.24142,115088
2801,mrudrego,3,0.00261,37109,32.24402,115088
2802,mstoops,3,0.00261,37112,32.24663,115088
2803,msysh,3,0.00261,37115,32.24924,115088
2804,muceres,3,0.00261,37118,32.25184,115088
2805,muffin87,3,0.00261,37121,32.25445,115088
2806,muraliready,3,0.00261,37124,32.25706,115088
2807,Mymetique,3,0.00261,37127,32.25966,115088
2808,myspotontheweb,3,0.00261,37130,32.26227,115088
2809,n0ts,3,0.00261,37133,32.26488,115088
2810,naoki-iwami,3,0.00261,37136,32.26748,115088
2811,NawarA,3,0.00261,37139,32.27009,115088
2812,nazo,3,0.00261,37142,32.27270,115088
2813,nbenjamin,3,0.00261,37145,32.27530,115088
2814,nc-ruth,3,0.00261,37148,32.27791,115088
2815,ndemoor,3,0.00261,37151,32.28052,115088
2816,neoxack,3,0.00261,37154,32.28312,115088
2817,nerro,3,0.00261,37157,32.28573,115088
2818,NetForces,3,0.00261,37160,32.28834,115088
2819,netmarkjp,3,0.00261,37163,32.29094,115088
2820,NfNitLoop,3,0.00261,37166,32.29355,115088
2821,nhamlh,3,0.00261,37169,32.29616,115088
2822,nicgrayson,3,0.00261,37172,32.29876,115088
2823,nickwq,3,0.00261,37175,32.30137,115088
2824,nieldomingo,3,0.00261,37178,32.30398,115088
2825,nikhilraj474,3,0.00261,37181,32.30658,115088
2826,nikitozz,3,0.00261,37184,32.30919,115088
2827,nishanth-pinnapareddy,3,0.00261,37187,32.31180,115088
2828,nizarayari,3,0.00261,37190,32.31440,115088
2829,nlundbo,3,0.00261,37193,32.31701,115088
2830,nmohoric,3,0.00261,37196,32.31962,115088
2831,nodesocket,3,0.00261,37199,32.32222,115088
2832,nokk,3,0.00261,37202,32.32483,115088
2833,npappin-wsu,3,0.00261,37205,32.32744,115088
2834,nparfait,3,0.00261,37208,32.33004,115088
2835,nqbao,3,0.00261,37211,32.33265,115088
2836,n-rook,3,0.00261,37214,32.33526,115088
2837,nttdbpo-liudengke,3,0.00261,37217,32.33786,115088
2838,nukepuppy,3,0.00261,37220,32.34047,115088
2839,nweiler,3,0.00261,37223,32.34308,115088
2840,ofcourseican,3,0.00261,37226,32.34568,115088
2841,omame,3,0.00261,37229,32.34829,115088
2842,omoldes,3,0.00261,37232,32.35090,115088
2843,openbob,3,0.00261,37235,32.35350,115088
2844,operezfuentes,3,0.00261,37238,32.35611,115088
2845,OriHoch,3,0.00261,37241,32.35872,115088
2846,ottimo,3,0.00261,37244,32.36132,115088
2847,ouziel-slama,3,0.00261,37247,32.36393,115088
2848,ovcharenko,3,0.00261,37250,32.36654,115088
2849,overip,3,0.00261,37253,32.36914,115088
2850,pallan,3,0.00261,37256,32.37175,115088
2851,panaetov,3,0.00261,37259,32.37436,115088
2852,panda87,3,0.00261,37262,32.37696,115088
2853,pandeyrahulgwl,3,0.00261,37265,32.37957,115088
2854,paraita,3,0.00261,37268,32.38218,115088
2855,pareeksanjay05,3,0.00261,37271,32.38478,115088
2856,passos,3,0.00261,37274,32.38739,115088
2857,PatrikCyvoct,3,0.00261,37277,32.39000,115088
2858,peelandsee,3,0.00261,37280,32.39260,115088
2859,pellaeon,3,0.00261,37283,32.39521,115088
2860,pensz,3,0.00261,37286,32.39782,115088
2861,perriea,3,0.00261,37289,32.40042,115088
2862,pgrin,3,0.00261,37292,32.40303,115088
2863,philalex,3,0.00261,37295,32.40564,115088
2864,pi4alina,3,0.00261,37298,32.40824,115088
2865,pikrzysztof,3,0.00261,37301,32.41085,115088
2866,PiotrKlimczak,3,0.00261,37304,32.41346,115088
2867,pkang,3,0.00261,37307,32.41606,115088
2868,pkout,3,0.00261,37310,32.41867,115088
2869,plsmaop,3,0.00261,37313,32.42128,115088
2870,podilra,3,0.00261,37316,32.42388,115088
2871,poison,3,0.00261,37319,32.42649,115088
2872,pradeep-mishra,3,0.00261,37322,32.42910,115088
2873,pragmaticivan,3,0.00261,37325,32.43170,115088
2874,prasadkarkera,3,0.00261,37328,32.43431,115088
2875,prashantvicky,3,0.00261,37331,32.43692,115088
2876,prestonvanloon,3,0.00261,37334,32.43952,115088
2877,profhase,3,0.00261,37337,32.44213,115088
2878,ps7exp,3,0.00261,37340,32.44474,115088
2879,psinghc,3,0.00261,37343,32.44734,115088
2880,psychomelet,3,0.00261,37346,32.44995,115088
2881,Psyered,3,0.00261,37349,32.45256,115088
2882,putaotao,3,0.00261,37352,32.45516,115088
2883,qu823110460,3,0.00261,37355,32.45777,115088
2884,r0stig,3,0.00261,37358,32.46038,115088
2885,rafambbr,3,0.00261,37361,32.46298,115088
2886,raghuOrb,3,0.00261,37364,32.46559,115088
2887,rahul-chowdhury,3,0.00261,37367,32.46820,115088
2888,rajan471,3,0.00261,37370,32.47080,115088
2889,rajatvcsbuild,3,0.00261,37373,32.47341,115088
2890,rajiff,3,0.00261,37376,32.47602,115088
2891,ranjeetkgupta,3,0.00261,37379,32.47863,115088
2892,raviprakashshahi,3,0.00261,37382,32.48123,115088
2893,rbolkey,3,0.00261,37385,32.48384,115088
2894,ReadmeCritic,3,0.00261,37388,32.48645,115088
2895,rebeccacaroline,3,0.00261,37391,32.48905,115088
2896,reesechou2014,3,0.00261,37394,32.49166,115088
2897,resnostyle,3,0.00261,37397,32.49427,115088
2898,rheaton,3,0.00261,37400,32.49687,115088
2899,Rice-tt,3,0.00261,37403,32.49948,115088
2900,richarddevers,3,0.00261,37406,32.50209,115088
2901,risbarov,3,0.00261,37409,32.50469,115088
2902,riuvshin,3,0.00261,37412,32.50730,115088
2903,riuvshyn,3,0.00261,37415,32.50991,115088
2904,rksatyam,3,0.00261,37418,32.51251,115088
2905,rluisr,3,0.00261,37421,32.51512,115088
2906,rmelick,3,0.00261,37424,32.51773,115088
2907,RobertHeim,3,0.00261,37427,32.52033,115088
2908,RobertLippens,3,0.00261,37430,32.52294,115088
2909,RodolpheGohard,3,0.00261,37433,32.52555,115088
2910,roee-indegy,3,0.00261,37436,32.52815,115088
2911,roffe,3,0.00261,37439,32.53076,115088
2912,rogeriobastos,3,0.00261,37442,32.53337,115088
2913,RomanManz,3,0.00261,37445,32.53597,115088
2914,RootTJNII,3,0.00261,37448,32.53858,115088
2915,rossaffandy,3,0.00261,37451,32.54119,115088
2916,rossKayHe,3,0.00261,37454,32.54379,115088
2917,rrudduck,3,0.00261,37457,32.54640,115088
2918,rsingh2411,3,0.00261,37460,32.54901,115088
2919,rubencabrera,3,0.00261,37463,32.55161,115088
2920,RubenHoms,3,0.00261,37466,32.55422,115088
2921,rudyryk,3,0.00261,37469,32.55683,115088
2922,ruiwen,3,0.00261,37472,32.55943,115088
2923,runningstream,3,0.00261,37475,32.56204,115088
2924,rusia-rak,3,0.00261,37478,32.56465,115088
2925,ryushu,3,0.00261,37481,32.56725,115088
2926,ryutaroy,3,0.00261,37484,32.56986,115088
2927,rywater,3,0.00261,37487,32.57247,115088
2928,sanoyphilippe,3,0.00261,37490,32.57507,115088
2929,satyaakam,3,0.00261,37493,32.57768,115088
2930,sbocinec,3,0.00261,37496,32.58029,115088
2931,scanlonjts,3,0.00261,37499,32.58289,115088
2932,schainks,3,0.00261,37502,32.58550,115088
2933,schasse,3,0.00261,37505,32.58811,115088
2934,scheshan,3,0.00261,37508,32.59071,115088
2935,scottbessler,3,0.00261,37511,32.59332,115088
2936,sdduursma,3,0.00261,37514,32.59593,115088
2937,selerite,3,0.00261,37517,32.59853,115088
2938,serge-jomedia,3,0.00261,37520,32.60114,115088
2939,servo1x,3,0.00261,37523,32.60375,115088
2940,sgulati89,3,0.00261,37526,32.60635,115088
2941,shaburov,3,0.00261,37529,32.60896,115088
2942,shacharz,3,0.00261,37532,32.61157,115088
2943,shanmukha511,3,0.00261,37535,32.61417,115088
2944,shcherbak,3,0.00261,37538,32.61678,115088
2945,sherwinwangs,3,0.00261,37541,32.61939,115088
2946,shinji3887,3,0.00261,37544,32.62199,115088
2947,shonansurvivors,3,0.00261,37547,32.62460,115088
2948,shuxiang,3,0.00261,37550,32.62721,115088
2949,simonwh,3,0.00261,37553,32.62981,115088
2950,SireeshaKucherlapati,3,0.00261,37556,32.63242,115088
2951,Sjolus,3,0.00261,37559,32.63503,115088
2952,Skarlso,3,0.00261,37562,32.63763,115088
2953,skomer,3,0.00261,37565,32.64024,115088
2954,slaunay,3,0.00261,37568,32.64285,115088
2955,sldblog,3,0.00261,37571,32.64545,115088
2956,SleepyBrett,3,0.00261,37574,32.64806,115088
2957,slene,3,0.00261,37577,32.65067,115088
2958,smlx,3,0.00261,37580,32.65327,115088
2959,sony-shinichi-hatayama,3,0.00261,37583,32.65588,115088
2960,sotayamashita,3,0.00261,37586,32.65849,115088
2961,soulhead1mg,3,0.00261,37589,32.66109,115088
2962,spaelet,3,0.00261,37592,32.66370,115088
2963,spijet,3,0.00261,37595,32.66631,115088
2964,splnkit,3,0.00261,37598,32.66891,115088
2965,sprohaska,3,0.00261,37601,32.67152,115088
2966,sqsw,3,0.00261,37604,32.67413,115088
2967,srini38,3,0.00261,37607,32.67673,115088
2968,ssweens,3,0.00261,37610,32.67934,115088
2969,stager0909-ray,3,0.00261,37613,32.68195,115088
2970,stang,3,0.00261,37616,32.68455,115088
2971,stanimirovv,3,0.00261,37619,32.68716,115088
2972,staylor774,3,0.00261,37622,32.68977,115088
2973,stebbib,3,0.00261,37625,32.69237,115088
2974,stefanax,3,0.00261,37628,32.69498,115088
2975,steinliber,3,0.00261,37631,32.69759,115088
2976,stephen-lazarionok,3,0.00261,37634,32.70019,115088
2977,stepin,3,0.00261,37637,32.70280,115088
2978,Strainy,3,0.00261,37640,32.70541,115088
2979,strantalis,3,0.00261,37643,32.70801,115088
2980,StudioEtrange,3,0.00261,37646,32.71062,115088
2981,stuh84,3,0.00261,37649,32.71323,115088
2982,sueken5,3,0.00261,37652,32.71583,115088
2983,suganyp07,3,0.00261,37655,32.71844,115088
2984,summed,3,0.00261,37658,32.72105,115088
2985,surajsunrays,3,0.00261,37661,32.72365,115088
2986,Suresh7,3,0.00261,37664,32.72626,115088
2987,surfraz,3,0.00261,37667,32.72887,115088
2988,Sushisource,3,0.00261,37670,32.73148,115088
2989,suxarik,3,0.00261,37673,32.73408,115088
2990,suyambuganesh,3,0.00261,37676,32.73669,115088
2991,swapnilpatil1682,3,0.00261,37679,32.73930,115088
2992,ta32,3,0.00261,37682,32.74190,115088
2993,tacahilo,3,0.00261,37685,32.74451,115088
2994,taflahi,3,0.00261,37688,32.74712,115088
2995,TAKAyukiatkwsk,3,0.00261,37691,32.74972,115088
2996,takei-yuya,3,0.00261,37694,32.75233,115088
2997,tamu222i,3,0.00261,37697,32.75494,115088
2998,tangjiaxing669,3,0.00261,37700,32.75754,115088
2999,taniokae,3,0.00261,37703,32.76015,115088
3000,TankNut,3,0.00261,37706,32.76276,115088
3001,tarabaskara,3,0.00261,37709,32.76536,115088
3002,tasdikrahman,3,0.00261,37712,32.76797,115088
3003,taskinen,3,0.00261,37715,32.77058,115088
3004,tb2186,3,0.00261,37718,32.77318,115088
3005,tbickford,3,0.00261,37721,32.77579,115088
3006,t-cyrill,3,0.00261,37724,32.77840,115088
3007,tebriel,3,0.00261,37727,32.78100,115088
3008,telefax,3,0.00261,37730,32.78361,115088
3009,temoon,3,0.00261,37733,32.78622,115088
3010,teotwaki,3,0.00261,37736,32.78882,115088
3011,testzlx,3,0.00261,37739,32.79143,115088
3012,tetramin,3,0.00261,37742,32.79404,115088
3013,tgalyean,3,0.00261,37745,32.79664,115088
3014,Thanad,3,0.00261,37748,32.79925,115088
3015,thekantian,3,0.00261,37751,32.80186,115088
3016,theogravity,3,0.00261,37754,32.80446,115088
3017,thereverendtom,3,0.00261,37757,32.80707,115088
3018,thkoch2001,3,0.00261,37760,32.80968,115088
3019,thomaskrag,3,0.00261,37763,32.81228,115088
3020,thoriqsatriya,3,0.00261,37766,32.81489,115088
3021,ThorstenHans,3,0.00261,37769,32.81750,115088
3022,timopek,3,0.00261,37772,32.82010,115088
3023,tjensen,3,0.00261,37775,32.82271,115088
3024,todesking,3,0.00261,37778,32.82532,115088
3025,tonyjchong,3,0.00261,37781,32.82792,115088
3026,trentzhou,3,0.00261,37784,32.83053,115088
3027,Tri0L,3,0.00261,37787,32.83314,115088
3028,trickyfck,3,0.00261,37790,32.83574,115088
3029,truedat101,3,0.00261,37793,32.83835,115088
3030,tuki0918,3,0.00261,37796,32.84096,115088
3031,tuomasjjrasanen,3,0.00261,37799,32.84356,115088
3032,turbohoje,3,0.00261,37802,32.84617,115088
3033,twalla,3,0.00261,37805,32.84878,115088
3034,tylux,3,0.00261,37808,32.85138,115088
3035,udf2457,3,0.00261,37811,32.85399,115088
3036,udomsak,3,0.00261,37814,32.85660,115088
3037,unbornchikken,3,0.00261,37817,32.85920,115088
3038,uoguk,3,0.00261,37820,32.86181,115088
3039,u-shunya,3,0.00261,37823,32.86442,115088
3040,uskudnik,3,0.00261,37826,32.86702,115088
3041,vaidas-lungis,3,0.00261,37829,32.86963,115088
3042,varunkumta,3,0.00261,37832,32.87224,115088
3043,vbuciuc,3,0.00261,37835,32.87484,115088
3044,vector-sec,3,0.00261,37838,32.87745,115088
3045,vgoloviznin,3,0.00261,37841,32.88006,115088
3046,vicendominguez,3,0.00261,37844,32.88266,115088
3047,vigohe,3,0.00261,37847,32.88527,115088
3048,vijaypa1,3,0.00261,37850,32.88788,115088
3049,vikin91,3,0.00261,37853,32.89048,115088
3050,vikneels,3,0.00261,37856,32.89309,115088
3051,vimalmpatel,3,0.00261,37859,32.89570,115088
3052,viskoo,3,0.00261,37862,32.89830,115088
3053,vitchester,3,0.00261,37865,32.90091,115088
3054,vjove,3,0.00261,37868,32.90352,115088
3055,vladimirsavenkov,3,0.00261,37871,32.90612,115088
3056,vmironenko,3,0.00261,37874,32.90873,115088
3057,voidtcg,3,0.00261,37877,32.91134,115088
3058,vpistis,3,0.00261,37880,32.91394,115088
3059,vrst37,3,0.00261,37883,32.91655,115088
3060,vsinghal13,3,0.00261,37886,32.91916,115088
3061,w7374520,3,0.00261,37889,32.92176,115088
3062,walfie,3,0.00261,37892,32.92437,115088
3063,Wang-Kai,3,0.00261,37895,32.92698,115088
3064,wata-gh,3,0.00261,37898,32.92958,115088
3065,webteb,3,0.00261,37901,32.93219,115088
3066,weilliu,3,0.00261,37904,32.93480,115088
3067,whithajess,3,0.00261,37907,32.93740,115088
3068,widgetpl,3,0.00261,37910,32.94001,115088
3069,WilliamBurdett,3,0.00261,37913,32.94262,115088
3070,wilteus,3,0.00261,37916,32.94522,115088
3071,wkuranowski,3,0.00261,37919,32.94783,115088
3072,wllmtrng,3,0.00261,37922,32.95044,115088
3073,worldcitizen,3,0.00261,37925,32.95304,115088
3074,wpengcheng,3,0.00261,37928,32.95565,115088
3075,wraithy,3,0.00261,37931,32.95826,115088
3076,wudebao,3,0.00261,37934,32.96086,115088
3077,wujiandong,3,0.00261,37937,32.96347,115088
3078,wutkemtt,3,0.00261,37940,32.96608,115088
3079,xaque208,3,0.00261,37943,32.96868,115088
3080,xavi-,3,0.00261,37946,32.97129,115088
3081,xdh-ops,3,0.00261,37949,32.97390,115088
3082,xenonsin,3,0.00261,37952,32.97650,115088
3083,xuanyuanaosheng,3,0.00261,37955,32.97911,115088
3084,xxwolfsrainxx,3,0.00261,37958,32.98172,115088
3085,y0y0z,3,0.00261,37961,32.98433,115088
3086,y0zg,3,0.00261,37964,32.98693,115088
3087,yacchin1205,3,0.00261,37967,32.98954,115088
3088,YanXiaobin-Ben,3,0.00261,37970,32.99215,115088
3089,Yarimizu14,3,0.00261,37973,32.99475,115088
3090,yhidai,3,0.00261,37976,32.99736,115088
3091,yigal-rozenberg,3,0.00261,37979,32.99997,115088
3092,yingw787,3,0.00261,37982,33.00257,115088
3093,yiwenshao,3,0.00261,37985,33.00518,115088
3094,yoshi-taka,3,0.00261,37988,33.00779,115088
3095,yqguodataman,3,0.00261,37991,33.01039,115088
3096,yshh,3,0.00261,37994,33.01300,115088
3097,zanthorn,3,0.00261,37997,33.01561,115088
3098,zarakay,3,0.00261,38000,33.01821,115088
3099,zbaylin,3,0.00261,38003,33.02082,115088
3100,zerosign,3,0.00261,38006,33.02343,115088
3101,zfouts,3,0.00261,38009,33.02603,115088
3102,zhangzhengstrive,3,0.00261,38012,33.02864,115088
3103,zhaoyao91,3,0.00261,38015,33.03125,115088
3104,zhuqinghua,3,0.00261,38018,33.03385,115088
3105,zimathon,3,0.00261,38021,33.03646,115088
3106,znorm,3,0.00261,38024,33.03907,115088
3107,ZPerling,3,0.00261,38027,33.04167,115088
3108,zsasaki,3,0.00261,38030,33.04428,115088
3109,zskulcsar,3,0.00261,38033,33.04689,115088
3110,zuehlke-dea,3,0.00261,38036,33.04949,115088
3111,1bcrona,2,0.00174,38038,33.05123,115088
3112,1tarak,2,0.00174,38040,33.05297,115088
3113,2solt,2,0.00174,38042,33.05471,115088
3114,3tinkers,2,0.00174,38044,33.05644,115088
3115,aarnaud,2,0.00174,38046,33.05818,115088
3116,aaron-miller,2,0.00174,38048,33.05992,115088
3117,abhinaya04,2,0.00174,38050,33.06166,115088
3118,abhiTamrakar,2,0.00174,38052,33.06339,115088
3119,abisuman,2,0.00174,38054,33.06513,115088
3120,adamp524,2,0.00174,38056,33.06687,115088
3121,AddChickpeas,2,0.00174,38058,33.06861,115088
3122,adeadman,2,0.00174,38060,33.07035,115088
3123,adipatel,2,0.00174,38062,33.07208,115088
3124,afirst,2,0.00174,38064,33.07382,115088
3125,againer,2,0.00174,38066,33.07556,115088
3126,agerro,2,0.00174,38068,33.07730,115088
3127,agrzegorczyk-leonsoftware,2,0.00174,38070,33.07904,115088
3128,ahevenor,2,0.00174,38072,33.08077,115088
3129,aido93,2,0.00174,38074,33.08251,115088
3130,aj-rame3,2,0.00174,38076,33.08425,115088
3131,aki017,2,0.00174,38078,33.08599,115088
3132,alamzeeshan,2,0.00174,38080,33.08772,115088
3133,AlecIsaacson,2,0.00174,38082,33.08946,115088
3134,alecs999,2,0.00174,38084,33.09120,115088
3135,alekseydemidov,2,0.00174,38086,33.09294,115088
3136,aleksey-pavlov,2,0.00174,38088,33.09468,115088
3137,aleks-v-k,2,0.00174,38090,33.09641,115088
3138,alexanderkiel,2,0.00174,38092,33.09815,115088
3139,alexander-mayr,2,0.00174,38094,33.09989,115088
3140,alex-derzhi-sp,2,0.00174,38096,33.10163,115088
3141,alexdyas,2,0.00174,38098,33.10336,115088
3142,AlexeyNikonorov,2,0.00174,38100,33.10510,115088
3143,AlexisRodet,2,0.00174,38102,33.10684,115088
3144,alexmanno,2,0.00174,38104,33.10858,115088
3145,AlexShemeshWix,2,0.00174,38106,33.11032,115088
3146,alexwbaule,2,0.00174,38108,33.11205,115088
3147,alinlacea,2,0.00174,38110,33.11379,115088
3148,allamiro,2,0.00174,38112,33.11553,115088
3149,alnat2,2,0.00174,38114,33.11727,115088
3150,alotofwe,2,0.00174,38116,33.11900,115088
3151,alph486,2,0.00174,38118,33.12074,115088
3152,Amirioelmos,2,0.00174,38120,33.12248,115088
3153,amohit1315,2,0.00174,38122,33.12422,115088
3154,amritb,2,0.00174,38124,33.12596,115088
3155,analytically,2,0.00174,38126,33.12769,115088
3156,andrericos,2,0.00174,38128,33.12943,115088
3157,AndrewDryga,2,0.00174,38130,33.13117,115088
3158,andreweames,2,0.00174,38132,33.13291,115088
3159,andrewgdavis,2,0.00174,38134,33.13464,115088
3160,andreydroid,2,0.00174,38136,33.13638,115088
3161,andrii29,2,0.00174,38138,33.13812,115088
3162,andyevans,2,0.00174,38140,33.13986,115088
3163,andygeorge,2,0.00174,38142,33.14160,115088
3164,AndyJS,2,0.00174,38144,33.14333,115088
3165,andy-pham,2,0.00174,38146,33.14507,115088
3166,andyprinceuk,2,0.00174,38148,33.14681,115088
3167,AnkurJain10,2,0.00174,38150,33.14855,115088
3168,ankurjha7,2,0.00174,38152,33.15028,115088
3169,anshumgargdd,2,0.00174,38154,33.15202,115088
3170,antho31,2,0.00174,38156,33.15376,115088
3171,apmcodes,2,0.00174,38158,33.15550,115088
3172,apolloclark,2,0.00174,38160,33.15724,115088
3173,aredmond,2,0.00174,38162,33.15897,115088
3174,arekt,2,0.00174,38164,33.16071,115088
3175,arianvp,2,0.00174,38166,33.16245,115088
3176,arikfr,2,0.00174,38168,33.16419,115088
3177,artur-fijalkowski,2,0.00174,38170,33.16593,115088
3178,Arvintian,2,0.00174,38172,33.16766,115088
3179,ashwinikd,2,0.00174,38174,33.16940,115088
3180,asplogic,2,0.00174,38176,33.17114,115088
3181,asserchiu,2,0.00174,38178,33.17288,115088
3182,asvinours,2,0.00174,38180,33.17461,115088
3183,asyd,2,0.00174,38182,33.17635,115088
3184,ATeamSolutions,2,0.00174,38184,33.17809,115088
3185,aurrelhebert,2,0.00174,38186,33.17983,115088
3186,avarf,2,0.00174,38188,33.18157,115088
3187,avikam-pagaya,2,0.00174,38190,33.18330,115088
3188,awlamb,2,0.00174,38192,33.18504,115088
3189,awwx,2,0.00174,38194,33.18678,115088
3190,ayandev007,2,0.00174,38196,33.18852,115088
3191,ayElwany,2,0.00174,38198,33.19025,115088
3192,ayushmathur86,2,0.00174,38200,33.19199,115088
3193,azhi,2,0.00174,38202,33.19373,115088
3194,azilber,2,0.00174,38204,33.19547,115088
3195,aziz-tux,2,0.00174,38206,33.19721,115088
3196,azyata,2,0.00174,38208,33.19894,115088
3197,B1tMaster,2,0.00174,38210,33.20068,115088
3198,baihe,2,0.00174,38212,33.20242,115088
3199,baileyjensen-wk,2,0.00174,38214,33.20416,115088
3200,bakkerpeter,2,0.00174,38216,33.20589,115088
3201,bartelsb,2,0.00174,38218,33.20763,115088
3202,bastichelaar,2,0.00174,38220,33.20937,115088
3203,basvandenbrink,2,0.00174,38222,33.21111,115088
3204,baznikin,2,0.00174,38224,33.21285,115088
3205,bcallanan,2,0.00174,38226,33.21458,115088
3206,bcarpio,2,0.00174,38228,33.21632,115088
3207,bcchenbc,2,0.00174,38230,33.21806,115088
3208,bcicen,2,0.00174,38232,33.21980,115088
3209,bcismariu,2,0.00174,38234,33.22153,115088
3210,bdschaap,2,0.00174,38236,33.22327,115088
3211,behbas,2,0.00174,38238,33.22501,115088
3212,belljustin,2,0.00174,38240,33.22675,115088
3213,BenBlaisdell,2,0.00174,38242,33.22849,115088
3214,bench87,2,0.00174,38244,33.23022,115088
3215,benvaljean,2,0.00174,38246,33.23196,115088
3216,beradrian,2,0.00174,38248,33.23370,115088
3217,beriberikix,2,0.00174,38250,33.23544,115088
3218,Berndinox,2,0.00174,38252,33.23718,115088
3219,bf4,2,0.00174,38254,33.23891,115088
3220,bfreezy,2,0.00174,38256,33.24065,115088
3221,bhattchaitanya,2,0.00174,38258,33.24239,115088
3222,bhavikchitroda,2,0.00174,38260,33.24413,115088
3223,bhbryant,2,0.00174,38262,33.24586,115088
3224,bigsleep,2,0.00174,38264,33.24760,115088
3225,birdy81,2,0.00174,38266,33.24934,115088
3226,bitc,2,0.00174,38268,33.25108,115088
3227,bjlvfei,2,0.00174,38270,33.25282,115088
3228,bjornin,2,0.00174,38272,33.25455,115088
3229,blopker,2,0.00174,38274,33.25629,115088
3230,BlowaXD,2,0.00174,38276,33.25803,115088
3231,Bobi-zhou,2,0.00174,38278,33.25977,115088
3232,bocytko,2,0.00174,38280,33.26150,115088
3233,bodanc,2,0.00174,38282,33.26324,115088
3234,boenr1,2,0.00174,38284,33.26498,115088
3235,bogdanov1609,2,0.00174,38286,33.26672,115088
3236,BoGs,2,0.00174,38288,33.26846,115088
3237,boniaik,2,0.00174,38290,33.27019,115088
3238,bowwowxx,2,0.00174,38292,33.27193,115088
3239,bozerkins,2,0.00174,38294,33.27367,115088
3240,bperel,2,0.00174,38296,33.27541,115088
3241,bradwilliams-nm,2,0.00174,38298,33.27714,115088
3242,brandshaide,2,0.00174,38300,33.27888,115088
3243,breath103,2,0.00174,38302,33.28062,115088
3244,bred86,2,0.00174,38304,33.28236,115088
3245,breinero,2,0.00174,38306,33.28410,115088
3246,BrendanBall,2,0.00174,38308,33.28583,115088
3247,brentonr,2,0.00174,38310,33.28757,115088
3248,brettdh,2,0.00174,38312,33.28931,115088
3249,breznik,2,0.00174,38314,33.29105,115088
3250,briantopping,2,0.00174,38316,33.29278,115088
3251,briceburg,2,0.00174,38318,33.29452,115088
3252,brommer,2,0.00174,38320,33.29626,115088
3253,broniek,2,0.00174,38322,33.29800,115088
3254,brunoyb,2,0.00174,38324,33.29974,115088
3255,BuckarewBanzai,2,0.00174,38326,33.30147,115088
3256,Bulat-Gumerov,2,0.00174,38328,33.30321,115088
3257,bulemoon,2,0.00174,38330,33.30495,115088
3258,butterkekstorte,2,0.00174,38332,33.30669,115088
3259,bvandermeersch,2,0.00174,38334,33.30842,115088
3260,bz-keitaro-kobayashi,2,0.00174,38336,33.31016,115088
3261,c0b,2,0.00174,38338,33.31190,115088
3262,caiohaz,2,0.00174,38340,33.31364,115088
3263,caleb15,2,0.00174,38342,33.31538,115088
3264,calexicoz,2,0.00174,38344,33.31711,115088
3265,calumah,2,0.00174,38346,33.31885,115088
3266,camallen,2,0.00174,38348,33.32059,115088
3267,canburak,2,0.00174,38350,33.32233,115088
3268,carabasdaniel,2,0.00174,38352,33.32407,115088
3269,castro1688,2,0.00174,38354,33.32580,115088
3270,catac,2,0.00174,38356,33.32754,115088
3271,cathy-js,2,0.00174,38358,33.32928,115088
3272,caugustus,2,0.00174,38360,33.33102,115088
3273,cb372,2,0.00174,38362,33.33275,115088
3274,CBR09,2,0.00174,38364,33.33449,115088
3275,ccottam,2,0.00174,38366,33.33623,115088
3276,chamilad,2,0.00174,38368,33.33797,115088
3277,chandertechavidity,2,0.00174,38370,33.33971,115088
3278,chaosoldier,2,0.00174,38372,33.34144,115088
3279,chapitos,2,0.00174,38374,33.34318,115088
3280,charmingcoder,2,0.00174,38376,33.34492,115088
3281,chipx,2,0.00174,38378,33.34666,115088
3282,chocopowwwa,2,0.00174,38380,33.34839,115088
3283,christopherriley,2,0.00174,38382,33.35013,115088
3284,chrusty,2,0.00174,38384,33.35187,115088
3285,chschs,2,0.00174,38386,33.35361,115088
3286,chsnell,2,0.00174,38388,33.35535,115088
3287,chungath,2,0.00174,38390,33.35708,115088
3288,cihangirbesiktas,2,0.00174,38392,33.35882,115088
3289,cinhtau,2,0.00174,38394,33.36056,115088
3290,cjsfj,2,0.00174,38396,33.36230,115088
3291,clarktlaugh,2,0.00174,38398,33.36403,115088
3292,cloud-rocket,2,0.00174,38400,33.36577,115088
3293,cm-igarashi-ryosuke,2,0.00174,38402,33.36751,115088
3294,CMseventeen,2,0.00174,38404,33.36925,115088
3295,codenot,2,0.00174,38406,33.37099,115088
3296,coderFPV,2,0.00174,38408,33.37272,115088
3297,CoderOwl,2,0.00174,38410,33.37446,115088
3298,Coldln,2,0.00174,38412,33.37620,115088
3299,collimarco,2,0.00174,38414,33.37794,115088
3300,congliu01,2,0.00174,38416,33.37967,115088
3301,corford,2,0.00174,38418,33.38141,115088
3302,corselia,2,0.00174,38420,33.38315,115088
3303,cpoirier,2,0.00174,38422,33.38489,115088
3304,creactiviti,2,0.00174,38424,33.38663,115088
3305,cricci82,2,0.00174,38426,33.38836,115088
3306,cristifalcas,2,0.00174,38428,33.39010,115088
3307,ctohastek,2,0.00174,38430,33.39184,115088
3308,cvjones17,2,0.00174,38432,33.39358,115088
3309,cwhatley,2,0.00174,38434,33.39531,115088
3310,CyanPZ,2,0.00174,38436,33.39705,115088
3311,cypherfox,2,0.00174,38438,33.39879,115088
3312,da125,2,0.00174,38440,33.40053,115088
3313,daijongkim,2,0.00174,38442,33.40227,115088
3314,Dakadivya,2,0.00174,38444,33.40400,115088
3315,daltonmatos,2,0.00174,38446,33.40574,115088
3316,dana,2,0.00174,38448,33.40748,115088
3317,danapplegate,2,0.00174,38450,33.40922,115088
3318,danielgollas,2,0.00174,38452,33.41096,115088
3319,danielserrao,2,0.00174,38454,33.41269,115088
3320,Daoq,2,0.00174,38456,33.41443,115088
3321,daparthi001,2,0.00174,38458,33.41617,115088
3322,data-dude,2,0.00174,38460,33.41791,115088
3323,dataich,2,0.00174,38462,33.41964,115088
3324,daveb0t,2,0.00174,38464,33.42138,115088
3325,davidjmemmett,2,0.00174,38466,33.42312,115088
3326,david-streamlio,2,0.00174,38468,33.42486,115088
3327,dawidrabiega,2,0.00174,38470,33.42660,115088
3328,dbyron0,2,0.00174,38472,33.42833,115088
3329,dCSeven,2,0.00174,38474,33.43007,115088
3330,DDAAREN,2,0.00174,38476,33.43181,115088
3331,ddides,2,0.00174,38478,33.43355,115088
3332,ddsultan,2,0.00174,38480,33.43528,115088
3333,deancarr,2,0.00174,38482,33.43702,115088
3334,dembaca,2,0.00174,38484,33.43876,115088
3335,denizarman,2,0.00174,38486,33.44050,115088
3336,denji,2,0.00174,38488,33.44224,115088
3337,derfred,2,0.00174,38490,33.44397,115088
3338,deripas,2,0.00174,38492,33.44571,115088
3339,derqurps,2,0.00174,38494,33.44745,115088
3340,devlinzed,2,0.00174,38496,33.44919,115088
3341,d-grossman,2,0.00174,38498,33.45092,115088
3342,dhiltonp,2,0.00174,38500,33.45266,115088
3343,didjcodt,2,0.00174,38502,33.45440,115088
3344,Dieff,2,0.00174,38504,33.45614,115088
3345,Dinidu,2,0.00174,38506,33.45788,115088
3346,disappear89,2,0.00174,38508,33.45961,115088
3347,djoker911,2,0.00174,38510,33.46135,115088
3348,dkarthi,2,0.00174,38512,33.46309,115088
3349,dmae3,2,0.00174,38514,33.46483,115088
3350,dmarkwat,2,0.00174,38516,33.46656,115088
3351,dmattatall-teradici,2,0.00174,38518,33.46830,115088
3352,dmitrycm,2,0.00174,38520,33.47004,115088
3353,dnajd,2,0.00174,38522,33.47178,115088
3354,dnascimento,2,0.00174,38524,33.47352,115088
3355,dobashim,2,0.00174,38526,33.47525,115088
3356,donkopotamus,2,0.00174,38528,33.47699,115088
3357,dorzeidman,2,0.00174,38530,33.47873,115088
3358,dotekien,2,0.00174,38532,33.48047,115088
3359,dotlambda,2,0.00174,38534,33.48220,115088
3360,dp-farm,2,0.00174,38536,33.48394,115088
3361,dpjayasekara,2,0.00174,38538,33.48568,115088
3362,drshin81,2,0.00174,38540,33.48742,115088
3363,drywheat,2,0.00174,38542,33.48916,115088
3364,ds89snsadbf,2,0.00174,38544,33.49089,115088
3365,ducWasHere,2,0.00174,38546,33.49263,115088
3366,dumoknam,2,0.00174,38548,33.49437,115088
3367,DuskoV,2,0.00174,38550,33.49611,115088
3368,dustinblackman,2,0.00174,38552,33.49785,115088
3369,Dutzu,2,0.00174,38554,33.49958,115088
3370,duxthefux,2,0.00174,38556,33.50132,115088
3371,duythinht,2,0.00174,38558,33.50306,115088
3372,dvdklnr,2,0.00174,38560,33.50480,115088
3373,dvfeinblum,2,0.00174,38562,33.50653,115088
3374,dypublic,2,0.00174,38564,33.50827,115088
3375,dyRavi,2,0.00174,38566,33.51001,115088
3376,ealebed,2,0.00174,38568,33.51175,115088
3377,ebirn,2,0.00174,38570,33.51349,115088
3378,echee2,2,0.00174,38572,33.51522,115088
3379,echelon,2,0.00174,38574,33.51696,115088
3380,edisonch,2,0.00174,38576,33.51870,115088
3381,edskim,2,0.00174,38578,33.52044,115088
3382,eduardolundgren,2,0.00174,38580,33.52217,115088
3383,eelke-at-bolt,2,0.00174,38582,33.52391,115088
3384,eiszfuchs,2,0.00174,38584,33.52565,115088
3385,eldad87,2,0.00174,38586,33.52739,115088
3386,eldondev,2,0.00174,38588,33.52913,115088
3387,elecay,2,0.00174,38590,33.53086,115088
3388,electromecca,2,0.00174,38592,33.53260,115088
3389,eliasnorrby,2,0.00174,38594,33.53434,115088
3390,elwlwlwk,2,0.00174,38596,33.53608,115088
3391,elyoncyber,2,0.00174,38598,33.53781,115088
3392,elzinko,2,0.00174,38600,33.53955,115088
3393,emate,2,0.00174,38602,33.54129,115088
3394,emcay,2,0.00174,38604,33.54303,115088
3395,emilaasa,2,0.00174,38606,33.54477,115088
3396,enami,2,0.00174,38608,33.54650,115088
3397,enm10k,2,0.00174,38610,33.54824,115088
3398,enzirion,2,0.00174,38612,33.54998,115088
3399,erbdex,2,0.00174,38614,33.55172,115088
3400,ericdill,2,0.00174,38616,33.55345,115088
3401,ericyan,2,0.00174,38618,33.55519,115088
3402,erikdubbelboer,2,0.00174,38620,33.55693,115088
3403,erlichmen,2,0.00174,38622,33.55867,115088
3404,ersushantsood,2,0.00174,38624,33.56041,115088
3405,eskornev,2,0.00174,38626,33.56214,115088
3406,essa,2,0.00174,38628,33.56388,115088
3407,essh,2,0.00174,38630,33.56562,115088
3408,esteban1983cl,2,0.00174,38632,33.56736,115088
3409,ethanlieske,2,0.00174,38634,33.56909,115088
3410,etiennejournet,2,0.00174,38636,33.57083,115088
3411,etwillbefine,2,0.00174,38638,33.57257,115088
3412,eugenetaranov,2,0.00174,38640,33.57431,115088
3413,EVODelavega,2,0.00174,38642,33.57605,115088
3414,eXtrem0us,2,0.00174,38644,33.57778,115088
3415,EyesOfRaistlinV,2,0.00174,38646,33.57952,115088
3416,f355,2,0.00174,38648,33.58126,115088
3417,faisal-khalique,2,0.00174,38650,33.58300,115088
3418,fakechris,2,0.00174,38652,33.58474,115088
3419,farchanjo,2,0.00174,38654,33.58647,115088
3420,fatal10110,2,0.00174,38656,33.58821,115088
3421,fatroller,2,0.00174,38658,33.58995,115088
3422,fchiorascu,2,0.00174,38660,33.59169,115088
3423,fcuozzo,2,0.00174,38662,33.59342,115088
3424,FereshtehLL,2,0.00174,38664,33.59516,115088
3425,fikander,2,0.00174,38666,33.59690,115088
3426,fiskeben,2,0.00174,38668,33.59864,115088
3427,fitz0017,2,0.00174,38670,33.60038,115088
3428,fizyk,2,0.00174,38672,33.60211,115088
3429,flare505,2,0.00174,38674,33.60385,115088
3430,flippakitten,2,0.00174,38676,33.60559,115088
3431,florentvaldelievre,2,0.00174,38678,33.60733,115088
3432,flowstate,2,0.00174,38680,33.60906,115088
3433,flypenguin,2,0.00174,38682,33.61080,115088
3434,forewei,2,0.00174,38684,33.61254,115088
3435,forging2012,2,0.00174,38686,33.61428,115088
3436,fpermana,2,0.00174,38688,33.61602,115088
3437,francesco-russo,2,0.00174,38690,33.61775,115088
3438,francjohny,2,0.00174,38692,33.61949,115088
3439,francotestori,2,0.00174,38694,33.62123,115088
3440,frankkusters,2,0.00174,38696,33.62297,115088
3441,freemanh,2,0.00174,38698,33.62470,115088
3442,frootkeyk,2,0.00174,38700,33.62644,115088
3443,fr-swap,2,0.00174,38702,33.62818,115088
3444,fruuf,2,0.00174,38704,33.62992,115088
3445,fsperling,2,0.00174,38706,33.63166,115088
3446,fujio0000,2,0.00174,38708,33.63339,115088
3447,funwun,2,0.00174,38710,33.63513,115088
3448,fvj,2,0.00174,38712,33.63687,115088
3449,Ganezu79,2,0.00174,38714,33.63861,115088
3450,gatolim,2,0.00174,38716,33.64034,115088
3451,gauravaroraoyo,2,0.00174,38718,33.64208,115088
3452,gavin-shr,2,0.00174,38720,33.64382,115088
3453,geekofalltrades,2,0.00174,38722,33.64556,115088
3454,geib,2,0.00174,38724,33.64730,115088
3455,gentoid,2,0.00174,38726,33.64903,115088
3456,gerasym,2,0.00174,38728,33.65077,115088
3457,gheon,2,0.00174,38730,33.65251,115088
3458,giannello,2,0.00174,38732,33.65425,115088
3459,gibban69,2,0.00174,38734,33.65598,115088
3460,gibsonje,2,0.00174,38736,33.65772,115088
3461,gildas,2,0.00174,38738,33.65946,115088
3462,gileshinchcliff,2,0.00174,38740,33.66120,115088
3463,gilllevy,2,0.00174,38742,33.66294,115088
3464,gioialorusso,2,0.00174,38744,33.66467,115088
3465,glee0316,2,0.00174,38746,33.66641,115088
3466,gmlexx,2,0.00174,38748,33.66815,115088
3467,goelsatyam,2,0.00174,38750,33.66989,115088
3468,gonzalorey,2,0.00174,38752,33.67163,115088
3469,Gourds,2,0.00174,38754,33.67336,115088
3470,gpaszkowski-rmn,2,0.00174,38756,33.67510,115088
3471,gpolek,2,0.00174,38758,33.67684,115088
3472,graniterocks,2,0.00174,38760,33.67858,115088
3473,Grant1219,2,0.00174,38762,33.68031,115088
3474,GrantSheehan,2,0.00174,38764,33.68205,115088
3475,grayaii,2,0.00174,38766,33.68379,115088
3476,graysky,2,0.00174,38768,33.68553,115088
3477,greenkiwi,2,0.00174,38770,33.68727,115088
3478,greggilbert,2,0.00174,38772,33.68900,115088
3479,gregoryb,2,0.00174,38774,33.69074,115088
3480,gretamosa,2,0.00174,38776,33.69248,115088
3481,groner,2,0.00174,38778,33.69422,115088
3482,grpubr,2,0.00174,38780,33.69595,115088
3483,gtrafimenkov,2,0.00174,38782,33.69769,115088
3484,gtt116,2,0.00174,38784,33.69943,115088
3485,guiocavalcanti,2,0.00174,38786,33.70117,115088
3486,gvillalta99,2,0.00174,38788,33.70291,115088
3487,gvishnutej,2,0.00174,38790,33.70464,115088
3488,gyj0825,2,0.00174,38792,33.70638,115088
3489,h0tw1r3,2,0.00174,38794,33.70812,115088
3490,hackeracc,2,0.00174,38796,33.70986,115088
3491,hamelsveld,2,0.00174,38798,33.71159,115088
3492,hamishforbes,2,0.00174,38800,33.71333,115088
3493,hana-da,2,0.00174,38802,33.71507,115088
3494,hansman,2,0.00174,38804,33.71681,115088
3495,Hapa29,2,0.00174,38806,33.71855,115088
3496,hardcorexcat,2,0.00174,38808,33.72028,115088
3497,harukasan,2,0.00174,38810,33.72202,115088
3498,hashbrowncipher,2,0.00174,38812,33.72376,115088
3499,hayamiz,2,0.00174,38814,33.72550,115088
3500,heiqs,2,0.00174,38816,33.72723,115088
3501,henteko,2,0.00174,38818,33.72897,115088
3502,herrsebi,2,0.00174,38820,33.73071,115088
3503,Hexta,2,0.00174,38822,33.73245,115088
3504,heyaWorld,2,0.00174,38824,33.73419,115088
3505,hiddletian,2,0.00174,38826,33.73592,115088
3506,hidetaka-f-matsumoto,2,0.00174,38828,33.73766,115088
3507,hideto0710,2,0.00174,38830,33.73940,115088
3508,himadriganguly,2,0.00174,38832,33.74114,115088
3509,hir3npatel,2,0.00174,38834,33.74288,115088
3510,hirobanex,2,0.00174,38836,33.74461,115088
3511,hligit,2,0.00174,38838,33.74635,115088
3512,hlosukwakha,2,0.00174,38840,33.74809,115088
3513,holinnn,2,0.00174,38842,33.74983,115088
3514,hongbosoftware,2,0.00174,38844,33.75156,115088
3515,HotdogWang,2,0.00174,38846,33.75330,115088
3516,houhoulis,2,0.00174,38848,33.75504,115088
3517,hrak,2,0.00174,38850,33.75678,115088
3518,huddlesj,2,0.00174,38852,33.75852,115088
3519,hughes,2,0.00174,38854,33.76025,115088
3520,hughneale,2,0.00174,38856,33.76199,115088
3521,Hugmeir,2,0.00174,38858,33.76373,115088
3522,hw6,2,0.00174,38860,33.76547,115088
3523,iam404,2,0.00174,38862,33.76720,115088
3524,iamnut,2,0.00174,38864,33.76894,115088
3525,ianseyer,2,0.00174,38866,33.77068,115088
3526,ienliven,2,0.00174,38868,33.77242,115088
3527,igalarzab,2,0.00174,38870,33.77416,115088
3528,IGZgustavomarin,2,0.00174,38872,33.77589,115088
3529,iiwoai,2,0.00174,38874,33.77763,115088
3530,iktakahiro,2,0.00174,38876,33.77937,115088
3531,ilove8,2,0.00174,38878,33.78111,115088
3532,imasho,2,0.00174,38880,33.78284,115088
3533,imre-kerr,2,0.00174,38882,33.78458,115088
3534,imriss,2,0.00174,38884,33.78632,115088
3535,infa-ddeore,2,0.00174,38886,33.78806,115088
3536,inkitm,2,0.00174,38888,33.78980,115088
3537,inv-joby,2,0.00174,38890,33.79153,115088
3538,ioprotium,2,0.00174,38892,33.79327,115088
3539,iravishah,2,0.00174,38894,33.79501,115088
3540,islue,2,0.00174,38896,33.79675,115088
3541,itaiMona,2,0.00174,38898,33.79848,115088
3542,itayariel,2,0.00174,38900,33.80022,115088
3543,itlabvn,2,0.00174,38902,33.80196,115088
3544,ivandotv,2,0.00174,38904,33.80370,115088
3545,j0057,2,0.00174,38906,33.80544,115088
3546,jackyycheng,2,0.00174,38908,33.80717,115088
3547,jamesalford,2,0.00174,38910,33.80891,115088
3548,jan-warchol,2,0.00174,38912,33.81065,115088
3549,jason-w,2,0.00174,38914,33.81239,115088
3550,javier-sanz,2,0.00174,38916,33.81412,115088
3551,jayslife,2,0.00174,38918,33.81586,115088
3552,jayson,2,0.00174,38920,33.81760,115088
3553,jbrownsc,2,0.00174,38922,33.81934,115088
3554,jdirwin,2,0.00174,38924,33.82108,115088
3555,jdoconnor,2,0.00174,38926,33.82281,115088
3556,jdvasque,2,0.00174,38928,33.82455,115088
3557,JeanMertz,2,0.00174,38930,33.82629,115088
3558,jeffgeiger,2,0.00174,38932,33.82803,115088
3559,jegt,2,0.00174,38934,33.82977,115088
3560,jensenbox,2,0.00174,38936,33.83150,115088
3561,jessebond2,2,0.00174,38938,33.83324,115088
3562,jessicalucci,2,0.00174,38940,33.83498,115088
3563,jeunito,2,0.00174,38942,33.83672,115088
3564,jfeeny,2,0.00174,38944,33.83845,115088
3565,jgibson02,2,0.00174,38946,33.84019,115088
3566,JGiola,2,0.00174,38948,33.84193,115088
3567,jgunnink,2,0.00174,38950,33.84367,115088
3568,jhappoldt,2,0.00174,38952,33.84541,115088
3569,jhelmo,2,0.00174,38954,33.84714,115088
3570,jhuenges,2,0.00174,38956,33.84888,115088
3571,jinchaoxiang,2,0.00174,38958,33.85062,115088
3572,JindongChen,2,0.00174,38960,33.85236,115088
3573,JinyongKim,2,0.00174,38962,33.85409,115088
3574,Jlonghi,2,0.00174,38964,33.85583,115088
3575,jo8937,2,0.00174,38966,33.85757,115088
3576,joaoubaldo,2,0.00174,38968,33.85931,115088
3577,JoaquinSV,2,0.00174,38970,33.86105,115088
3578,joestrouth1,2,0.00174,38972,33.86278,115088
3579,joetym,2,0.00174,38974,33.86452,115088
3580,johanavril,2,0.00174,38976,33.86626,115088
3581,johne9087,2,0.00174,38978,33.86800,115088
3582,johnfg10,2,0.00174,38980,33.86973,115088
3583,johnk-novu,2,0.00174,38982,33.87147,115088
3584,johnmarcou,2,0.00174,38984,33.87321,115088
3585,JohnMealy23,2,0.00174,38986,33.87495,115088
3586,jojand,2,0.00174,38988,33.87669,115088
3587,jokester,2,0.00174,38990,33.87842,115088
3588,jonatasalves-hotmart,2,0.00174,38992,33.88016,115088
3589,jonsgreen,2,0.00174,38994,33.88190,115088
3590,jon-stumpf,2,0.00174,38996,33.88364,115088
3591,jorhett,2,0.00174,38998,33.88537,115088
3592,josagonzalez,2,0.00174,39000,33.88711,115088
3593,joshualan,2,0.00174,39002,33.88885,115088
3594,joyzhang-dd,2,0.00174,39004,33.89059,115088
3595,jraby,2,0.00174,39006,33.89233,115088
3596,jriggins,2,0.00174,39008,33.89406,115088
3597,jsdoe,2,0.00174,39010,33.89580,115088
3598,jtlindsey,2,0.00174,39012,33.89754,115088
3599,juan-domenech,2,0.00174,39014,33.89928,115088
3600,JunyaOkumura,2,0.00174,39016,33.90101,115088
3601,justinturpin,2,0.00174,39018,33.90275,115088
3602,jyuan,2,0.00174,39020,33.90449,115088
3603,jzimmek,2,0.00174,39022,33.90623,115088
3604,k1w1,2,0.00174,39024,33.90797,115088
3605,k4200,2,0.00174,39026,33.90970,115088
3606,Kageetai,2,0.00174,39028,33.91144,115088
3607,kaitlynmesa,2,0.00174,39030,33.91318,115088
3608,kalinkrustev,2,0.00174,39032,33.91492,115088
3609,kanupriya15025,2,0.00174,39034,33.91666,115088
3610,kardianos,2,0.00174,39036,33.91839,115088
3611,karthicgit,2,0.00174,39038,33.92013,115088
3612,karthikeayan,2,0.00174,39040,33.92187,115088
3613,KarthikRangaraju,2,0.00174,39042,33.92361,115088
3614,katopz,2,0.00174,39044,33.92534,115088
3615,katsuhiko,2,0.00174,39046,33.92708,115088
3616,katty0324,2,0.00174,39048,33.92882,115088
3617,kayawari,2,0.00174,39050,33.93056,115088
3618,kaybinwong,2,0.00174,39052,33.93230,115088
3619,kazeula,2,0.00174,39054,33.93403,115088
3620,kbowerma,2,0.00174,39056,33.93577,115088
3621,kdeldycke,2,0.00174,39058,33.93751,115088
3622,kdevendran-branch,2,0.00174,39060,33.93925,115088
3623,keigohtr,2,0.00174,39062,33.94098,115088
3624,KeiichiHirobe,2,0.00174,39064,33.94272,115088
3625,kensantou,2,0.00174,39066,33.94446,115088
3626,kevin-sumo,2,0.00174,39068,33.94620,115088
3627,kgeorga,2,0.00174,39070,33.94794,115088
3628,khanage,2,0.00174,39072,33.94967,115088
3629,kimor79,2,0.00174,39074,33.95141,115088
3630,Kirchen99,2,0.00174,39076,33.95315,115088
3631,kjnilsson,2,0.00174,39078,33.95489,115088
3632,kjwierenga,2,0.00174,39080,33.95662,115088
3633,kklemmicknvidia,2,0.00174,39082,33.95836,115088
3634,kknd113,2,0.00174,39084,33.96010,115088
3635,kkotamar,2,0.00174,39086,33.96184,115088
3636,kkurten,2,0.00174,39088,33.96358,115088
3637,klaxa,2,0.00174,39090,33.96531,115088
3638,klo2k,2,0.00174,39092,33.96705,115088
3639,kmonsoor,2,0.00174,39094,33.96879,115088
3640,knlambert,2,0.00174,39096,33.97053,115088
3641,knockubo,2,0.00174,39098,33.97226,115088
3642,koman-maciej,2,0.00174,39100,33.97400,115088
3643,ko-zu,2,0.00174,39102,33.97574,115088
3644,kpcyrd,2,0.00174,39104,33.97748,115088
3645,KristianZH,2,0.00174,39106,33.97922,115088
3646,krysennn,2,0.00174,39108,33.98095,115088
3647,kSandr-ki,2,0.00174,39110,33.98269,115088
3648,kswapd,2,0.00174,39112,33.98443,115088
3649,kuki21,2,0.00174,39114,33.98617,115088
3650,kumavis,2,0.00174,39116,33.98790,115088
3651,kuromike0629,2,0.00174,39118,33.98964,115088
3652,kuroneko25,2,0.00174,39120,33.99138,115088
3653,kuy,2,0.00174,39122,33.99312,115088
3654,kuzuha,2,0.00174,39124,33.99486,115088
3655,kuzukami,2,0.00174,39126,33.99659,115088
3656,Kwelity,2,0.00174,39128,33.99833,115088
3657,kyentei,2,0.00174,39130,34.00007,115088
3658,labosen,2,0.00174,39132,34.00181,115088
3659,lackita,2,0.00174,39134,34.00355,115088
3660,lance-edmodo,2,0.00174,39136,34.00528,115088
3661,lang710,2,0.00174,39138,34.00702,115088
3662,leedohyun,2,0.00174,39140,34.00876,115088
3663,leehoawki,2,0.00174,39142,34.01050,115088
3664,LeeYearJ,2,0.00174,39144,34.01223,115088
3665,leklund,2,0.00174,39146,34.01397,115088
3666,lel085,2,0.00174,39148,34.01571,115088
3667,Leninmarker,2,0.00174,39150,34.01745,115088
3668,lenoAlex,2,0.00174,39152,34.01919,115088
3669,lhucinequr,2,0.00174,39154,34.02092,115088
3670,linzhaoming,2,0.00174,39156,34.02266,115088
3671,lionux2,2,0.00174,39158,34.02440,115088
3672,lisajluo,2,0.00174,39160,34.02614,115088
3673,LittlePeng,2,0.00174,39162,34.02787,115088
3674,liuqianxin,2,0.00174,39164,34.02961,115088
3675,liusunpan,2,0.00174,39166,34.03135,115088
3676,lizdeika,2,0.00174,39168,34.03309,115088
3677,ljagiello,2,0.00174,39170,34.03483,115088
3678,llernestal,2,0.00174,39172,34.03656,115088
3679,lomkju,2,0.00174,39174,34.03830,115088
3680,longvd89,2,0.00174,39176,34.04004,115088
3681,lostman-github,2,0.00174,39178,34.04178,115088
3682,louism517,2,0.00174,39180,34.04351,115088
3683,lubinszARM,2,0.00174,39182,34.04525,115088
3684,lubouski,2,0.00174,39184,34.04699,115088
3685,lucaim,2,0.00174,39186,34.04873,115088
3686,lucj,2,0.00174,39188,34.05047,115088
3687,lucky7id,2,0.00174,39190,34.05220,115088
3688,LudwigTirazona,2,0.00174,39192,34.05394,115088
3689,lvicentesanchez,2,0.00174,39194,34.05568,115088
3690,lyman,2,0.00174,39196,34.05742,115088
3691,m27g,2,0.00174,39198,34.05915,115088
3692,mac2000,2,0.00174,39200,34.06089,115088
3693,maciekm,2,0.00174,39202,34.06263,115088
3694,madamkiwi,2,0.00174,39204,34.06437,115088
3695,madfist,2,0.00174,39206,34.06611,115088
3696,Madhansudhan,2,0.00174,39208,34.06784,115088
3697,mafuyuk,2,0.00174,39210,34.06958,115088
3698,mageddo,2,0.00174,39212,34.07132,115088
3699,maimaisie,2,0.00174,39214,34.07306,115088
3700,maishiro,2,0.00174,39216,34.07479,115088
3701,mamboking,2,0.00174,39218,34.07653,115088
3702,mandyjohar23,2,0.00174,39220,34.07827,115088
3703,manhnguyenduc,2,0.00174,39222,34.08001,115088
3704,Manikantan22,2,0.00174,39224,34.08175,115088
3705,manu844,2,0.00174,39226,34.08348,115088
3706,mapcuk,2,0.00174,39228,34.08522,115088
3707,marcin-je,2,0.00174,39230,34.08696,115088
3708,MarcSchmitzer,2,0.00174,39232,34.08870,115088
3709,markgewurz,2,0.00174,39234,34.09044,115088
3710,mark-sivill-splunk,2,0.00174,39236,34.09217,115088
3711,marti6tic,2,0.00174,39238,34.09391,115088
3712,MartinVUALTO,2,0.00174,39240,34.09565,115088
3713,masayukit,2,0.00174,39242,34.09739,115088
3714,mastak,2,0.00174,39244,34.09912,115088
3715,masterada,2,0.00174,39246,34.10086,115088
3716,matrey,2,0.00174,39248,34.10260,115088
3717,matt14483,2,0.00174,39250,34.10434,115088
3718,matt-land,2,0.00174,39252,34.10608,115088
3719,matt-march,2,0.00174,39254,34.10781,115088
3720,MattMencel,2,0.00174,39256,34.10955,115088
3721,mattty,2,0.00174,39258,34.11129,115088
3722,maxsakharov,2,0.00174,39260,34.11303,115088
3723,mboxell,2,0.00174,39262,34.11476,115088
3724,mcanaves,2,0.00174,39264,34.11650,115088
3725,mcgeeco,2,0.00174,39266,34.11824,115088
3726,mcswaroop19,2,0.00174,39268,34.11998,115088
3727,mcuelenaere,2,0.00174,39270,34.12172,115088
3728,mdamir,2,0.00174,39272,34.12345,115088
3729,medox,2,0.00174,39274,34.12519,115088
3730,melgart,2,0.00174,39276,34.12693,115088
3731,memosstilvi,2,0.00174,39278,34.12867,115088
3732,MerkAndreas,2,0.00174,39280,34.13040,115088
3733,mffiedler,2,0.00174,39282,34.13214,115088
3734,mgherman,2,0.00174,39284,34.13388,115088
3735,mgsh,2,0.00174,39286,34.13562,115088
3736,mhobotpplnet,2,0.00174,39288,34.13736,115088
3737,mhumeSF,2,0.00174,39290,34.13909,115088
3738,micahlagrange,2,0.00174,39292,34.14083,115088
3739,michae1ho11ey,2,0.00174,39294,34.14257,115088
3740,michaelharrer,2,0.00174,39296,34.14431,115088
3741,michaelsteiner,2,0.00174,39298,34.14604,115088
3742,michimartini,2,0.00174,39300,34.14778,115088
3743,MihoYamato,2,0.00174,39302,34.14952,115088
3744,MikeVL,2,0.00174,39304,34.15126,115088
3745,milanbrahmbhatt,2,0.00174,39306,34.15300,115088
3746,mineyang,2,0.00174,39308,34.15473,115088
3747,mirakui,2,0.00174,39310,34.15647,115088
3748,mitchhh22,2,0.00174,39312,34.15821,115088
3749,mitsu-ko,2,0.00174,39314,34.15995,115088
3750,miyatakemasato,2,0.00174,39316,34.16168,115088
3751,mk3a,2,0.00174,39318,34.16342,115088
3752,mkorkalo,2,0.00174,39320,34.16516,115088
3753,mmlb,2,0.00174,39322,34.16690,115088
3754,mnd999,2,0.00174,39324,34.16864,115088
3755,mnogu,2,0.00174,39326,34.17037,115088
3756,moebiuseye,2,0.00174,39328,34.17211,115088
3757,moeryomenko,2,0.00174,39330,34.17385,115088
3758,mogulla3,2,0.00174,39332,34.17559,115088
3759,mohdahmad17,2,0.00174,39334,34.17733,115088
3760,mohigupt,2,0.00174,39336,34.17906,115088
3761,moinnadeem,2,0.00174,39338,34.18080,115088
3762,mooperd,2,0.00174,39340,34.18254,115088
3763,mopinion,2,0.00174,39342,34.18428,115088
3764,Mosibi,2,0.00174,39344,34.18601,115088
3765,mostlyjason,2,0.00174,39346,34.18775,115088
3766,motemen,2,0.00174,39348,34.18949,115088
3767,moznion,2,0.00174,39350,34.19123,115088
3768,mperezco,2,0.00174,39352,34.19297,115088
3769,mplachter,2,0.00174,39354,34.19470,115088
3770,mraczynska,2,0.00174,39356,34.19644,115088
3771,mrdulin,2,0.00174,39358,34.19818,115088
3772,mrfreezer,2,0.00174,39360,34.19992,115088
3773,mrkn,2,0.00174,39362,34.20165,115088
3774,mrkstate,2,0.00174,39364,34.20339,115088
3775,mrnonz,2,0.00174,39366,34.20513,115088
3776,mrozentsvayg,2,0.00174,39368,34.20687,115088
3777,MrPink,2,0.00174,39370,34.20861,115088
3778,mrunesson,2,0.00174,39372,34.21034,115088
3779,mseiwald,2,0.00174,39374,34.21208,115088
3780,mstinglin,2,0.00174,39376,34.21382,115088
3781,msulland,2,0.00174,39378,34.21556,115088
3782,mtotheikle,2,0.00174,39380,34.21729,115088
3783,muuuuwa,2,0.00174,39382,34.21903,115088
3784,myfinder,2,0.00174,39384,34.22077,115088
3785,nagata-logly,2,0.00174,39386,34.22251,115088
3786,NAlexandrov,2,0.00174,39388,34.22425,115088
3787,namrata-ibm,2,0.00174,39390,34.22598,115088
3788,nasunom,2,0.00174,39392,34.22772,115088
3789,nathan-oakes,2,0.00174,39394,34.22946,115088
3790,navaati,2,0.00174,39396,34.23120,115088
3791,nazar554,2,0.00174,39398,34.23293,115088
3792,nbaoping,2,0.00174,39400,34.23467,115088
3793,nbertram,2,0.00174,39402,34.23641,115088
3794,nbvehbq,2,0.00174,39404,34.23815,115088
3795,nc30,2,0.00174,39406,34.23989,115088
3796,ncepuwanghui,2,0.00174,39408,34.24162,115088
3797,ndhoule,2,0.00174,39410,34.24336,115088
3798,Nebulis,2,0.00174,39412,34.24510,115088
3799,NecatiSiseci,2,0.00174,39414,34.24684,115088
3800,neeravarora,2,0.00174,39416,34.24858,115088
3801,nelson-ks,2,0.00174,39418,34.25031,115088
3802,nestegg,2,0.00174,39420,34.25205,115088
3803,netsuvi,2,0.00174,39422,34.25379,115088
3804,Nevon,2,0.00174,39424,34.25553,115088
3805,newbenji,2,0.00174,39426,34.25726,115088
3806,nglinh,2,0.00174,39428,34.25900,115088
3807,nico1106,2,0.00174,39430,34.26074,115088
3808,NidhiArien,2,0.00174,39432,34.26248,115088
3809,NikhilTejSR,2,0.00174,39434,34.26422,115088
3810,niku,2,0.00174,39436,34.26595,115088
3811,Nikunj-Sharma,2,0.00174,39438,34.26769,115088
3812,njd5475,2,0.00174,39440,34.26943,115088
3813,nkrendel,2,0.00174,39442,34.27117,115088
3814,NKUCodingCat,2,0.00174,39444,34.27290,115088
3815,nnao45,2,0.00174,39446,34.27464,115088
3816,noodle-rubrik,2,0.00174,39448,34.27638,115088
3817,noraesae,2,0.00174,39450,34.27812,115088
3818,normander,2,0.00174,39452,34.27986,115088
3819,novitski,2,0.00174,39454,34.28159,115088
3820,nshttpd,2,0.00174,39456,34.28333,115088
3821,ntdetect,2,0.00174,39458,34.28507,115088
3822,Ntzafrir,2,0.00174,39460,34.28681,115088
3823,nvx,2,0.00174,39462,34.28854,115088
3824,oazabir,2,0.00174,39464,34.29028,115088
3825,obilliard,2,0.00174,39466,34.29202,115088
3826,obokaiwele,2,0.00174,39468,34.29376,115088
3827,ods94065,2,0.00174,39470,34.29550,115088
3828,oengel,2,0.00174,39472,34.29723,115088
3829,Ohmen,2,0.00174,39474,34.29897,115088
3830,okashino,2,0.00174,39476,34.30071,115088
3831,Oleg2tor,2,0.00174,39478,34.30245,115088
3832,OleksandrMykytenko,2,0.00174,39480,34.30418,115088
3833,Oliniusz,2,0.00174,39482,34.30592,115088
3834,omer-akhter,2,0.00174,39484,34.30766,115088
3835,onimsha,2,0.00174,39486,34.30940,115088
3836,opspy,2,0.00174,39488,34.31114,115088
3837,orlangure,2,0.00174,39490,34.31287,115088
3838,ormico,2,0.00174,39492,34.31461,115088
3839,osiegmar,2,0.00174,39494,34.31635,115088
3840,oytuntez,2,0.00174,39496,34.31809,115088
3841,palloc,2,0.00174,39498,34.31982,115088
3842,pankajagrawal16,2,0.00174,39500,34.32156,115088
3843,pankajmt,2,0.00174,39502,34.32330,115088
3844,paragradke,2,0.00174,39504,34.32504,115088
3845,P-A-R-U-S,2,0.00174,39506,34.32678,115088
3846,patrickleboutillier,2,0.00174,39508,34.32851,115088
3847,Patrick-Shih,2,0.00174,39510,34.33025,115088
3848,paulotfilho,2,0.00174,39512,34.33199,115088
3849,pawangonnakuti,2,0.00174,39514,34.33373,115088
3850,pbartoszek,2,0.00174,39516,34.33547,115088
3851,pckhoi,2,0.00174,39518,34.33720,115088
3852,pedromazala,2,0.00174,39520,34.33894,115088
3853,peet-j,2,0.00174,39522,34.34068,115088
3854,peter-lotts-tombola,2,0.00174,39524,34.34242,115088
3855,pfalgowski,2,0.00174,39526,34.34415,115088
3856,pguz,2,0.00174,39528,34.34589,115088
3857,pharindoko,2,0.00174,39530,34.34763,115088
3858,phillipsinger,2,0.00174,39532,34.34937,115088
3859,philnielsen,2,0.00174,39534,34.35111,115088
3860,pingles,2,0.00174,39536,34.35284,115088
3861,pitan,2,0.00174,39538,34.35458,115088
3862,pkeuter,2,0.00174,39540,34.35632,115088
3863,Place1,2,0.00174,39542,34.35806,115088
3864,plicease,2,0.00174,39544,34.35979,115088
3865,ploef,2,0.00174,39546,34.36153,115088
3866,pms1969,2,0.00174,39548,34.36327,115088
3867,pointbre,2,0.00174,39550,34.36501,115088
3868,pollosp,2,0.00174,39552,34.36675,115088
3869,poom,2,0.00174,39554,34.36848,115088
3870,porterja31,2,0.00174,39556,34.37022,115088
3871,prabinsubedi,2,0.00174,39558,34.37196,115088
3872,pratikmoo,2,0.00174,39560,34.37370,115088
3873,PravenJohn,2,0.00174,39562,34.37543,115088
3874,pravindahal,2,0.00174,39564,34.37717,115088
3875,protomonk,2,0.00174,39566,34.37891,115088
3876,prtk-ngm,2,0.00174,39568,34.38065,115088
3877,psarupria,2,0.00174,39570,34.38239,115088
3878,pseudobeer,2,0.00174,39572,34.38412,115088
3879,ptadas,2,0.00174,39574,34.38586,115088
3880,punitag,2,0.00174,39576,34.38760,115088
3881,pussade,2,0.00174,39578,34.38934,115088
3882,pxcurtis,2,0.00174,39580,34.39107,115088
3883,qantasloyalty-techops,2,0.00174,39582,34.39281,115088
3884,qingchuwudi,2,0.00174,39584,34.39455,115088
3885,qnapnickchang,2,0.00174,39586,34.39629,115088
3886,qrtt1,2,0.00174,39588,34.39803,115088
3887,qwiggy,2,0.00174,39590,34.39976,115088
3888,r0bj,2,0.00174,39592,34.40150,115088
3889,raf-d,2,0.00174,39594,34.40324,115088
3890,rahulprasad31121988,2,0.00174,39596,34.40498,115088
3891,rahul-splendre,2,0.00174,39598,34.40671,115088
3892,rajputvishwas,2,0.00174,39600,34.40845,115088
3893,rami013,2,0.00174,39602,34.41019,115088
3894,rasheedamir,2,0.00174,39604,34.41193,115088
3895,rashmichandrashekar,2,0.00174,39606,34.41367,115088
3896,rashok-rmn,2,0.00174,39608,34.41540,115088
3897,ravvereddy,2,0.00174,39610,34.41714,115088
3898,rb-johnmurphy,2,0.00174,39612,34.41888,115088
3899,rcsavage,2,0.00174,39614,34.42062,115088
3900,rdcastro,2,0.00174,39616,34.42236,115088
3901,readless,2,0.00174,39618,34.42409,115088
3902,recunius,2,0.00174,39620,34.42583,115088
3903,RedactedProfile,2,0.00174,39622,34.42757,115088
3904,redbox2000,2,0.00174,39624,34.42931,115088
3905,ReDim42,2,0.00174,39626,34.43104,115088
3906,reimarstier,2,0.00174,39628,34.43278,115088
3907,Reiner030,2,0.00174,39630,34.43452,115088
3908,rektide,2,0.00174,39632,34.43626,115088
3909,residualdata,2,0.00174,39634,34.43800,115088
3910,Resisty,2,0.00174,39636,34.43973,115088
3911,restyler,2,0.00174,39638,34.44147,115088
3912,rhefner1,2,0.00174,39640,34.44321,115088
3913,rhonnava,2,0.00174,39642,34.44495,115088
3914,rhroach,2,0.00174,39644,34.44668,115088
3915,richard-li-sp,2,0.00174,39646,34.44842,115088
3916,rigsby-chi,2,0.00174,39648,34.45016,115088
3917,rijoparakkal,2,0.00174,39650,34.45190,115088
3918,rishisharmamt,2,0.00174,39652,34.45364,115088
3919,rjcrystal,2,0.00174,39654,34.45537,115088
3920,rjemanuele,2,0.00174,39656,34.45711,115088
3921,rjshrjndrn,2,0.00174,39658,34.45885,115088
3922,rmcclaincf,2,0.00174,39660,34.46059,115088
3923,robert-7,2,0.00174,39662,34.46232,115088
3924,RobertAtomic,2,0.00174,39664,34.46406,115088
3925,robertlamarre,2,0.00174,39666,34.46580,115088
3926,robertomiranda,2,0.00174,39668,34.46754,115088
3927,robmp,2,0.00174,39670,34.46928,115088
3928,rohitrsh,2,0.00174,39672,34.47101,115088
3929,roicostas,2,0.00174,39674,34.47275,115088
3930,rolindroy,2,0.00174,39676,34.47449,115088
3931,roma42427,2,0.00174,39678,34.47623,115088
3932,romainbureau,2,0.00174,39680,34.47796,115088
3933,romanvbabenko,2,0.00174,39682,34.47970,115088
3934,roscoecairney,2,0.00174,39684,34.48144,115088
3935,rpelissi,2,0.00174,39686,34.48318,115088
3936,rqc,2,0.00174,39688,34.48492,115088
3937,rscot231,2,0.00174,39690,34.48665,115088
3938,rstpv,2,0.00174,39692,34.48839,115088
3939,rverma-nikiai,2,0.00174,39694,34.49013,115088
3940,ryanking,2,0.00174,39696,34.49187,115088
3941,ryhamz,2,0.00174,39698,34.49360,115088
3942,S569,2,0.00174,39700,34.49534,115088
3943,saahn,2,0.00174,39702,34.49708,115088
3944,sachaos,2,0.00174,39704,34.49882,115088
3945,sagarkal,2,0.00174,39706,34.50056,115088
3946,sagimann,2,0.00174,39708,34.50229,115088
3947,sagis-tikal,2,0.00174,39710,34.50403,115088
3948,saint1991,2,0.00174,39712,34.50577,115088
3949,saldixon,2,0.00174,39714,34.50751,115088
3950,sam0x17,2,0.00174,39716,34.50925,115088
3951,samcday,2,0.00174,39718,34.51098,115088
3952,sanjuicgithub,2,0.00174,39720,34.51272,115088
3953,sanmingzi,2,0.00174,39722,34.51446,115088
3954,sapg,2,0.00174,39724,34.51620,115088
3955,saranya2612,2,0.00174,39726,34.51793,115088
3956,satharasidineah,2,0.00174,39728,34.51967,115088
3957,saturday-shi,2,0.00174,39730,34.52141,115088
3958,satyatumati,2,0.00174,39732,34.52315,115088
3959,sbrandtb,2,0.00174,39734,34.52489,115088
3960,SebastianOsuna,2,0.00174,39736,34.52662,115088
3961,sebbacon,2,0.00174,39738,34.52836,115088
3962,seelam,2,0.00174,39740,34.53010,115088
3963,segalziv,2,0.00174,39742,34.53184,115088
3964,segfault,2,0.00174,39744,34.53357,115088
3965,seiffert,2,0.00174,39746,34.53531,115088
3966,seiyeah78,2,0.00174,39748,34.53705,115088
3967,Semmix,2,0.00174,39750,34.53879,115088
3968,senate6268,2,0.00174,39752,34.54053,115088
3969,sensay-nelson,2,0.00174,39754,34.54226,115088
3970,sentinelcross,2,0.00174,39756,34.54400,115088
3971,serafettin,2,0.00174,39758,34.54574,115088
3972,serain,2,0.00174,39760,34.54748,115088
3973,sergeyfedotov,2,0.00174,39762,34.54921,115088
3974,SergiyYarinovskiy,2,0.00174,39764,34.55095,115088
3975,serialoverflow,2,0.00174,39766,34.55269,115088
3976,servak,2,0.00174,39768,34.55443,115088
3977,seufagner,2,0.00174,39770,34.55617,115088
3978,sgnsys3,2,0.00174,39772,34.55790,115088
3979,shadjiiski,2,0.00174,39774,34.55964,115088
3980,ShankarSumanth,2,0.00174,39776,34.56138,115088
3981,She1d0n,2,0.00174,39778,34.56312,115088
3982,shetaksroc,2,0.00174,39780,34.56485,115088
3983,shibacow,2,0.00174,39782,34.56659,115088
3984,shihch,2,0.00174,39784,34.56833,115088
3985,shineforever,2,0.00174,39786,34.57007,115088
3986,ShivakumarSwamy,2,0.00174,39788,34.57181,115088
3987,shivamdixit,2,0.00174,39790,34.57354,115088
3988,shock-pewtoo,2,0.00174,39792,34.57528,115088
3989,shogo82148,2,0.00174,39794,34.57702,115088
3990,Shota-Tajiri,2,0.00174,39796,34.57876,115088
3991,shrikrishnaholla,2,0.00174,39798,34.58049,115088
3992,sidcarter,2,0.00174,39800,34.58223,115088
3993,simonxmh,2,0.00174,39802,34.58397,115088
3994,siroken3,2,0.00174,39804,34.58571,115088
3995,skaminski23,2,0.00174,39806,34.58745,115088
3996,skdasarin00b,2,0.00174,39808,34.58918,115088
3997,SkeLLLa,2,0.00174,39810,34.59092,115088
3998,slava-vishnyakov,2,0.00174,39812,34.59266,115088
3999,sleongkoan,2,0.00174,39814,34.59440,115088
4000,sliuu,2,0.00174,39816,34.59614,115088
4001,s-mansouri,2,0.00174,39818,34.59787,115088
4002,smira,2,0.00174,39820,34.59961,115088
4003,smirgel,2,0.00174,39822,34.60135,115088
4004,smith-30,2,0.00174,39824,34.60309,115088
4005,socialfeels,2,0.00174,39826,34.60482,115088
4006,solacens,2,0.00174,39828,34.60656,115088
4007,solatch,2,0.00174,39830,34.60830,115088
4008,someword,2,0.00174,39832,34.61004,115088
4009,sovioletta,2,0.00174,39834,34.61178,115088
4010,spkesan,2,0.00174,39836,34.61351,115088
4011,splunk-oss-admin,2,0.00174,39838,34.61525,115088
4012,SpringMT,2,0.00174,39840,34.61699,115088
4013,sriramflydata,2,0.00174,39842,34.61873,115088
4014,sriv1211,2,0.00174,39844,34.62046,115088
4015,Srynetix,2,0.00174,39846,34.62220,115088
4016,ssmiller25,2,0.00174,39848,34.62394,115088
4017,stalkerg,2,0.00174,39850,34.62568,115088
4018,stanleyxc,2,0.00174,39852,34.62742,115088
4019,starkers,2,0.00174,39854,34.62915,115088
4020,starmaker-dev,2,0.00174,39856,34.63089,115088
4021,stati0n,2,0.00174,39858,34.63263,115088
4022,stefk,2,0.00174,39860,34.63437,115088
4023,stevenringo,2,0.00174,39862,34.63610,115088
4024,straight-shoota,2,0.00174,39864,34.63784,115088
4025,stronny,2,0.00174,39866,34.63958,115088
4026,suanziliu,2,0.00174,39868,34.64132,115088
4027,subodh100,2,0.00174,39870,34.64306,115088
4028,sumeethtewar,2,0.00174,39872,34.64479,115088
4029,superkjp,2,0.00174,39874,34.64653,115088
4030,supermock,2,0.00174,39876,34.64827,115088
4031,SurenNihalani,2,0.00174,39878,34.65001,115088
4032,suversky,2,0.00174,39880,34.65174,115088
4033,svengau,2,0.00174,39882,34.65348,115088
4034,svenkin,2,0.00174,39884,34.65522,115088
4035,SVPA-LenPistoria,2,0.00174,39886,34.65696,115088
4036,sys-cat,2,0.00174,39888,34.65870,115088
4037,szakavatott,2,0.00174,39890,34.66043,115088
4038,szepeviktor,2,0.00174,39892,34.66217,115088
4039,takipone,2,0.00174,39894,34.66391,115088
4040,tamarr,2,0.00174,39896,34.66565,115088
4041,taneli76,2,0.00174,39898,34.66738,115088
4042,TanTan-TT,2,0.00174,39900,34.66912,115088
4043,TarekAS,2,0.00174,39902,34.67086,115088
4044,tatsuyafw,2,0.00174,39904,34.67260,115088
4045,teamcitytest3,2,0.00174,39906,34.67434,115088
4046,techthumb,2,0.00174,39908,34.67607,115088
4047,tejaswi1234,2,0.00174,39910,34.67781,115088
4048,TerryYeo,2,0.00174,39912,34.67955,115088
4049,tetsuo-yamamoto,2,0.00174,39914,34.68129,115088
4050,tetsurosaito,2,0.00174,39916,34.68303,115088
4051,TeunRoefs,2,0.00174,39918,34.68476,115088
4052,texag93,2,0.00174,39920,34.68650,115088
4053,TheCoderGuyVlad,2,0.00174,39922,34.68824,115088
4054,theduke,2,0.00174,39924,34.68998,115088
4055,theindra,2,0.00174,39926,34.69171,115088
4056,themadprofessor,2,0.00174,39928,34.69345,115088
4057,ThibautGery,2,0.00174,39930,34.69519,115088
4058,thomasjungblut,2,0.00174,39932,34.69693,115088
4059,ThorstenKunz,2,0.00174,39934,34.69867,115088
4060,thwblueboy,2,0.00174,39936,34.70040,115088
4061,tianctrl,2,0.00174,39938,34.70214,115088
4062,tienjuki,2,0.00174,39940,34.70388,115088
4063,Timoses,2,0.00174,39942,34.70562,115088
4064,Tiny-wlx,2,0.00174,39944,34.70735,115088
4065,tirofax0,2,0.00174,39946,34.70909,115088
4066,tj13,2,0.00174,39948,34.71083,115088
4067,tkporter,2,0.00174,39950,34.71257,115088
4068,tlvenn,2,0.00174,39952,34.71431,115088
4069,tmd313,2,0.00174,39954,34.71604,115088
4070,tmdoit,2,0.00174,39956,34.71778,115088
4071,toconnor,2,0.00174,39958,34.71952,115088
4072,toddams,2,0.00174,39960,34.72126,115088
4073,toddlamb,2,0.00174,39962,34.72299,115088
4074,tomari,2,0.00174,39964,34.72473,115088
4075,tomasare,2,0.00174,39966,34.72647,115088
4076,tomas-didziokas,2,0.00174,39968,34.72821,115088
4077,TomaszKlosinski,2,0.00174,39970,34.72995,115088
4078,tomiloza,2,0.00174,39972,34.73168,115088
4079,tomitakazutaka,2,0.00174,39974,34.73342,115088
4080,TomMizrachi,2,0.00174,39976,34.73516,115088
4081,tonny1983,2,0.00174,39978,34.73690,115088
4082,torus,2,0.00174,39980,34.73863,115088
4083,toshikidoi,2,0.00174,39982,34.74037,115088
4084,toshimaru,2,0.00174,39984,34.74211,115088
4085,tranchitella,2,0.00174,39986,34.74385,115088
4086,trevorndodds,2,0.00174,39988,34.74559,115088
4087,tribonacci,2,0.00174,39990,34.74732,115088
4088,tritruong,2,0.00174,39992,34.74906,115088
4089,trotyoung,2,0.00174,39994,34.75080,115088
4090,tscott1213,2,0.00174,39996,34.75254,115088
4091,Tsidkenu,2,0.00174,39998,34.75427,115088
4092,tthayer,2,0.00174,40000,34.75601,115088
4093,ttk04,2,0.00174,40002,34.75775,115088
4094,ttwoosta,2,0.00174,40004,34.75949,115088
4095,tuchodi,2,0.00174,40006,34.76123,115088
4096,tuxtek,2,0.00174,40008,34.76296,115088
4097,tuxtof,2,0.00174,40010,34.76470,115088
4098,twDuke,2,0.00174,40012,34.76644,115088
4099,typ431127,2,0.00174,40014,34.76818,115088
4100,uchisako,2,0.00174,40016,34.76992,115088
4101,ugo5,2,0.00174,40018,34.77165,115088
4102,uhaciogullari,2,0.00174,40020,34.77339,115088
4103,UkrainianProgrammer,2,0.00174,40022,34.77513,115088
4104,ultinous-dancsa,2,0.00174,40024,34.77687,115088
4105,ulyr,2,0.00174,40026,34.77860,115088
4106,unetto,2,0.00174,40028,34.78034,115088
4107,UrosCvijan,2,0.00174,40030,34.78208,115088
4108,usk,2,0.00174,40032,34.78382,115088
4109,uswami,2,0.00174,40034,34.78556,115088
4110,utshav2008,2,0.00174,40036,34.78729,115088
4111,uyu423,2,0.00174,40038,34.78903,115088
4112,vadimkim,2,0.00174,40040,34.79077,115088
4113,valichek,2,0.00174,40042,34.79251,115088
4114,valkolaci,2,0.00174,40044,34.79424,115088
4115,vandot,2,0.00174,40046,34.79598,115088
4116,VarunSrinivasa,2,0.00174,40048,34.79772,115088
4117,vascoosx,2,0.00174,40050,34.79946,115088
4118,vazhnov,2,0.00174,40052,34.80120,115088
4119,vdnt,2,0.00174,40054,34.80293,115088
4120,vezir,2,0.00174,40056,34.80467,115088
4121,victorcoder,2,0.00174,40058,34.80641,115088
4122,vidhy,2,0.00174,40060,34.80815,115088
4123,vikashsingh005,2,0.00174,40062,34.80988,115088
4124,viljaste,2,0.00174,40064,34.81162,115088
4125,vilyapilya,2,0.00174,40066,34.81336,115088
4126,vinayakm340,2,0.00174,40068,34.81510,115088
4127,vinbie,2,0.00174,40070,34.81684,115088
4128,vincent927,2,0.00174,40072,34.81857,115088
4129,VincentCouzij,2,0.00174,40074,34.82031,115088
4130,vincesesto,2,0.00174,40076,34.82205,115088
4131,vineethloka,2,0.00174,40078,34.82379,115088
4132,visla,2,0.00174,40080,34.82552,115088
4133,vissible,2,0.00174,40082,34.82726,115088
4134,viveksinghggits,2,0.00174,40084,34.82900,115088
4135,voltige,2,0.00174,40086,34.83074,115088
4136,vsdoradla,2,0.00174,40088,34.83248,115088
4137,vsk-123,2,0.00174,40090,34.83421,115088
4138,vyscond,2,0.00174,40092,34.83595,115088
4139,w256,2,0.00174,40094,34.83769,115088
4140,w564791,2,0.00174,40096,34.83943,115088
4141,waelghaith97,2,0.00174,40098,34.84117,115088
4142,WafflesVonMaple,2,0.00174,40100,34.84290,115088
4143,walktall,2,0.00174,40102,34.84464,115088
4144,wanghaisheng,2,0.00174,40104,34.84638,115088
4145,wannesvc,2,0.00174,40106,34.84812,115088
4146,wapa5pow,2,0.00174,40108,34.84985,115088
4147,warrenackerman,2,0.00174,40110,34.85159,115088
4148,watnotte,2,0.00174,40112,34.85333,115088
4149,weaseal,2,0.00174,40114,34.85507,115088
4150,wfelipe,2,0.00174,40116,34.85681,115088
4151,willemt,2,0.00174,40118,34.85854,115088
4152,willmao,2,0.00174,40120,34.86028,115088
4153,winsorkwong,2,0.00174,40122,34.86202,115088
4154,winstonwp,2,0.00174,40124,34.86376,115088
4155,wirtsi,2,0.00174,40126,34.86549,115088
4156,witsoej,2,0.00174,40128,34.86723,115088
4157,wkf,2,0.00174,40130,34.86897,115088
4158,wolfthegray,2,0.00174,40132,34.87071,115088
4159,woosanwoosang,2,0.00174,40134,34.87245,115088
4160,worrel,2,0.00174,40136,34.87418,115088
4161,wrender,2,0.00174,40138,34.87592,115088
4162,wuchencm,2,0.00174,40140,34.87766,115088
4163,wukq,2,0.00174,40142,34.87940,115088
4164,wxy325,2,0.00174,40144,34.88113,115088
4165,x-fauzan-x,2,0.00174,40146,34.88287,115088
4166,xflag,2,0.00174,40148,34.88461,115088
4167,XiaoGe2030,2,0.00174,40150,34.88635,115088
4168,xinghusc,2,0.00174,40152,34.88809,115088
4169,xitkov,2,0.00174,40154,34.88982,115088
4170,xluffy,2,0.00174,40156,34.89156,115088
4171,xmackex,2,0.00174,40158,34.89330,115088
4172,xu-xiang,2,0.00174,40160,34.89504,115088
4173,xx-zhang,2,0.00174,40162,34.89677,115088
4174,Xyaren,2,0.00174,40164,34.89851,115088
4175,yamamo-i,2,0.00174,40166,34.90025,115088
4176,yas-ysd,2,0.00174,40168,34.90199,115088
4177,yedeng,2,0.00174,40170,34.90373,115088
4178,yhara,2,0.00174,40172,34.90546,115088
4179,yichingwu,2,0.00174,40174,34.90720,115088
4180,yienge,2,0.00174,40176,34.90894,115088
4181,yinzhi7,2,0.00174,40178,34.91068,115088
4182,yizumi,2,0.00174,40180,34.91241,115088
4183,yk-twww,2,0.00174,40182,34.91415,115088
4184,ymchun,2,0.00174,40184,34.91589,115088
4185,YohaanYoon,2,0.00174,40186,34.91763,115088
4186,ytti,2,0.00174,40188,34.91937,115088
4187,yuha0,2,0.00174,40190,34.92110,115088
4188,yusufgungor,2,0.00174,40192,34.92284,115088
4189,yuxing1994,2,0.00174,40194,34.92458,115088
4190,ywchenbu,2,0.00174,40196,34.92632,115088
4191,yxd-hde,2,0.00174,40198,34.92806,115088
4192,zaa,2,0.00174,40200,34.92979,115088
4193,zacharynevin,2,0.00174,40202,34.93153,115088
4194,zackwine,2,0.00174,40204,34.93327,115088
4195,zanoubia,2,0.00174,40206,34.93501,115088
4196,zedtux,2,0.00174,40208,34.93674,115088
4197,zeph,2,0.00174,40210,34.93848,115088
4198,Zexi,2,0.00174,40212,34.94022,115088
4199,zhaominmail,2,0.00174,40214,34.94196,115088
4200,ZiggyMaes,2,0.00174,40216,34.94370,115088
4201,ziguzagu,2,0.00174,40218,34.94543,115088
4202,zkcarterlau,2,0.00174,40220,34.94717,115088
4203,znz,2,0.00174,40222,34.94891,115088
4204,Zophren,2,0.00174,40224,34.95065,115088
4205,ZP-AlwaysWin,2,0.00174,40226,34.95238,115088
4206,zpavlig,2,0.00174,40228,34.95412,115088
4207,zrochler,2,0.00174,40230,34.95586,115088
4208,zsozso,2,0.00174,40232,34.95760,115088
4209,08euccs014,1,0.00087,40233,34.95847,115088
4210,0913925162,1,0.00087,40234,34.95934,115088
4211,0x17de,1,0.00087,40235,34.96020,115088
4212,1mentat,1,0.00087,40236,34.96107,115088
4213,1ucasun,1,0.00087,40237,34.96194,115088
4214,328,1,0.00087,40238,34.96281,115088
4215,360d-io-labs,1,0.00087,40239,34.96368,115088
4216,3fr61n,1,0.00087,40240,34.96455,115088
4217,4680185,1,0.00087,40241,34.96542,115088
4218,54xiaosu,1,0.00087,40242,34.96629,115088
4219,759803573,1,0.00087,40243,34.96716,115088
4220,7KjN3mHq,1,0.00087,40244,34.96802,115088
4221,a2ikm,1,0.00087,40245,34.96889,115088
4222,a6kme,1,0.00087,40246,34.96976,115088
4223,aahmed-se,1,0.00087,40247,34.97063,115088
4224,aahndan,1,0.00087,40248,34.97150,115088
4225,aaron1989041,1,0.00087,40249,34.97237,115088
4226,aarvee11,1,0.00087,40250,34.97324,115088
4227,aatkinson-canopy,1,0.00087,40251,34.97411,115088
4228,aavinashjha,1,0.00087,40252,34.97498,115088
4229,AbdulHaseebHussain,1,0.00087,40253,34.97584,115088
4230,abernardino,1,0.00087,40254,34.97671,115088
4231,abhishek063,1,0.00087,40255,34.97758,115088
4232,AbhishekChudekar,1,0.00087,40256,34.97845,115088
4233,abhishekwy,1,0.00087,40257,34.97932,115088
4234,abijitn,1,0.00087,40258,34.98019,115088
4235,abrakhim,1,0.00087,40259,34.98106,115088
4236,ace03uec,1,0.00087,40260,34.98193,115088
4237,acmmayur,1,0.00087,40261,34.98280,115088
4238,acrylicx,1,0.00087,40262,34.98366,115088
4239,acty-yoshida,1,0.00087,40263,34.98453,115088
4240,adamjerickson,1,0.00087,40264,34.98540,115088
4241,adamlukaszczyk,1,0.00087,40265,34.98627,115088
4242,adams-sarah,1,0.00087,40266,34.98714,115088
4243,adawalli,1,0.00087,40267,34.98801,115088
4244,adbrowne,1,0.00087,40268,34.98888,115088
4245,adeesent,1,0.00087,40269,34.98975,115088
4246,ademars94,1,0.00087,40270,34.99062,115088
4247,aderuwe,1,0.00087,40271,34.99148,115088
4248,adichiru,1,0.00087,40272,34.99235,115088
4249,AdmiralGT,1,0.00087,40273,34.99322,115088
4250,adolci,1,0.00087,40274,34.99409,115088
4251,adolia,1,0.00087,40275,34.99496,115088
4252,adonishi,1,0.00087,40276,34.99583,115088
4253,adrianguenter,1,0.00087,40277,34.99670,115088
4254,adrianog,1,0.00087,40278,34.99757,115088
4255,adw1n,1,0.00087,40279,34.99844,115088
4256,adyekjaer,1,0.00087,40280,34.99930,115088
4257,aeibrahim,1,0.00087,40281,35.00017,115088
4258,afeld,1,0.00087,40282,35.00104,115088
4259,agarwalshivam456,1,0.00087,40283,35.00191,115088
4260,agasbzj,1,0.00087,40284,35.00278,115088
4261,aggarwalShivani,1,0.00087,40285,35.00365,115088
4262,agonzalez-tk,1,0.00087,40286,35.00452,115088
4263,agrozyme,1,0.00087,40287,35.00539,115088
4264,agsimeonov,1,0.00087,40288,35.00626,115088
4265,ahacking,1,0.00087,40289,35.00712,115088
4266,aheimowitz,1,0.00087,40290,35.00799,115088
4267,ahprez,1,0.00087,40291,35.00886,115088
4268,aiueogawa,1,0.00087,40292,35.00973,115088
4269,AixNPanes,1,0.00087,40293,35.01060,115088
4270,ajevans85,1,0.00087,40294,35.01147,115088
4271,aka-cafu,1,0.00087,40295,35.01234,115088
4272,akailash,1,0.00087,40296,35.01321,115088
4273,akhilkumarpdd,1,0.00087,40297,35.01408,115088
4274,akhy,1,0.00087,40298,35.01495,115088
4275,akirakiron,1,0.00087,40299,35.01581,115088
4276,akkie,1,0.00087,40300,35.01668,115088
4277,akngs,1,0.00087,40301,35.01755,115088
4278,Akshay-Iyangar,1,0.00087,40302,35.01842,115088
4279,akunaatrium,1,0.00087,40303,35.01929,115088
4280,alahijani,1,0.00087,40304,35.02016,115088
4281,alanh0vx,1,0.00087,40305,35.02103,115088
4282,Alars-ALIT,1,0.00087,40306,35.02190,115088
4283,alarsyo,1,0.00087,40307,35.02277,115088
4284,albertweng13,1,0.00087,40308,35.02363,115088
4285,aleks-mariusz,1,0.00087,40309,35.02450,115088
4286,Alessar,1,0.00087,40310,35.02537,115088
4287,Alewex,1,0.00087,40311,35.02624,115088
4288,AlexandreProenca,1,0.00087,40312,35.02711,115088
4289,alexbarcelo,1,0.00087,40313,35.02798,115088
4290,alexbklein91,1,0.00087,40314,35.02885,115088
4291,alexilievski,1,0.00087,40315,35.02972,115088
4292,alex-kovshovik,1,0.00087,40316,35.03059,115088
4293,alexlehm,1,0.00087,40317,35.03145,115088
4294,alexmerkel,1,0.00087,40318,35.03232,115088
4295,alexpatel,1,0.00087,40319,35.03319,115088
4296,AlexProfi,1,0.00087,40320,35.03406,115088
4297,AlexRRR,1,0.00087,40321,35.03493,115088
4298,alexxed,1,0.00087,40322,35.03580,115088
4299,ALFNeT,1,0.00087,40323,35.03667,115088
4300,algestam,1,0.00087,40324,35.03754,115088
4301,alicuche,1,0.00087,40325,35.03841,115088
4302,alihalabyah,1,0.00087,40326,35.03927,115088
4303,allenbang,1,0.00087,40327,35.04014,115088
4304,Allesgluck,1,0.00087,40328,35.04101,115088
4305,alrf,1,0.00087,40329,35.04188,115088
4306,AlskiOnTheWeb,1,0.00087,40330,35.04275,115088
4307,aluedeke,1,0.00087,40331,35.04362,115088
4308,alvinhom,1,0.00087,40332,35.04449,115088
4309,amaraaon,1,0.00087,40333,35.04536,115088
4310,amartinunowhy,1,0.00087,40334,35.04623,115088
4311,ameir,1,0.00087,40335,35.04709,115088
4312,amgohan,1,0.00087,40336,35.04796,115088
4313,amihura,1,0.00087,40337,35.04883,115088
4314,amitga-rnd,1,0.00087,40338,35.04970,115088
4315,amit-uc,1,0.00087,40339,35.05057,115088
4316,amlife,1,0.00087,40340,35.05144,115088
4317,andesyudanto,1,0.00087,40341,35.05231,115088
4318,andlaz,1,0.00087,40342,35.05318,115088
4319,andreacasini,1,0.00087,40343,35.05405,115088
4320,andrecastro,1,0.00087,40344,35.05491,115088
4321,andreek,1,0.00087,40345,35.05578,115088
4322,andrei-galkin,1,0.00087,40346,35.05665,115088
4323,AndresPineros,1,0.00087,40347,35.05752,115088
4324,AndrewBoklashko,1,0.00087,40348,35.05839,115088
4325,andrewkrug,1,0.00087,40349,35.05926,115088
4326,andrewl,1,0.00087,40350,35.06013,115088
4327,andrewnazarov,1,0.00087,40351,35.06100,115088
4328,AndrewX192,1,0.00087,40352,35.06187,115088
4329,AndriiPopok,1,0.00087,40353,35.06273,115088
4330,AndriMar,1,0.00087,40354,35.06360,115088
4331,andyliddle,1,0.00087,40355,35.06447,115088
4332,andywow,1,0.00087,40356,35.06534,115088
4333,andyy5,1,0.00087,40357,35.06621,115088
4334,aneagoe,1,0.00087,40358,35.06708,115088
4335,aneal,1,0.00087,40359,35.06795,115088
4336,AngryGami,1,0.00087,40360,35.06882,115088
4337,anhnk,1,0.00087,40361,35.06969,115088
4338,aniamin,1,0.00087,40362,35.07055,115088
4339,AnishAnil,1,0.00087,40363,35.07142,115088
4340,aniskhan001,1,0.00087,40364,35.07229,115088
4341,ankitgoelcmu,1,0.00087,40365,35.07316,115088
4342,ankitrg,1,0.00087,40366,35.07403,115088
4343,ankkumar-progress,1,0.00087,40367,35.07490,115088
4344,Ankushaccc,1,0.00087,40368,35.07577,115088
4345,annymsMthd,1,0.00087,40369,35.07664,115088
4346,anoopsmai,1,0.00087,40370,35.07751,115088
4347,anoopvm,1,0.00087,40371,35.07837,115088
4348,anosek-verimatrix,1,0.00087,40372,35.07924,115088
4349,antohaby,1,0.00087,40373,35.08011,115088
4350,Anubh,1,0.00087,40374,35.08098,115088
4351,anymms,1,0.00087,40375,35.08185,115088
4352,aohta,1,0.00087,40376,35.08272,115088
4353,AO-StreetArt,1,0.00087,40377,35.08359,115088
4354,aotenko,1,0.00087,40378,35.08446,115088
4355,apacoco9861,1,0.00087,40379,35.08533,115088
4356,apchee,1,0.00087,40380,35.08619,115088
4357,AphexFX,1,0.00087,40381,35.08706,115088
4358,aplulu,1,0.00087,40382,35.08793,115088
4359,appiritsnakamatsu,1,0.00087,40383,35.08880,115088
4360,AprilZhaoWY,1,0.00087,40384,35.08967,115088
4361,apsey,1,0.00087,40385,35.09054,115088
4362,aptranj,1,0.00087,40386,35.09141,115088
4363,aranair,1,0.00087,40387,35.09228,115088
4364,arascanakin,1,0.00087,40388,35.09315,115088
4365,arbenibeni,1,0.00087,40389,35.09402,115088
4366,arbetts,1,0.00087,40390,35.09488,115088
4367,archie,1,0.00087,40391,35.09575,115088
4368,arcsector,1,0.00087,40392,35.09662,115088
4369,ardfard,1,0.00087,40393,35.09749,115088
4370,argirischristakos,1,0.00087,40394,35.09836,115088
4371,argz,1,0.00087,40395,35.09923,115088
4372,arienchen,1,0.00087,40396,35.10010,115088
4373,ariforu,1,0.00087,40397,35.10097,115088
4374,arittner,1,0.00087,40398,35.10184,115088
4375,arjun-urs,1,0.00087,40399,35.10270,115088
4376,arminc,1,0.00087,40400,35.10357,115088
4377,arrow003,1,0.00087,40401,35.10444,115088
4378,artash,1,0.00087,40402,35.10531,115088
4379,artbeglaryan,1,0.00087,40403,35.10618,115088
4380,artemas,1,0.00087,40404,35.10705,115088
4381,ArthurasJ,1,0.00087,40405,35.10792,115088
4382,ArthurJiang,1,0.00087,40406,35.10879,115088
4383,ArthurSens,1,0.00087,40407,35.10966,115088
4384,ArturZurawski,1,0.00087,40408,35.11052,115088
4385,arunapavan,1,0.00087,40409,35.11139,115088
4386,arunasamula,1,0.00087,40410,35.11226,115088
4387,ArunDahiya1,1,0.00087,40411,35.11313,115088
4388,aruruka,1,0.00087,40412,35.11400,115088
4389,arvind-naidu,1,0.00087,40413,35.11487,115088
4390,asaaki,1,0.00087,40414,35.11574,115088
4391,asamasoma,1,0.00087,40415,35.11661,115088
4392,asbish,1,0.00087,40416,35.11748,115088
4393,aschofie,1,0.00087,40417,35.11834,115088
4394,asdfgasfhsn,1,0.00087,40418,35.11921,115088
4395,ashmckenzie,1,0.00087,40419,35.12008,115088
4396,ashokkkannan,1,0.00087,40420,35.12095,115088
4397,ashramsey,1,0.00087,40421,35.12182,115088
4398,asmsuechan,1,0.00087,40422,35.12269,115088
4399,Aspekt112,1,0.00087,40423,35.12356,115088
4400,astronaut1712,1,0.00087,40424,35.12443,115088
4401,asumawang,1,0.00087,40425,35.12530,115088
4402,asummers,1,0.00087,40426,35.12616,115088
4403,Athest,1,0.00087,40427,35.12703,115088
4404,athoune,1,0.00087,40428,35.12790,115088
4405,athuljayaraj,1,0.00087,40429,35.12877,115088
4406,athurg,1,0.00087,40430,35.12964,115088
4407,atikhonov-avito,1,0.00087,40431,35.13051,115088
4408,atm1992,1,0.00087,40432,35.13138,115088
4409,aturri,1,0.00087,40433,35.13225,115088
4410,avdhoot,1,0.00087,40434,35.13312,115088
4411,averri,1,0.00087,40435,35.13398,115088
4412,awcheney,1,0.00087,40436,35.13485,115088
4413,AxellH,1,0.00087,40437,35.13572,115088
4414,azhurbilo,1,0.00087,40438,35.13659,115088
4415,azimut,1,0.00087,40439,35.13746,115088
4416,Azuka,1,0.00087,40440,35.13833,115088
4417,baaree,1,0.00087,40441,35.13920,115088
4418,badyli,1,0.00087,40442,35.14007,115088
4419,balajijinnah,1,0.00087,40443,35.14094,115088
4420,baldomeromero,1,0.00087,40444,35.14180,115088
4421,balistof,1,0.00087,40445,35.14267,115088
4422,bam0382,1,0.00087,40446,35.14354,115088
4423,barbarosalp,1,0.00087,40447,35.14441,115088
4424,BarthV,1,0.00087,40448,35.14528,115088
4425,bathizte,1,0.00087,40449,35.14615,115088
4426,bbcnt,1,0.00087,40450,35.14702,115088
4427,bbc-tomfitzhenry,1,0.00087,40451,35.14789,115088
4428,bbelchak,1,0.00087,40452,35.14876,115088
4429,bcantin,1,0.00087,40453,35.14962,115088
4430,bcottinghamae,1,0.00087,40454,35.15049,115088
4431,bdnf,1,0.00087,40455,35.15136,115088
4432,bdqnghi,1,0.00087,40456,35.15223,115088
4433,beeva-alvarolopez,1,0.00087,40457,35.15310,115088
4434,belaytzev,1,0.00087,40458,35.15397,115088
4435,beng-beng,1,0.00087,40459,35.15484,115088
4436,benjaminhuo,1,0.00087,40460,35.15571,115088
4437,benjumanji,1,0.00087,40461,35.15658,115088
4438,benkeil,1,0.00087,40462,35.15744,115088
4439,ben-lei,1,0.00087,40463,35.15831,115088
4440,benner,1,0.00087,40464,35.15918,115088
4441,benoc617,1,0.00087,40465,35.16005,115088
4442,benoitc,1,0.00087,40466,35.16092,115088
4443,bentol,1,0.00087,40467,35.16179,115088
4444,benzheren,1,0.00087,40468,35.16266,115088
4445,beornf,1,0.00087,40469,35.16353,115088
4446,bergerx,1,0.00087,40470,35.16440,115088
4447,bertramn,1,0.00087,40471,35.16526,115088
4448,bgsilvait,1,0.00087,40472,35.16613,115088
4449,bguerout,1,0.00087,40473,35.16700,115088
4450,BhartiAgrawalNvidia,1,0.00087,40474,35.16787,115088
4451,bhaskar-chenchu,1,0.00087,40475,35.16874,115088
4452,Bhaskars,1,0.00087,40476,35.16961,115088
4453,bhavishyagopesh,1,0.00087,40477,35.17048,115088
4454,bhavyabhatj,1,0.00087,40478,35.17135,115088
4455,bhvishal9,1,0.00087,40479,35.17222,115088
4456,Bidhanbst,1,0.00087,40480,35.17308,115088
4457,bijaya1,1,0.00087,40481,35.17395,115088
4458,bikkinamahesh369,1,0.00087,40482,35.17482,115088
4459,billiaz,1,0.00087,40483,35.17569,115088
4460,billmers,1,0.00087,40484,35.17656,115088
4461,bimalvasan,1,0.00087,40485,35.17743,115088
4462,binarymechanic,1,0.00087,40486,35.17830,115088
4463,bit-wrangler,1,0.00087,40487,35.17917,115088
4464,bivald,1,0.00087,40488,35.18004,115088
4465,BjergsenZhu,1,0.00087,40489,35.18091,115088
4466,bkayranci,1,0.00087,40490,35.18177,115088
4467,bl000b,1,0.00087,40491,35.18264,115088
4468,Blackbam,1,0.00087,40492,35.18351,115088
4469,BlackBsd,1,0.00087,40493,35.18438,115088
4470,blackholegalaxy,1,0.00087,40494,35.18525,115088
4471,blackxored,1,0.00087,40495,35.18612,115088
4472,bliemli,1,0.00087,40496,35.18699,115088
4473,blofroth,1,0.00087,40497,35.18786,115088
4474,blogwatcher-gi,1,0.00087,40498,35.18873,115088
4475,bmalynovytch,1,0.00087,40499,35.18959,115088
4476,bmcgavin,1,0.00087,40500,35.19046,115088
4477,bmenasha,1,0.00087,40501,35.19133,115088
4478,bmihaescu,1,0.00087,40502,35.19220,115088
4479,boatmisser,1,0.00087,40503,35.19307,115088
4480,bobasek,1,0.00087,40504,35.19394,115088
4481,bobziuchkovski,1,0.00087,40505,35.19481,115088
4482,bodsch,1,0.00087,40506,35.19568,115088
4483,bogdanRada,1,0.00087,40507,35.19655,115088
4484,bonczj,1,0.00087,40508,35.19741,115088
4485,boodera,1,0.00087,40509,35.19828,115088
4486,bootswithdefer,1,0.00087,40510,35.19915,115088
4487,boumitran,1,0.00087,40511,35.20002,115088
4488,BoundInfinity,1,0.00087,40512,35.20089,115088
4489,bozhou94,1,0.00087,40513,35.20176,115088
4490,bozydar,1,0.00087,40514,35.20263,115088
4491,brad-alexander,1,0.00087,40515,35.20350,115088
4492,brad-hays-mentor,1,0.00087,40516,35.20437,115088
4493,bradwilson,1,0.00087,40517,35.20523,115088
4494,BrandonTsai,1,0.00087,40518,35.20610,115088
4495,braybaut,1,0.00087,40519,35.20697,115088
4496,breeze7086,1,0.00087,40520,35.20784,115088
4497,brendanly,1,0.00087,40521,35.20871,115088
4498,brettrann,1,0.00087,40522,35.20958,115088
4499,brifordwylie,1,0.00087,40523,35.21045,115088
4500,brightzheng100,1,0.00087,40524,35.21132,115088
4501,brokencube,1,0.00087,40525,35.21219,115088
4502,browny,1,0.00087,40526,35.21305,115088
4503,broxio,1,0.00087,40527,35.21392,115088
4504,brunsgaard,1,0.00087,40528,35.21479,115088
4505,Bruslaan,1,0.00087,40529,35.21566,115088
4506,brutallino,1,0.00087,40530,35.21653,115088
4507,bryan831,1,0.00087,40531,35.21740,115088
4508,bryan-radiant,1,0.00087,40532,35.21827,115088
4509,bschwartz757,1,0.00087,40533,35.21914,115088
4510,btomasini,1,0.00087,40534,35.22001,115088
4511,buch11,1,0.00087,40535,35.22087,115088
4512,buchmui,1,0.00087,40536,35.22174,115088
4513,burandobata,1,0.00087,40537,35.22261,115088
4514,buzztaiki,1,0.00087,40538,35.22348,115088
4515,bwolfehcm,1,0.00087,40539,35.22435,115088
4516,bygui86,1,0.00087,40540,35.22522,115088
4517,cainelli,1,0.00087,40541,35.22609,115088
4518,cajbecu,1,0.00087,40542,35.22696,115088
4519,calibr,1,0.00087,40543,35.22783,115088
4520,callicles,1,0.00087,40544,35.22869,115088
4521,camelmasa,1,0.00087,40545,35.22956,115088
4522,captn3m0,1,0.00087,40546,35.23043,115088
4523,carlesar,1,0.00087,40547,35.23130,115088
4524,CarlGill,1,0.00087,40548,35.23217,115088
4525,carlosmkb,1,0.00087,40549,35.23304,115088
4526,carlosrochap,1,0.00087,40550,35.23391,115088
4527,carl-peng,1,0.00087,40551,35.23478,115088
4528,carsonip,1,0.00087,40552,35.23565,115088
4529,catlittlechen,1,0.00087,40553,35.23651,115088
4530,cblument,1,0.00087,40554,35.23738,115088
4531,cbruno10,1,0.00087,40555,35.23825,115088
4532,cchaussat,1,0.00087,40556,35.23912,115088
4533,cCloudSky,1,0.00087,40557,35.23999,115088
4534,ccs018,1,0.00087,40558,35.24086,115088
4535,cdj03,1,0.00087,40559,35.24173,115088
4536,cedretaber,1,0.00087,40560,35.24260,115088
4537,cejast,1,0.00087,40561,35.24347,115088
4538,cellnuscyrus,1,0.00087,40562,35.24433,115088
4539,cesare,1,0.00087,40563,35.24520,115088
4540,cf-gitbot,1,0.00087,40564,35.24607,115088
4541,cgst,1,0.00087,40565,35.24694,115088
4542,chadlwm,1,0.00087,40566,35.24781,115088
4543,chaitrahegde115,1,0.00087,40567,35.24868,115088
4544,chaospixel,1,0.00087,40568,35.24955,115088
4545,charlecoms,1,0.00087,40569,35.25042,115088
4546,charliezang,1,0.00087,40570,35.25129,115088
4547,chaseYLC,1,0.00087,40571,35.25215,115088
4548,chbndrhnns,1,0.00087,40572,35.25302,115088
4549,CH-DanReif,1,0.00087,40573,35.25389,115088
4550,chemelnucfin,1,0.00087,40574,35.25476,115088
4551,chenjpu,1,0.00087,40575,35.25563,115088
4552,chenmin1992,1,0.00087,40576,35.25650,115088
4553,chesterlai,1,0.00087,40577,35.25737,115088
4554,chgliu2018,1,0.00087,40578,35.25824,115088
4555,chigichan24,1,0.00087,40579,35.25911,115088
4556,childofb0d0m,1,0.00087,40580,35.25997,115088
4557,chilibreaker,1,0.00087,40581,35.26084,115088
4558,chilinhnet,1,0.00087,40582,35.26171,115088
4559,chillum,1,0.00087,40583,35.26258,115088
4560,Chinaxiang,1,0.00087,40584,35.26345,115088
4561,ChiperSoft,1,0.00087,40585,35.26432,115088
4562,ChitraKumarS,1,0.00087,40586,35.26519,115088
4563,chitsaou,1,0.00087,40587,35.26606,115088
4564,cho-m,1,0.00087,40588,35.26693,115088
4565,ChrisCGH,1,0.00087,40589,35.26780,115088
4566,chrisdebug,1,0.00087,40590,35.26866,115088
4567,chrisleavoy,1,0.00087,40591,35.26953,115088
4568,christhesoul,1,0.00087,40592,35.27040,115088
4569,ChristiaanWestgeest,1,0.00087,40593,35.27127,115088
4570,ChristineTChen,1,0.00087,40594,35.27214,115088
4571,christopherL91,1,0.00087,40595,35.27301,115088
4572,chrisvaughn,1,0.00087,40596,35.27388,115088
4573,chris-x86-64,1,0.00087,40597,35.27475,115088
4574,chuan,1,0.00087,40598,35.27562,115088
4575,citosid,1,0.00087,40599,35.27648,115088
4576,cityzendata,1,0.00087,40600,35.27735,115088
4577,cjdmax,1,0.00087,40601,35.27822,115088
4578,ckdanny,1,0.00087,40602,35.27909,115088
4579,ckwang8128,1,0.00087,40603,35.27996,115088
4580,claralui,1,0.00087,40604,35.28083,115088
4581,cleankod,1,0.00087,40605,35.28170,115088
4582,clok,1,0.00087,40606,35.28257,115088
4583,clsung,1,0.00087,40607,35.28344,115088
4584,cmachgodaddy,1,0.00087,40608,35.28430,115088
4585,CmdrKeen,1,0.00087,40609,35.28517,115088
4586,cmygeHm,1,0.00087,40610,35.28604,115088
4587,cnosuke,1,0.00087,40611,35.28691,115088
4588,codeninja55,1,0.00087,40612,35.28778,115088
4589,coderabhi03,1,0.00087,40613,35.28865,115088
4590,coders-kitchen,1,0.00087,40614,35.28952,115088
4591,codesqueak,1,0.00087,40615,35.29039,115088
4592,cognitiaclaeves,1,0.00087,40616,35.29126,115088
4593,colegatron,1,0.00087,40617,35.29212,115088
4594,colinbjohnson,1,0.00087,40618,35.29299,115088
4595,colinnewell,1,0.00087,40619,35.29386,115088
4596,colin-nolan,1,0.00087,40620,35.29473,115088
4597,collin-bachi-sp,1,0.00087,40621,35.29560,115088
4598,comutt,1,0.00087,40622,35.29647,115088
4599,ConaghFM,1,0.00087,40623,35.29734,115088
4600,conaku,1,0.00087,40624,35.29821,115088
4601,copumpkin,1,0.00087,40625,35.29908,115088
4602,coreteam-co,1,0.00087,40626,35.29994,115088
4603,corvinusy,1,0.00087,40627,35.30081,115088
4604,Cosmo,1,0.00087,40628,35.30168,115088
4605,costa,1,0.00087,40629,35.30255,115088
4606,CoufalJa,1,0.00087,40630,35.30342,115088
4607,countergram,1,0.00087,40631,35.30429,115088
4608,countingtoten,1,0.00087,40632,35.30516,115088
4609,cpxPratik,1,0.00087,40633,35.30603,115088
4610,crackmac,1,0.00087,40634,35.30690,115088
4611,crain,1,0.00087,40635,35.30776,115088
4612,CrazyUmka,1,0.00087,40636,35.30863,115088
4613,CrazyZfp,1,0.00087,40637,35.30950,115088
4614,cricketfan5,1,0.00087,40638,35.31037,115088
4615,crysper,1,0.00087,40639,35.31124,115088
4616,Crystark,1,0.00087,40640,35.31211,115088
4617,cschug,1,0.00087,40641,35.31298,115088
4618,csimani,1,0.00087,40642,35.31385,115088
4619,ctproject4,1,0.00087,40643,35.31472,115088
4620,cuiliang5,1,0.00087,40644,35.31558,115088
4621,cusxio,1,0.00087,40645,35.31645,115088
4622,cwbuege,1,0.00087,40646,35.31732,115088
4623,CyberGecko,1,0.00087,40647,35.31819,115088
4624,cynial,1,0.00087,40648,35.31906,115088
4625,cyyeong,1,0.00087,40649,35.31993,115088
4626,cz-moteki-takahiro,1,0.00087,40650,35.32080,115088
4627,d4ntheman,1,0.00087,40651,35.32167,115088
4628,dabr-grapeup,1,0.00087,40652,35.32254,115088
4629,dad264,1,0.00087,40653,35.32340,115088
4630,da-edra,1,0.00087,40654,35.32427,115088
4631,dafegit,1,0.00087,40655,35.32514,115088
4632,daguilarv,1,0.00087,40656,35.32601,115088
4633,daikeren,1,0.00087,40657,35.32688,115088
4634,daiksy,1,0.00087,40658,35.32775,115088
4635,dakky,1,0.00087,40659,35.32862,115088
4636,dale-oconnor,1,0.00087,40660,35.32949,115088
4637,damiansilbergleithcunniff,1,0.00087,40661,35.33036,115088
4638,dancb10,1,0.00087,40662,35.33122,115088
4639,danielcb,1,0.00087,40663,35.33209,115088
4640,danielcompton,1,0.00087,40664,35.33296,115088
4641,danielefranceschi,1,0.00087,40665,35.33383,115088
4642,DanielJRutledge,1,0.00087,40666,35.33470,115088
4643,danilorsilva,1,0.00087,40667,35.33557,115088
4644,dannylesnik,1,0.00087,40668,35.33644,115088
4645,danopia,1,0.00087,40669,35.33731,115088
4646,darklore,1,0.00087,40670,35.33818,115088
4647,darthchudi,1,0.00087,40671,35.33904,115088
4648,datianshi21,1,0.00087,40672,35.33991,115088
4649,Datise,1,0.00087,40673,35.34078,115088
4650,dave00galloway,1,0.00087,40674,35.34165,115088
4651,davedastrange,1,0.00087,40675,35.34252,115088
4652,davelee0504,1,0.00087,40676,35.34339,115088
4653,davidchua,1,0.00087,40677,35.34426,115088
4654,davide-romanini,1,0.00087,40678,35.34513,115088
4655,david-rooke,1,0.00087,40679,35.34600,115088
4656,davidwartell,1,0.00087,40680,35.34687,115088
4657,davix,1,0.00087,40681,35.34773,115088
4658,dbarriguete,1,0.00087,40682,35.34860,115088
4659,dbousamra,1,0.00087,40683,35.34947,115088
4660,dchai76,1,0.00087,40684,35.35034,115088
4661,dchimeno,1,0.00087,40685,35.35121,115088
4662,dchinmaya,1,0.00087,40686,35.35208,115088
4663,dcruzin,1,0.00087,40687,35.35295,115088
4664,ddehghan,1,0.00087,40688,35.35382,115088
4665,Deaddy,1,0.00087,40689,35.35469,115088
4666,deepakmittal,1,0.00087,40690,35.35555,115088
4667,deepaksharma17,1,0.00087,40691,35.35642,115088
4668,dehemart,1,0.00087,40692,35.35729,115088
4669,deiv,1,0.00087,40693,35.35816,115088
4670,dekked,1,0.00087,40694,35.35903,115088
4671,Denis101,1,0.00087,40695,35.35990,115088
4672,denmarkin,1,0.00087,40696,35.36077,115088
4673,DennyZhang,1,0.00087,40697,35.36164,115088
4674,denser,1,0.00087,40698,35.36251,115088
4675,DenverJ,1,0.00087,40699,35.36337,115088
4676,DeploymentKing,1,0.00087,40700,35.36424,115088
4677,dev-bandai,1,0.00087,40701,35.36511,115088
4678,devils-ey3,1,0.00087,40702,35.36598,115088
4679,deweller,1,0.00087,40703,35.36685,115088
4680,dfateyev,1,0.00087,40704,35.36772,115088
4681,dgalichet,1,0.00087,40705,35.36859,115088
4682,DH-Mike,1,0.00087,40706,35.36946,115088
4683,diannaowa,1,0.00087,40707,35.37033,115088
4684,didhd,1,0.00087,40708,35.37119,115088
4685,DieZ,1,0.00087,40709,35.37206,115088
4686,digi691,1,0.00087,40710,35.37293,115088
4687,DigitalRogues,1,0.00087,40711,35.37380,115088
4688,dimitrovvlado,1,0.00087,40712,35.37467,115088
4689,dingobar,1,0.00087,40713,35.37554,115088
4690,dionjwa,1,0.00087,40714,35.37641,115088
4691,diptimanadak,1,0.00087,40715,35.37728,115088
4692,directeam,1,0.00087,40716,35.37815,115088
4693,directionless,1,0.00087,40717,35.37901,115088
4694,djotanov,1,0.00087,40718,35.37988,115088
4695,dkopack,1,0.00087,40719,35.38075,115088
4696,dleyanlin,1,0.00087,40720,35.38162,115088
4697,dloiko,1,0.00087,40721,35.38249,115088
4698,dmarkey,1,0.00087,40722,35.38336,115088
4699,dmatheron,1,0.00087,40723,35.38423,115088
4700,dmatosl,1,0.00087,40724,35.38510,115088
4701,dmilde,1,0.00087,40725,35.38597,115088
4702,DmitriyProkhorov,1,0.00087,40726,35.38683,115088
4703,dmnjohns,1,0.00087,40727,35.38770,115088
4704,dmytroleonenko,1,0.00087,40728,35.38857,115088
4705,dogzzdogzz,1,0.00087,40729,35.38944,115088
4706,dohoangkhiem,1,0.00087,40730,35.39031,115088
4707,Dolape1983,1,0.00087,40731,35.39118,115088
4708,dominicphillips,1,0.00087,40732,35.39205,115088
4709,donat-b,1,0.00087,40733,35.39292,115088
4710,donovanwhite,1,0.00087,40734,35.39379,115088
4711,dontspamterry,1,0.00087,40735,35.39465,115088
4712,doron-td-agent,1,0.00087,40736,35.39552,115088
4713,doublemarket,1,0.00087,40737,35.39639,115088
4714,doublening,1,0.00087,40738,35.39726,115088
4715,dougbeauchene,1,0.00087,40739,35.39813,115088
4716,DougC,1,0.00087,40740,35.39900,115088
4717,dpeterka,1,0.00087,40741,35.39987,115088
4718,dpgeekzero,1,0.00087,40742,35.40074,115088
4719,dpovshed,1,0.00087,40743,35.40161,115088
4720,dracmic,1,0.00087,40744,35.40247,115088
4721,DrMavenRebe,1,0.00087,40745,35.40334,115088
4722,dry4ng,1,0.00087,40746,35.40421,115088
4723,dsociative,1,0.00087,40747,35.40508,115088
4724,dsommerville-bbc,1,0.00087,40748,35.40595,115088
4725,dsoria,1,0.00087,40749,35.40682,115088
4726,dspruell,1,0.00087,40750,35.40769,115088
4727,dterei,1,0.00087,40751,35.40856,115088
4728,duboisph,1,0.00087,40752,35.40943,115088
4729,dunnock,1,0.00087,40753,35.41029,115088
4730,DuratarskeyK,1,0.00087,40754,35.41116,115088
4731,dvlato,1,0.00087,40755,35.41203,115088
4732,dvsekhvalnov,1,0.00087,40756,35.41290,115088
4733,dwalintukan,1,0.00087,40757,35.41377,115088
4734,dxas90,1,0.00087,40758,35.41464,115088
4735,dylan-barduzzi,1,0.00087,40759,35.41551,115088
4736,dytmh,1,0.00087,40760,35.41638,115088
4737,eagleoflqj,1,0.00087,40761,35.41725,115088
4738,eamonnmcevoy,1,0.00087,40762,35.41811,115088
4739,earthdiaosi,1,0.00087,40763,35.41898,115088
4740,eashman,1,0.00087,40764,35.41985,115088
4741,eastwook80,1,0.00087,40765,35.42072,115088
4742,ebastos,1,0.00087,40766,35.42159,115088
4743,edgeworthch,1,0.00087,40767,35.42246,115088
4744,ediphy-azorab,1,0.00087,40768,35.42333,115088
4745,eduardojmatos,1,0.00087,40769,35.42420,115088
4746,edward2a,1,0.00087,40770,35.42507,115088
4747,EdwinExtendas,1,0.00087,40771,35.42593,115088
4748,eeshaisha,1,0.00087,40772,35.42680,115088
4749,Egnaik,1,0.00087,40773,35.42767,115088
4750,egulik,1,0.00087,40774,35.42854,115088
4751,ehalpern,1,0.00087,40775,35.42941,115088
4752,Eiryyy,1,0.00087,40776,35.43028,115088
4753,ekanai,1,0.00087,40777,35.43115,115088
4754,e-koma,1,0.00087,40778,35.43202,115088
4755,elad,1,0.00087,40779,35.43289,115088
4756,eladtamary,1,0.00087,40780,35.43376,115088
4757,EldarSagirov,1,0.00087,40781,35.43462,115088
4758,elkan1788,1,0.00087,40782,35.43549,115088
4759,ellipse42,1,0.00087,40783,35.43636,115088
4760,elvarb,1,0.00087,40784,35.43723,115088
4761,elvis-cai,1,0.00087,40785,35.43810,115088
4762,emaste-r,1,0.00087,40786,35.43897,115088
4763,emayssat-ms,1,0.00087,40787,35.43984,115088
4764,ember,1,0.00087,40788,35.44071,115088
4765,EmilienM,1,0.00087,40789,35.44158,115088
4766,emmayang,1,0.00087,40790,35.44244,115088
4767,emretiryaki,1,0.00087,40791,35.44331,115088
4768,emrocha,1,0.00087,40792,35.44418,115088
4769,en-siba,1,0.00087,40793,35.44505,115088
4770,eoconnor,1,0.00087,40794,35.44592,115088
4771,eosstvw,1,0.00087,40795,35.44679,115088
4772,eregon,1,0.00087,40796,35.44766,115088
4773,ereOn,1,0.00087,40797,35.44853,115088
4774,ericlarssen-wf,1,0.00087,40798,35.44940,115088
4775,EricVS,1,0.00087,40799,35.45026,115088
4776,ernescz,1,0.00087,40800,35.45113,115088
4777,error0x1,1,0.00087,40801,35.45200,115088
4778,ervansetiawan,1,0.00087,40802,35.45287,115088
4779,ervinb,1,0.00087,40803,35.45374,115088
4780,etegan,1,0.00087,40804,35.45461,115088
4781,ethankan,1,0.00087,40805,35.45548,115088
4782,eunjae-lee,1,0.00087,40806,35.45635,115088
4783,eunsikpark,1,0.00087,40807,35.45722,115088
4784,EvertonSA,1,0.00087,40808,35.45808,115088
4785,evmin02,1,0.00087,40809,35.45895,115088
4786,Ewan-GrandSlam,1,0.00087,40810,35.45982,115088
4787,eyeezzi,1,0.00087,40811,35.46069,115088
4788,e-zhydzetski,1,0.00087,40812,35.46156,115088
4789,fabiofalci,1,0.00087,40813,35.46243,115088
4790,fabiothiroki,1,0.00087,40814,35.46330,115088
4791,fabrice-etanchaud,1,0.00087,40815,35.46417,115088
4792,facastagnini,1,0.00087,40816,35.46504,115088
4793,fadingdust,1,0.00087,40817,35.46590,115088
4794,faizal15,1,0.00087,40818,35.46677,115088
4795,FaKod,1,0.00087,40819,35.46764,115088
4796,fan-k-tamura,1,0.00087,40820,35.46851,115088
4797,fanlifei,1,0.00087,40821,35.46938,115088
4798,fantajeon,1,0.00087,40822,35.47025,115088
4799,fbe,1,0.00087,40823,35.47112,115088
4800,fearthecowboy,1,0.00087,40824,35.47199,115088
4801,federicopuntoni,1,0.00087,40825,35.47286,115088
4802,felixkrohn,1,0.00087,40826,35.47372,115088
4803,fenxiong,1,0.00087,40827,35.47459,115088
4804,Fettah,1,0.00087,40828,35.47546,115088
4805,ffcczz,1,0.00087,40829,35.47633,115088
4806,fgken,1,0.00087,40830,35.47720,115088
4807,Finges,1,0.00087,40831,35.47807,115088
4808,FlorentGuillin,1,0.00087,40832,35.47894,115088
4809,floriankammermann,1,0.00087,40833,35.47981,115088
4810,fly2tomato,1,0.00087,40834,35.48068,115088
4811,flyingKaenguru,1,0.00087,40835,35.48154,115088
4812,flynnecf2,1,0.00087,40836,35.48241,115088
4813,fog1985,1,0.00087,40837,35.48328,115088
4814,foobarnum,1,0.00087,40838,35.48415,115088
4815,fopina,1,0.00087,40839,35.48502,115088
4816,foremap,1,0.00087,40840,35.48589,115088
4817,fprg,1,0.00087,40841,35.48676,115088
4818,franck-schmidlin,1,0.00087,40842,35.48763,115088
4819,franfabrizio,1,0.00087,40843,35.48850,115088
4820,fredzqm,1,0.00087,40844,35.48936,115088
4821,freelancerlucas,1,0.00087,40845,35.49023,115088
4822,freeyoung,1,0.00087,40846,35.49110,115088
4823,fuatyosanto,1,0.00087,40847,35.49197,115088
4824,fukangwen,1,0.00087,40848,35.49284,115088
4825,fuusuke,1,0.00087,40849,35.49371,115088
4826,fuxes,1,0.00087,40850,35.49458,115088
4827,fw42,1,0.00087,40851,35.49545,115088
4828,fwhite-wsm,1,0.00087,40852,35.49632,115088
4829,fxpester,1,0.00087,40853,35.49718,115088
4830,fxposter,1,0.00087,40854,35.49805,115088
4831,g2doug,1,0.00087,40855,35.49892,115088
4832,GabrielCastro,1,0.00087,40856,35.49979,115088
4833,gabriel-vicente,1,0.00087,40857,35.50066,115088
4834,gadelkareem,1,0.00087,40858,35.50153,115088
4835,galindro,1,0.00087,40859,35.50240,115088
4836,gallardop,1,0.00087,40860,35.50327,115088
4837,Gambler13,1,0.00087,40861,35.50414,115088
4838,ganga1980,1,0.00087,40862,35.50500,115088
4839,ganting,1,0.00087,40863,35.50587,115088
4840,ganymedes01,1,0.00087,40864,35.50674,115088
4841,gaohao,1,0.00087,40865,35.50761,115088
4842,garbetjie,1,0.00087,40866,35.50848,115088
4843,garild,1,0.00087,40867,35.50935,115088
4844,gashokkumar040,1,0.00087,40868,35.51022,115088
4845,gaussye,1,0.00087,40869,35.51109,115088
4846,gavinmcnair,1,0.00087,40870,35.51196,115088
4847,gbates101,1,0.00087,40871,35.51282,115088
4848,gciotta,1,0.00087,40872,35.51369,115088
4849,gcxRun,1,0.00087,40873,35.51456,115088
4850,geeky-smurf,1,0.00087,40874,35.51543,115088
4851,genseb13011,1,0.00087,40875,35.51630,115088
4852,genya0407,1,0.00087,40876,35.51717,115088
4853,georgehdd,1,0.00087,40877,35.51804,115088
4854,gergelyzsamboki,1,0.00087,40878,35.51891,115088
4855,getSurreal,1,0.00087,40879,35.51978,115088
4856,gflarity,1,0.00087,40880,35.52065,115088
4857,ghjnut,1,0.00087,40881,35.52151,115088
4858,ghostymun,1,0.00087,40882,35.52238,115088
4859,gio00,1,0.00087,40883,35.52325,115088
4860,giovanichaves,1,0.00087,40884,35.52412,115088
4861,giraphme,1,0.00087,40885,35.52499,115088
4862,github-zhang,1,0.00087,40886,35.52586,115088
4863,gkuchta,1,0.00087,40887,35.52673,115088
4864,glaci,1,0.00087,40888,35.52760,115088
4865,Gleb-ho,1,0.00087,40889,35.52847,115088
4866,glidenote,1,0.00087,40890,35.52933,115088
4867,glitchsys,1,0.00087,40891,35.53020,115088
4868,gna582,1,0.00087,40892,35.53107,115088
4869,go2murali,1,0.00087,40893,35.53194,115088
4870,godefroi,1,0.00087,40894,35.53281,115088
4871,gogovan-vincentngai,1,0.00087,40895,35.53368,115088
4872,gokhandincer,1,0.00087,40896,35.53455,115088
4873,GolanSabo,1,0.00087,40897,35.53542,115088
4874,GoodDingo,1,0.00087,40898,35.53629,115088
4875,goodfoo,1,0.00087,40899,35.53715,115088
4876,google238,1,0.00087,40900,35.53802,115088
4877,gotttlieb,1,0.00087,40901,35.53889,115088
4878,GOUYONGCHAO,1,0.00087,40902,35.53976,115088
4879,govindcnd,1,0.00087,40903,35.54063,115088
4880,gracedo,1,0.00087,40904,35.54150,115088
4881,grantstephens,1,0.00087,40905,35.54237,115088
4882,gregswift,1,0.00087,40906,35.54324,115088
4883,Greyvend,1,0.00087,40907,35.54411,115088
4884,grimmxsleeper,1,0.00087,40908,35.54497,115088
4885,grjones,1,0.00087,40909,35.54584,115088
4886,gschaden,1,0.00087,40910,35.54671,115088
4887,gstib,1,0.00087,40911,35.54758,115088
4888,gtmtech,1,0.00087,40912,35.54845,115088
4889,GuidoHaase,1,0.00087,40913,35.54932,115088
4890,Guik,1,0.00087,40914,35.55019,115088
4891,guildencrantz,1,0.00087,40915,35.55106,115088
4892,guitcastro,1,0.00087,40916,35.55193,115088
4893,gvsrini,1,0.00087,40917,35.55279,115088
4894,gyustorm,1,0.00087,40918,35.55366,115088
4895,gzhukov,1,0.00087,40919,35.55453,115088
4896,haakoneriksen,1,0.00087,40920,35.55540,115088
4897,habibiefaried,1,0.00087,40921,35.55627,115088
4898,hahafamilia,1,0.00087,40922,35.55714,115088
4899,haije,1,0.00087,40923,35.55801,115088
4900,Hajiri-Moez,1,0.00087,40924,35.55888,115088
4901,HakanL,1,0.00087,40925,35.55975,115088
4902,hanabokuro,1,0.00087,40926,35.56061,115088
4903,hanai-tohru,1,0.00087,40927,35.56148,115088
4904,handysama,1,0.00087,40928,35.56235,115088
4905,hanoch,1,0.00087,40929,35.56322,115088
4906,haosu,1,0.00087,40930,35.56409,115088
4907,happysalada,1,0.00087,40931,35.56496,115088
4908,happyyangyuan,1,0.00087,40932,35.56583,115088
4909,hari819,1,0.00087,40933,35.56670,115088
4910,harigist,1,0.00087,40934,35.56757,115088
4911,haritw,1,0.00087,40935,35.56843,115088
4912,haroboro,1,0.00087,40936,35.56930,115088
4913,harpritc,1,0.00087,40937,35.57017,115088
4914,harry-wood,1,0.00087,40938,35.57104,115088
4915,hassanshabbirahmed,1,0.00087,40939,35.57191,115088
4916,hasseio,1,0.00087,40940,35.57278,115088
4917,Hatayaman,1,0.00087,40941,35.57365,115088
4918,hawknewton,1,0.00087,40942,35.57452,115088
4919,hayashiki,1,0.00087,40943,35.57539,115088
4920,hayesr,1,0.00087,40944,35.57625,115088
4921,HazCod,1,0.00087,40945,35.57712,115088
4922,hbceylan,1,0.00087,40946,35.57799,115088
4923,hbs,1,0.00087,40947,35.57886,115088
4924,hbyandy,1,0.00087,40948,35.57973,115088
4925,hcbraun,1,0.00087,40949,35.58060,115088
4926,hctech,1,0.00087,40950,35.58147,115088
4927,hellojukay,1,0.00087,40951,35.58234,115088
4928,hellower,1,0.00087,40952,35.58321,115088
4929,Helmut-Onna,1,0.00087,40953,35.58407,115088
4930,henb,1,0.00087,40954,35.58494,115088
4931,HenryYao369,1,0.00087,40955,35.58581,115088
4932,Heriam,1,0.00087,40956,35.58668,115088
4933,hev,1,0.00087,40957,35.58755,115088
4934,hexinatgithub,1,0.00087,40958,35.58842,115088
4935,hexwit,1,0.00087,40959,35.58929,115088
4936,hey-jude,1,0.00087,40960,35.59016,115088
4937,hhubris,1,0.00087,40961,35.59103,115088
4938,hidalgopl,1,0.00087,40962,35.59189,115088
4939,hifi,1,0.00087,40963,35.59276,115088
4940,HighWatersDev,1,0.00087,40964,35.59363,115088
4941,hillbun,1,0.00087,40965,35.59450,115088
4942,hiroru,1,0.00087,40966,35.59537,115088
4943,hiroyukim,1,0.00087,40967,35.59624,115088
4944,hithwen,1,0.00087,40968,35.59711,115088
4945,hleroy,1,0.00087,40969,35.59798,115088
4946,hmatsuoka,1,0.00087,40970,35.59885,115088
4947,hmc1986,1,0.00087,40971,35.59972,115088
4948,hmmbug,1,0.00087,40972,35.60058,115088
4949,hoanpv3993,1,0.00087,40973,35.60145,115088
4950,hoedic44,1,0.00087,40974,35.60232,115088
4951,hogmuzzle,1,0.00087,40975,35.60319,115088
4952,HolgerNeub,1,0.00087,40976,35.60406,115088
4953,holyhope,1,0.00087,40977,35.60493,115088
4954,hornetmadness,1,0.00087,40978,35.60580,115088
4955,houseofback,1,0.00087,40979,35.60667,115088
4956,howarddierking,1,0.00087,40980,35.60754,115088
4957,hpello,1,0.00087,40981,35.60840,115088
4958,hramc,1,0.00087,40982,35.60927,115088
4959,hridyeshpant,1,0.00087,40983,35.61014,115088
4960,hsachdevah,1,0.00087,40984,35.61101,115088
4961,hsiaoairplane,1,0.00087,40985,35.61188,115088
4962,hsingh6764,1,0.00087,40986,35.61275,115088
4963,hsinhoyeh,1,0.00087,40987,35.61362,115088
4964,hugeleaf,1,0.00087,40988,35.61449,115088
4965,huichen,1,0.00087,40989,35.61536,115088
4966,humpalum,1,0.00087,40990,35.61622,115088
4967,hurtauda,1,0.00087,40991,35.61709,115088
4968,husseinraoouf,1,0.00087,40992,35.61796,115088
4969,hwasp,1,0.00087,40993,35.61883,115088
4970,hydnwang,1,0.00087,40994,35.61970,115088
4971,hyginous29,1,0.00087,40995,35.62057,115088
4972,HYmian,1,0.00087,40996,35.62144,115088
4973,hyperledger1,1,0.00087,40997,35.62231,115088
4974,i5okie,1,0.00087,40998,35.62318,115088
4975,iahmad-khan,1,0.00087,40999,35.62404,115088
4976,iammichiel,1,0.00087,41000,35.62491,115088
4977,iampiyush,1,0.00087,41001,35.62578,115088
4978,ibalashov,1,0.00087,41002,35.62665,115088
4979,ifeldshteyn,1,0.00087,41003,35.62752,115088
4980,igas,1,0.00087,41004,35.62839,115088
4981,ignusws,1,0.00087,41005,35.62926,115088
4982,igorgatis,1,0.00087,41006,35.63013,115088
4983,igorkchyts,1,0.00087,41007,35.63100,115088
4984,igorrudyk,1,0.00087,41008,35.63186,115088
4985,ikarin,1,0.00087,41009,35.63273,115088
4986,ilikedata,1,0.00087,41010,35.63360,115088
4987,illegalnumbers,1,0.00087,41011,35.63447,115088
4988,ilyaskorik,1,0.00087,41012,35.63534,115088
4989,imhongw,1,0.00087,41013,35.63621,115088
4990,imperio-wxm,1,0.00087,41014,35.63708,115088
4991,impicklejon,1,0.00087,41015,35.63795,115088
4992,indigoid,1,0.00087,41016,35.63882,115088
4993,infertux,1,0.00087,41017,35.63968,115088
4994,infoMatt,1,0.00087,41018,35.64055,115088
4995,info-samir,1,0.00087,41019,35.64142,115088
4996,initcron-abhijit,1,0.00087,41020,35.64229,115088
4997,InspurKelly,1,0.00087,41021,35.64316,115088
4998,intenseFrog,1,0.00087,41022,35.64403,115088
4999,invin12,1,0.00087,41023,35.64490,115088
5000,irizzant,1,0.00087,41024,35.64577,115088
5001,irom77,1,0.00087,41025,35.64664,115088
5002,irregulator,1,0.00087,41026,35.64750,115088
5003,isaacegglestone,1,0.00087,41027,35.64837,115088
5004,ishantanu,1,0.00087,41028,35.64924,115088
5005,isukapalli,1,0.00087,41029,35.65011,115088
5006,isurusiri,1,0.00087,41030,35.65098,115088
5007,Itfly,1,0.00087,41031,35.65185,115088
5008,itmecho,1,0.00087,41032,35.65272,115088
5009,itorres,1,0.00087,41033,35.65359,115088
5010,iusergii,1,0.00087,41034,35.65446,115088
5011,iuyiuy,1,0.00087,41035,35.65532,115088
5012,ivanfoo,1,0.00087,41036,35.65619,115088
5013,iwat,1,0.00087,41037,35.65706,115088
5014,j1681358,1,0.00087,41038,35.65793,115088
5015,jackpimbert,1,0.00087,41039,35.65880,115088
5016,jacobuk,1,0.00087,41040,35.65967,115088
5017,jadencodes,1,0.00087,41041,35.66054,115088
5018,jaffrey007,1,0.00087,41042,35.66141,115088
5019,JAGAxIMO,1,0.00087,41043,35.66228,115088
5020,jahmad-fareportal,1,0.00087,41044,35.66314,115088
5021,jaingaurav,1,0.00087,41045,35.66401,115088
5022,JaisalSingh,1,0.00087,41046,35.66488,115088
5023,jakeyr,1,0.00087,41047,35.66575,115088
5024,JakubCoufal,1,0.00087,41048,35.66662,115088
5025,jaliase,1,0.00087,41049,35.66749,115088
5026,jamesbursa,1,0.00087,41050,35.66836,115088
5027,jamesone,1,0.00087,41051,35.66923,115088
5028,JamieCressey,1,0.00087,41052,35.67010,115088
5029,Jane0108,1,0.00087,41053,35.67096,115088
5030,januszry,1,0.00087,41054,35.67183,115088
5031,jaredready,1,0.00087,41055,35.67270,115088
5032,jarmaker,1,0.00087,41056,35.67357,115088
5033,jasonhr13,1,0.00087,41057,35.67444,115088
5034,JAtula,1,0.00087,41058,35.67531,115088
5035,javapapo,1,0.00087,41059,35.67618,115088
5036,javrllerenas,1,0.00087,41060,35.67705,115088
5037,jaxonpickett,1,0.00087,41061,35.67792,115088
5038,jaygriffin1024,1,0.00087,41062,35.67878,115088
5039,Jaykah,1,0.00087,41063,35.67965,115088
5040,jaysonwor,1,0.00087,41064,35.68052,115088
5041,jbuck,1,0.00087,41065,35.68139,115088
5042,jburgess777,1,0.00087,41066,35.68226,115088
5043,jbye,1,0.00087,41067,35.68313,115088
5044,jbyers,1,0.00087,41068,35.68400,115088
5045,jcassee,1,0.00087,41069,35.68487,115088
5046,jcdauchy,1,0.00087,41070,35.68574,115088
5047,jcdauchy-moodys,1,0.00087,41071,35.68661,115088
5048,jchan-scc,1,0.00087,41072,35.68747,115088
5049,jclosure,1,0.00087,41073,35.68834,115088
5050,jdambly-ns,1,0.00087,41074,35.68921,115088
5051,j-davies,1,0.00087,41075,35.69008,115088
5052,jd-carroll,1,0.00087,41076,35.69095,115088
5053,jd-daniels,1,0.00087,41077,35.69182,115088
5054,jdeprin,1,0.00087,41078,35.69269,115088
5055,jdhibberd,1,0.00087,41079,35.69356,115088
5056,JDKardia,1,0.00087,41080,35.69443,115088
5057,jdrueckert,1,0.00087,41081,35.69529,115088
5058,jeanlouisferey,1,0.00087,41082,35.69616,115088
5059,jebl01,1,0.00087,41083,35.69703,115088
5060,jedisct1,1,0.00087,41084,35.69790,115088
5061,jeffaco,1,0.00087,41085,35.69877,115088
5062,jeffersfp,1,0.00087,41086,35.69964,115088
5063,jeffi7,1,0.00087,41087,35.70051,115088
5064,jeffutter,1,0.00087,41088,35.70138,115088
5065,jeffwroblewski,1,0.00087,41089,35.70225,115088
5066,jelmokri,1,0.00087,41090,35.70311,115088
5067,jenishshah671993,1,0.00087,41091,35.70398,115088
5068,jenseeberg,1,0.00087,41092,35.70485,115088
5069,jeremylongo,1,0.00087,41093,35.70572,115088
5070,JerkyTreats,1,0.00087,41094,35.70659,115088
5071,jerrymeng,1,0.00087,41095,35.70746,115088
5072,jesper,1,0.00087,41096,35.70833,115088
5073,jessemcallister,1,0.00087,41097,35.70920,115088
5074,jesusch,1,0.00087,41098,35.71007,115088
5075,jet9,1,0.00087,41099,35.71093,115088
5076,Jeyanthinath,1,0.00087,41100,35.71180,115088
5077,jfgreen,1,0.00087,41101,35.71267,115088
5078,jfillman,1,0.00087,41102,35.71354,115088
5079,jgiangrande-applause,1,0.00087,41103,35.71441,115088
5080,jgoodall,1,0.00087,41104,35.71528,115088
5081,jhonatanmorais,1,0.00087,41105,35.71615,115088
5082,Ji0ngHan,1,0.00087,41106,35.71702,115088
5083,jiamo,1,0.00087,41107,35.71789,115088
5084,JihyeBaek,1,0.00087,41108,35.71875,115088
5085,jijikarikkad,1,0.00087,41109,35.71962,115088
5086,jimwal,1,0.00087,41110,35.72049,115088
5087,JingqiaoFu,1,0.00087,41111,35.72136,115088
5088,jingsm,1,0.00087,41112,35.72223,115088
5089,jinhyukchang,1,0.00087,41113,35.72310,115088
5090,jinja2,1,0.00087,41114,35.72397,115088
5091,jitendra9873,1,0.00087,41115,35.72484,115088
5092,jlacoline,1,0.00087,41116,35.72571,115088
5093,jlloh,1,0.00087,41117,35.72657,115088
5094,jlorich,1,0.00087,41118,35.72744,115088
5095,jmalouf69,1,0.00087,41119,35.72831,115088
5096,jmarijan,1,0.00087,41120,35.72918,115088
5097,jmcle,1,0.00087,41121,35.73005,115088
5098,jmickey,1,0.00087,41122,35.73092,115088
5099,jmorascalyr,1,0.00087,41123,35.73179,115088
5100,jnathanh,1,0.00087,41124,35.73266,115088
5101,jnicholls,1,0.00087,41125,35.73353,115088
5102,JnMik,1,0.00087,41126,35.73439,115088
5103,joaquin386,1,0.00087,41127,35.73526,115088
5104,jo-bi,1,0.00087,41128,35.73613,115088
5105,joby-thomas,1,0.00087,41129,35.73700,115088
5106,joeandaverde,1,0.00087,41130,35.73787,115088
5107,joerghall,1,0.00087,41131,35.73874,115088
5108,johannesfritsch,1,0.00087,41132,35.73961,115088
5109,johlo,1,0.00087,41133,35.74048,115088
5110,john-delivuk,1,0.00087,41134,35.74135,115088
5111,johnpaulett,1,0.00087,41135,35.74221,115088
5112,johnrazeur,1,0.00087,41136,35.74308,115088
5113,johnseekins,1,0.00087,41137,35.74395,115088
5114,jolly7481,1,0.00087,41138,35.74482,115088
5115,Jonathan-mura,1,0.00087,41139,35.74569,115088
5116,jonhandlermac,1,0.00087,41140,35.74656,115088
5117,jonnyyu,1,0.00087,41141,35.74743,115088
5118,joriws,1,0.00087,41142,35.74830,115088
5119,jorrizza,1,0.00087,41143,35.74917,115088
5120,joseliber,1,0.00087,41144,35.75003,115088
5121,joshcwa,1,0.00087,41145,35.75090,115088
5122,JoshDaone,1,0.00087,41146,35.75177,115088
5123,joshgarnett,1,0.00087,41147,35.75264,115088
5124,JoshuaOliphant,1,0.00087,41148,35.75351,115088
5125,josqu4red,1,0.00087,41149,35.75438,115088
5126,jpaskhay,1,0.00087,41150,35.75525,115088
5127,jpatokal,1,0.00087,41151,35.75612,115088
5128,jpbelanger-mtl,1,0.00087,41152,35.75699,115088
5129,JPM84,1,0.00087,41153,35.75785,115088
5130,jpugliesi,1,0.00087,41154,35.75872,115088
5131,jrlonan,1,0.00087,41155,35.75959,115088
5132,jroberts07,1,0.00087,41156,35.76046,115088
5133,jrun,1,0.00087,41157,35.76133,115088
5134,JSchwerberg,1,0.00087,41158,35.76220,115088
5135,jsedlace,1,0.00087,41159,35.76307,115088
5136,jsiegele,1,0.00087,41160,35.76394,115088
5137,jsteigel-rmn,1,0.00087,41161,35.76481,115088
5138,judika03,1,0.00087,41162,35.76567,115088
5139,juhaerk,1,0.00087,41163,35.76654,115088
5140,juho9000,1,0.00087,41164,35.76741,115088
5141,Ju-Li-An,1,0.00087,41165,35.76828,115088
5142,JungsuHan,1,0.00087,41166,35.76915,115088
5143,junho85,1,0.00087,41167,35.77002,115088
5144,juniorsysadmin,1,0.00087,41168,35.77089,115088
5145,junpei-yoshino-,1,0.00087,41169,35.77176,115088
5146,jurelou,1,0.00087,41170,35.77263,115088
5147,justanding,1,0.00087,41171,35.77350,115088
5148,justinh24,1,0.00087,41172,35.77436,115088
5149,JustinPlute,1,0.00087,41173,35.77523,115088
5150,justinpnichols,1,0.00087,41174,35.77610,115088
5151,JvalantPatel-MS,1,0.00087,41175,35.77697,115088
5152,jwillaime,1,0.00087,41176,35.77784,115088
5153,jwitrick,1,0.00087,41177,35.77871,115088
5154,jwlogemann,1,0.00087,41178,35.77958,115088
5155,jwrolson,1,0.00087,41179,35.78045,115088
5156,jyipks,1,0.00087,41180,35.78132,115088
5157,jyotiruhil,1,0.00087,41181,35.78218,115088
5158,kainage,1,0.00087,41182,35.78305,115088
5159,kajahno,1,0.00087,41183,35.78392,115088
5160,kakmt,1,0.00087,41184,35.78479,115088
5161,Kaliamos,1,0.00087,41185,35.78566,115088
5162,kamyuentse,1,0.00087,41186,35.78653,115088
5163,kanjieater,1,0.00087,41187,35.78740,115088
5164,karloluiten,1,0.00087,41188,35.78827,115088
5165,karlvlam,1,0.00087,41189,35.78914,115088
5166,KarstenSchnitter,1,0.00087,41190,35.79000,115088
5167,kartesliao,1,0.00087,41191,35.79087,115088
5168,KasparBP,1,0.00087,41192,35.79174,115088
5169,kasunt84,1,0.00087,41193,35.79261,115088
5170,kave,1,0.00087,41194,35.79348,115088
5171,kaweit,1,0.00087,41195,35.79435,115088
5172,kaz080,1,0.00087,41196,35.79522,115088
5173,kdihalas,1,0.00087,41197,35.79609,115088
5174,keepburning,1,0.00087,41198,35.79696,115088
5175,keihino,1,0.00087,41199,35.79782,115088
5176,kekoav,1,0.00087,41200,35.79869,115088
5177,kelseymok,1,0.00087,41201,35.79956,115088
5178,kelson-martins,1,0.00087,41202,35.80043,115088
5179,Ken4scholars,1,0.00087,41203,35.80130,115088
5180,kennedyalexander,1,0.00087,41204,35.80217,115088
5181,kennycyb,1,0.00087,41205,35.80304,115088
5182,Kenny-House,1,0.00087,41206,35.80391,115088
5183,kentokento,1,0.00087,41207,35.80478,115088
5184,kentsteer,1,0.00087,41208,35.80564,115088
5185,keshavab,1,0.00087,41209,35.80651,115088
5186,kevcodez,1,0.00087,41210,35.80738,115088
5187,kevdowney,1,0.00087,41211,35.80825,115088
5188,kevinjom,1,0.00087,41212,35.80912,115088
5189,Kgirthofer,1,0.00087,41213,35.80999,115088
5190,khalilamdouni,1,0.00087,41214,35.81086,115088
5191,khotkevych,1,0.00087,41215,35.81173,115088
5192,kid101,1,0.00087,41216,35.81260,115088
5193,kiran251,1,0.00087,41217,35.81346,115088
5194,kitsushadow,1,0.00087,41218,35.81433,115088
5195,kiwiz,1,0.00087,41219,35.81520,115088
5196,kkc,1,0.00087,41220,35.81607,115088
5197,kkujawinski,1,0.00087,41221,35.81694,115088
5198,kkwoker,1,0.00087,41222,35.81781,115088
5199,km3945,1,0.00087,41223,35.81868,115088
5200,k-masa2501,1,0.00087,41224,35.81955,115088
5201,knasim,1,0.00087,41225,35.82042,115088
5202,knopka,1,0.00087,41226,35.82128,115088
5203,know-no,1,0.00087,41227,35.82215,115088
5204,koalalorenzo,1,0.00087,41228,35.82302,115088
5205,kohki1234,1,0.00087,41229,35.82389,115088
5206,kokosabu,1,0.00087,41230,35.82476,115088
5207,koksan83,1,0.00087,41231,35.82563,115088
5208,kompiuter,1,0.00087,41232,35.82650,115088
5209,konradmichael,1,0.00087,41233,35.82737,115088
5210,kooboo-binbin,1,0.00087,41234,35.82824,115088
5211,koolhead17,1,0.00087,41235,35.82910,115088
5212,KoopaKing,1,0.00087,41236,35.82997,115088
5213,koozdra,1,0.00087,41237,35.83084,115088
5214,koreantramp,1,0.00087,41238,35.83171,115088
5215,kota718,1,0.00087,41239,35.83258,115088
5216,kousik93,1,0.00087,41240,35.83345,115088
5217,kpbll,1,0.00087,41241,35.83432,115088
5218,kraag22,1,0.00087,41242,35.83519,115088
5219,krafts,1,0.00087,41243,35.83606,115088
5220,krdlab,1,0.00087,41244,35.83692,115088
5221,Krishna1408,1,0.00087,41245,35.83779,115088
5222,KristianLyng,1,0.00087,41246,35.83866,115088
5223,kristofferahl,1,0.00087,41247,35.83953,115088
5224,kriston13,1,0.00087,41248,35.84040,115088
5225,krlng,1,0.00087,41249,35.84127,115088
5226,krudskoy,1,0.00087,41250,35.84214,115088
5227,KrysKruk,1,0.00087,41251,35.84301,115088
5228,k-s-dean,1,0.00087,41252,35.84388,115088
5229,ktugan,1,0.00087,41253,35.84474,115088
5230,kumagi,1,0.00087,41254,35.84561,115088
5231,kumarganesh2814,1,0.00087,41255,35.84648,115088
5232,kuniiskywalker,1,0.00087,41256,35.84735,115088
5233,kuroei,1,0.00087,41257,35.84822,115088
5234,kurosakisora,1,0.00087,41258,35.84909,115088
5235,kushagra391,1,0.00087,41259,35.84996,115088
5236,kvolkovich-sc,1,0.00087,41260,35.85083,115088
5237,kvr12294,1,0.00087,41261,35.85170,115088
5238,kvranjith,1,0.00087,41262,35.85256,115088
5239,kyagi,1,0.00087,41263,35.85343,115088
5240,kycfeel,1,0.00087,41264,35.85430,115088
5241,kylebevans,1,0.00087,41265,35.85517,115088
5242,lachlanmunro,1,0.00087,41266,35.85604,115088
5243,landryb,1,0.00087,41267,35.85691,115088
5244,later123,1,0.00087,41268,35.85778,115088
5245,laurentl92,1,0.00087,41269,35.85865,115088
5246,lavoiedn,1,0.00087,41270,35.85952,115088
5247,laysakura,1,0.00087,41271,35.86039,115088
5248,lberruti,1,0.00087,41272,35.86125,115088
5249,leamarty,1,0.00087,41273,35.86212,115088
5250,learn0208,1,0.00087,41274,35.86299,115088
5251,ledbettj,1,0.00087,41275,35.86386,115088
5252,leehambley,1,0.00087,41276,35.86473,115088
5253,leelynne,1,0.00087,41277,35.86560,115088
5254,leoau123,1,0.00087,41278,35.86647,115088
5255,leobudima,1,0.00087,41279,35.86734,115088
5256,letmepew,1,0.00087,41280,35.86821,115088
5257,letsgolesco,1,0.00087,41281,35.86907,115088
5258,letusfly85,1,0.00087,41282,35.86994,115088
5259,levidehaan,1,0.00087,41283,35.87081,115088
5260,levlas,1,0.00087,41284,35.87168,115088
5261,lexa500,1,0.00087,41285,35.87255,115088
5262,lhoss,1,0.00087,41286,35.87342,115088
5263,lhtan200,1,0.00087,41287,35.87429,115088
5264,liche60,1,0.00087,41288,35.87516,115088
5265,lifekiller,1,0.00087,41289,35.87603,115088
5266,lifeofguenter,1,0.00087,41290,35.87689,115088
5267,likunbyl,1,0.00087,41291,35.87776,115088
5268,Lin1303,1,0.00087,41292,35.87863,115088
5269,lindsjan,1,0.00087,41293,35.87950,115088
5270,Linuus,1,0.00087,41294,35.88037,115088
5271,linuxandunix,1,0.00087,41295,35.88124,115088
5272,liorco3000,1,0.00087,41296,35.88211,115088
5273,littlesandra88,1,0.00087,41297,35.88298,115088
5274,liubin-cm,1,0.00087,41298,35.88385,115088
5275,liuming,1,0.00087,41299,35.88471,115088
5276,liuyong2000,1,0.00087,41300,35.88558,115088
5277,living42,1,0.00087,41301,35.88645,115088
5278,liyuankui,1,0.00087,41302,35.88732,115088
5279,ljfuyuan,1,0.00087,41303,35.88819,115088
5280,ljonsson,1,0.00087,41304,35.88906,115088
5281,lk432,1,0.00087,41305,35.88993,115088
5282,lkjangir,1,0.00087,41306,35.89080,115088
5283,llibra,1,0.00087,41307,35.89167,115088
5284,llimon,1,0.00087,41308,35.89253,115088
5285,l-lotz,1,0.00087,41309,35.89340,115088
5286,llrrbaba,1,0.00087,41310,35.89427,115088
5287,lmorais,1,0.00087,41311,35.89514,115088
5288,LmYjQ,1,0.00087,41312,35.89601,115088
5289,lneves75,1,0.00087,41313,35.89688,115088
5290,lnregalias,1,0.00087,41314,35.89775,115088
5291,loganbfisher,1,0.00087,41315,35.89862,115088
5292,logicfox,1,0.00087,41316,35.89949,115088
5293,loic35,1,0.00087,41317,35.90035,115088
5294,lokiwins,1,0.00087,41318,35.90122,115088
5295,longrenren,1,0.00087,41319,35.90209,115088
5296,lostz,1,0.00087,41320,35.90296,115088
5297,Lowess,1,0.00087,41321,35.90383,115088
5298,lowstz,1,0.00087,41322,35.90470,115088
5299,lpetre,1,0.00087,41323,35.90557,115088
5300,lpic10,1,0.00087,41324,35.90644,115088
5301,lpugoy,1,0.00087,41325,35.90731,115088
5302,lrg-ev0,1,0.00087,41326,35.90817,115088
5303,luannguyen49,1,0.00087,41327,35.90904,115088
5304,lubing1101,1,0.00087,41328,35.90991,115088
5305,lucabotti,1,0.00087,41329,35.91078,115088
5306,lucas1993ch,1,0.00087,41330,35.91165,115088
5307,lucasceballos,1,0.00087,41331,35.91252,115088
5308,lucasmpb,1,0.00087,41332,35.91339,115088
5309,luciflus,1,0.00087,41333,35.91426,115088
5310,luckoseabraham,1,0.00087,41334,35.91513,115088
5311,ludwick,1,0.00087,41335,35.91599,115088
5312,luisbrandao,1,0.00087,41336,35.91686,115088
5313,luisnrkl,1,0.00087,41337,35.91773,115088
5314,LukeHong,1,0.00087,41338,35.91860,115088
5315,lukmanulhakimd,1,0.00087,41339,35.91947,115088
5316,lutanist,1,0.00087,41340,35.92034,115088
5317,luthienberen,1,0.00087,41341,35.92121,115088
5318,luukd,1,0.00087,41342,35.92208,115088
5319,LuukSt,1,0.00087,41343,35.92295,115088
5320,luv2code,1,0.00087,41344,35.92381,115088
5321,lvc,1,0.00087,41345,35.92468,115088
5322,lwh,1,0.00087,41346,35.92555,115088
5323,lxhunter,1,0.00087,41347,35.92642,115088
5324,LYHuang,1,0.00087,41348,35.92729,115088
5325,lynxaegon,1,0.00087,41349,35.92816,115088
5326,LyuGGang,1,0.00087,41350,35.92903,115088
5327,m1h43l,1,0.00087,41351,35.92990,115088
5328,m1keil,1,0.00087,41352,35.93077,115088
5329,m22r,1,0.00087,41353,35.93163,115088
5330,maadtechie,1,0.00087,41354,35.93250,115088
5331,maazghani,1,0.00087,41355,35.93337,115088
5332,macropin,1,0.00087,41356,35.93424,115088
5333,mactr0n,1,0.00087,41357,35.93511,115088
5334,madiedinro,1,0.00087,41358,35.93598,115088
5335,Maellooou,1,0.00087,41359,35.93685,115088
5336,maheshb415,1,0.00087,41360,35.93772,115088
5337,mahmoudawadeen,1,0.00087,41361,35.93859,115088
5338,majian159,1,0.00087,41362,35.93946,115088
5339,majormoses,1,0.00087,41363,35.94032,115088
5340,makccr,1,0.00087,41364,35.94119,115088
5341,makeloffve,1,0.00087,41365,35.94206,115088
5342,MakeshKathirvel,1,0.00087,41366,35.94293,115088
5343,makzdot,1,0.00087,41367,35.94380,115088
5344,malavikad072,1,0.00087,41368,35.94467,115088
5345,malford,1,0.00087,41369,35.94554,115088
5346,malikid,1,0.00087,41370,35.94641,115088
5347,mamoroom,1,0.00087,41371,35.94728,115088
5348,manasagn,1,0.00087,41372,35.94814,115088
5349,manhg,1,0.00087,41373,35.94901,115088
5350,manojpardeshi,1,0.00087,41374,35.94988,115088
5351,manojshetty28,1,0.00087,41375,35.95075,115088
5352,manuelfelipe,1,0.00087,41376,35.95162,115088
5353,manvinderr21,1,0.00087,41377,35.95249,115088
5354,mapk0y,1,0.00087,41378,35.95336,115088
5355,Maplejw,1,0.00087,41379,35.95423,115088
5356,maraujop,1,0.00087,41380,35.95510,115088
5357,Marcel-Hillmann,1,0.00087,41381,35.95596,115088
5358,marcelo23,1,0.00087,41382,35.95683,115088
5359,marcin-kasinski,1,0.00087,41383,35.95770,115088
5360,marcinrosinski,1,0.00087,41384,35.95857,115088
5361,marciorf,1,0.00087,41385,35.95944,115088
5362,marcsue,1,0.00087,41386,35.96031,115088
5363,marcwickenden,1,0.00087,41387,35.96118,115088
5364,marcy,1,0.00087,41388,35.96205,115088
5365,marinnedea,1,0.00087,41389,35.96292,115088
5366,mariotee,1,0.00087,41390,35.96378,115088
5367,mariuscoto,1,0.00087,41391,35.96465,115088
5368,markdascher,1,0.00087,41392,35.96552,115088
5369,marklieberman,1,0.00087,41393,35.96639,115088
5370,markosiira-arm,1,0.00087,41394,35.96726,115088
5371,Markusaa77,1,0.00087,41395,35.96813,115088
5372,marmos91,1,0.00087,41396,35.96900,115088
5373,maromaro0013,1,0.00087,41397,35.96987,115088
5374,marrrvin,1,0.00087,41398,35.97074,115088
5375,marshally,1,0.00087,41399,35.97160,115088
5376,MartinAltmayer,1,0.00087,41400,35.97247,115088
5377,martinbaillie,1,0.00087,41401,35.97334,115088
5378,martinsula,1,0.00087,41402,35.97421,115088
5379,marulm,1,0.00087,41403,35.97508,115088
5380,MarwanBayadsi,1,0.00087,41404,35.97595,115088
5381,masayamaeda,1,0.00087,41405,35.97682,115088
5382,MasslessParticle,1,0.00087,41406,35.97769,115088
5383,mastermiaoge,1,0.00087,41407,35.97856,115088
5384,MasterSquishy,1,0.00087,41408,35.97942,115088
5385,matansh,1,0.00087,41409,35.98029,115088
5386,matayto,1,0.00087,41410,35.98116,115088
5387,mathetake,1,0.00087,41411,35.98203,115088
5388,Matiasmct,1,0.00087,41412,35.98290,115088
5389,matikij,1,0.00087,41413,35.98377,115088
5390,mattb18,1,0.00087,41414,35.98464,115088
5391,mattcui,1,0.00087,41415,35.98551,115088
5392,Matt-Dee,1,0.00087,41416,35.98638,115088
5393,matteogaito,1,0.00087,41417,35.98724,115088
5394,Mattes83,1,0.00087,41418,35.98811,115088
5395,mattgimbal,1,0.00087,41419,35.98898,115088
5396,matth0x1,1,0.00087,41420,35.98985,115088
5397,matt-simons,1,0.00087,41421,35.99072,115088
5398,mattyb,1,0.00087,41422,35.99159,115088
5399,MaxDiOrio,1,0.00087,41423,35.99246,115088
5400,maxgutman,1,0.00087,41424,35.99333,115088
5401,maximdx,1,0.00087,41425,35.99420,115088
5402,maxjacobson,1,0.00087,41426,35.99506,115088
5403,maxpowel,1,0.00087,41427,35.99593,115088
5404,maxromanovsky,1,0.00087,41428,35.99680,115088
5405,mcastilho,1,0.00087,41429,35.99767,115088
5406,mcaulifn,1,0.00087,41430,35.99854,115088
5407,mcmar,1,0.00087,41431,35.99941,115088
5408,mcortinas,1,0.00087,41432,36.00028,115088
5409,McPetersonGH,1,0.00087,41433,36.00115,115088
5410,mcrapet,1,0.00087,41434,36.00202,115088
5411,MCRayRay,1,0.00087,41435,36.00288,115088
5412,mculmone,1,0.00087,41436,36.00375,115088
5413,mdazam1942,1,0.00087,41437,36.00462,115088
5414,mdost,1,0.00087,41438,36.00549,115088
5415,mechamogera,1,0.00087,41439,36.00636,115088
5416,medalliaerlich,1,0.00087,41440,36.00723,115088
5417,medanasslim,1,0.00087,41441,36.00810,115088
5418,medb,1,0.00087,41442,36.00897,115088
5419,meduri99,1,0.00087,41443,36.00984,115088
5420,medzin,1,0.00087,41444,36.01070,115088
5421,meirwah,1,0.00087,41445,36.01157,115088
5422,meishao,1,0.00087,41446,36.01244,115088
5423,melghors,1,0.00087,41447,36.01331,115088
5424,melnik13,1,0.00087,41448,36.01418,115088
5425,memory,1,0.00087,41449,36.01505,115088
5426,menghuanwd,1,0.00087,41450,36.01592,115088
5427,messiahUA,1,0.00087,41451,36.01679,115088
5428,meta-coder,1,0.00087,41452,36.01766,115088
5429,mhb8436,1,0.00087,41453,36.01852,115088
5430,mheppner,1,0.00087,41454,36.01939,115088
5431,mhulscher,1,0.00087,41455,36.02026,115088
5432,mi5c,1,0.00087,41456,36.02113,115088
5433,MichaelBerryman,1,0.00087,41457,36.02200,115088
5434,MichaelKunze,1,0.00087,41458,36.02287,115088
5435,MichaelMitchellM,1,0.00087,41459,36.02374,115088
5436,Michake,1,0.00087,41460,36.02461,115088
5437,michalrabinowitch,1,0.00087,41461,36.02548,115088
5438,michalriha1,1,0.00087,41462,36.02635,115088
5439,michele,1,0.00087,41463,36.02721,115088
5440,michi-nakaya,1,0.00087,41464,36.02808,115088
5441,michtek,1,0.00087,41465,36.02895,115088
5442,MickaelBZH,1,0.00087,41466,36.02982,115088
5443,micw,1,0.00087,41467,36.03069,115088
5444,midihenry,1,0.00087,41468,36.03156,115088
5445,mihailgmihaylov,1,0.00087,41469,36.03243,115088
5446,mihirpatel,1,0.00087,41470,36.03330,115088
5447,mihir-shutterfly,1,0.00087,41471,36.03417,115088
5448,MikeChou,1,0.00087,41472,36.03503,115088
5449,MikeEdgar,1,0.00087,41473,36.03590,115088
5450,mikejuliettetango,1,0.00087,41474,36.03677,115088
5451,mikelaws,1,0.00087,41475,36.03764,115088
5452,mikemar10,1,0.00087,41476,36.03851,115088
5453,MikePlayle,1,0.00087,41477,36.03938,115088
5454,miketheman,1,0.00087,41478,36.04025,115088
5455,mikisseth,1,0.00087,41479,36.04112,115088
5456,mikowitz,1,0.00087,41480,36.04199,115088
5457,MilesDickChen,1,0.00087,41481,36.04285,115088
5458,milesich,1,0.00087,41482,36.04372,115088
5459,milunko,1,0.00087,41483,36.04459,115088
5460,mimachniak,1,0.00087,41484,36.04546,115088
5461,mindfulmonk,1,0.00087,41485,36.04633,115088
5462,Mindtoeye,1,0.00087,41486,36.04720,115088
5463,MinghuiChen,1,0.00087,41487,36.04807,115088
5464,mirantisjp,1,0.00087,41488,36.04894,115088
5465,MiroslavCsonka,1,0.00087,41489,36.04981,115088
5466,misoobu,1,0.00087,41490,36.05067,115088
5467,Mist3ry,1,0.00087,41491,36.05154,115088
5468,mitrilmad,1,0.00087,41492,36.05241,115088
5469,miverson,1,0.00087,41493,36.05328,115088
5470,mixazya,1,0.00087,41494,36.05415,115088
5471,mjallday,1,0.00087,41495,36.05502,115088
5472,mjkelly,1,0.00087,41496,36.05589,115088
5473,mk811,1,0.00087,41497,36.05676,115088
5474,mkishi,1,0.00087,41498,36.05763,115088
5475,mkoerperriag,1,0.00087,41499,36.05849,115088
5476,MKo-xx,1,0.00087,41500,36.05936,115088
5477,mmacfadden,1,0.00087,41501,36.06023,115088
5478,mmadsen,1,0.00087,41502,36.06110,115088
5479,mma-pivotal,1,0.00087,41503,36.06197,115088
5480,mmaslowskicc,1,0.00087,41504,36.06284,115088
5481,mmsits-kaefferlein,1,0.00087,41505,36.06371,115088
5482,Mnakagawa,1,0.00087,41506,36.06458,115088
5483,mnanduri,1,0.00087,41507,36.06545,115088
5484,mnibecker,1,0.00087,41508,36.06631,115088
5485,mnivedithaa,1,0.00087,41509,36.06718,115088
5486,Mobiledeveloper0728,1,0.00087,41510,36.06805,115088
5487,mochizukikotaro,1,0.00087,41511,36.06892,115088
5488,mochizuki-masao,1,0.00087,41512,36.06979,115088
5489,moeterich,1,0.00087,41513,36.07066,115088
5490,mokemokechicken,1,0.00087,41514,36.07153,115088
5491,molinto,1,0.00087,41515,36.07240,115088
5492,moliqingwa,1,0.00087,41516,36.07327,115088
5493,moloch90,1,0.00087,41517,36.07413,115088
5494,monkeypiggy,1,0.00087,41518,36.07500,115088
5495,monotone,1,0.00087,41519,36.07587,115088
5496,moon0326,1,0.00087,41520,36.07674,115088
5497,moos3,1,0.00087,41521,36.07761,115088
5498,mordaha,1,0.00087,41522,36.07848,115088
5499,morero,1,0.00087,41523,36.07935,115088
5500,morganwu277,1,0.00087,41524,36.08022,115088
5501,MorleyDev,1,0.00087,41525,36.08109,115088
5502,Mortega5,1,0.00087,41526,36.08195,115088
5503,mosfet1kg,1,0.00087,41527,36.08282,115088
5504,mostfunkyduck,1,0.00087,41528,36.08369,115088
5505,movekj,1,0.00087,41529,36.08456,115088
5506,moyiz,1,0.00087,41530,36.08543,115088
5507,mpluhar,1,0.00087,41531,36.08630,115088
5508,mpohl56,1,0.00087,41532,36.08717,115088
5509,mpricope,1,0.00087,41533,36.08804,115088
5510,mprzygrodzki,1,0.00087,41534,36.08891,115088
5511,Mr0x58,1,0.00087,41535,36.08977,115088
5512,Mr5hanMan,1,0.00087,41536,36.09064,115088
5513,mrazvan92,1,0.00087,41537,36.09151,115088
5514,m-revetria,1,0.00087,41538,36.09238,115088
5515,mrg2k8,1,0.00087,41539,36.09325,115088
5516,MridulaSivanandan,1,0.00087,41540,36.09412,115088
5517,mritunjaykumar,1,0.00087,41541,36.09499,115088
5518,mr-karan,1,0.00087,41542,36.09586,115088
5519,msacchiPPRO,1,0.00087,41543,36.09673,115088
5520,mshytikov,1,0.00087,41544,36.09759,115088
5521,msims-okta,1,0.00087,41545,36.09846,115088
5522,msinantoktay,1,0.00087,41546,36.09933,115088
5523,msonnabaum,1,0.00087,41547,36.10020,115088
5524,mspangdal,1,0.00087,41548,36.10107,115088
5525,mthebridge,1,0.00087,41549,36.10194,115088
5526,mthird,1,0.00087,41550,36.10281,115088
5527,mtovino-nefeli,1,0.00087,41551,36.10368,115088
5528,mtpereira,1,0.00087,41552,36.10455,115088
5529,mudrii,1,0.00087,41553,36.10541,115088
5530,muffins,1,0.00087,41554,36.10628,115088
5531,mugenen,1,0.00087,41555,36.10715,115088
5532,mukgupta,1,0.00087,41556,36.10802,115088
5533,mukteshkrmishra,1,0.00087,41557,36.10889,115088
5534,munishpalmakhija,1,0.00087,41558,36.10976,115088
5535,muramasa64,1,0.00087,41559,36.11063,115088
5536,muramoto-keisuke,1,0.00087,41560,36.11150,115088
5537,mvlbarcelos,1,0.00087,41561,36.11237,115088
5538,mwasserschaff,1,0.00087,41562,36.11324,115088
5539,mwaylonis,1,0.00087,41563,36.11410,115088
5540,myfreeweb,1,0.00087,41564,36.11497,115088
5541,mysticmcj,1,0.00087,41565,36.11584,115088
5542,n0m4d50u1,1,0.00087,41566,36.11671,115088
5543,nabe,1,0.00087,41567,36.11758,115088
5544,Nabouk,1,0.00087,41568,36.11845,115088
5545,naegelin,1,0.00087,41569,36.11932,115088
5546,nainanurag,1,0.00087,41570,36.12019,115088
5547,najamsk,1,0.00087,41571,36.12106,115088
5548,nakamegu,1,0.00087,41572,36.12192,115088
5549,namgunghyeon,1,0.00087,41573,36.12279,115088
5550,nanaones,1,0.00087,41574,36.12366,115088
5551,nancykyo,1,0.00087,41575,36.12453,115088
5552,nanmu42,1,0.00087,41576,36.12540,115088
5553,naphta,1,0.00087,41577,36.12627,115088
5554,narutaro,1,0.00087,41578,36.12714,115088
5555,nathwill,1,0.00087,41579,36.12801,115088
5556,natlibfi-arlehiko,1,0.00087,41580,36.12888,115088
5557,nauckunas,1,0.00087,41581,36.12974,115088
5558,ndenkowycz,1,0.00087,41582,36.13061,115088
5559,neeraj9194,1,0.00087,41583,36.13148,115088
5560,neerajap3,1,0.00087,41584,36.13235,115088
5561,NehaSe,1,0.00087,41585,36.13322,115088
5562,nehayward,1,0.00087,41586,36.13409,115088
5563,nehiljain,1,0.00087,41587,36.13496,115088
5564,neilsrg,1,0.00087,41588,36.13583,115088
5565,nekenk1,1,0.00087,41589,36.13670,115088
5566,nelsonenzo,1,0.00087,41590,36.13756,115088
5567,neofreko,1,0.00087,41591,36.13843,115088
5568,newallone,1,0.00087,41592,36.13930,115088
5569,newbie78,1,0.00087,41593,36.14017,115088
5570,newrushbolt,1,0.00087,41594,36.14104,115088
5571,nfo,1,0.00087,41595,36.14191,115088
5572,ngunukula,1,0.00087,41596,36.14278,115088
5573,niallbrown,1,0.00087,41597,36.14365,115088
5574,NicholasKurian,1,0.00087,41598,36.14452,115088
5575,nickmcdowall,1,0.00087,41599,36.14538,115088
5576,nick-peskett-bbc,1,0.00087,41600,36.14625,115088
5577,nicolas-mosch,1,0.00087,41601,36.14712,115088
5578,nikoladj13,1,0.00087,41602,36.14799,115088
5579,nilsonpontello,1,0.00087,41603,36.14886,115088
5580,nipe0324,1,0.00087,41604,36.14973,115088
5581,NiranjjanHari,1,0.00087,41605,36.15060,115088
5582,nisaacson,1,0.00087,41606,36.15147,115088
5583,nish5uec,1,0.00087,41607,36.15234,115088
5584,nitin302,1,0.00087,41608,36.15320,115088
5585,nitish661401869,1,0.00087,41609,36.15407,115088
5586,njnuwjq,1,0.00087,41610,36.15494,115088
5587,njordr,1,0.00087,41611,36.15581,115088
5588,nkravi,1,0.00087,41612,36.15668,115088
5589,nmits,1,0.00087,41613,36.15755,115088
5590,nnoto,1,0.00087,41614,36.15842,115088
5591,nobutus,1,0.00087,41615,36.15929,115088
5592,nolith,1,0.00087,41616,36.16016,115088
5593,Nossnevs,1,0.00087,41617,36.16102,115088
5594,notonlyfoweb,1,0.00087,41618,36.16189,115088
5595,npockrus-bnet,1,0.00087,41619,36.16276,115088
5596,nroypf,1,0.00087,41620,36.16363,115088
5597,ntrp,1,0.00087,41621,36.16450,115088
5598,NTTAKR,1,0.00087,41622,36.16537,115088
5599,numidiasoft,1,0.00087,41623,36.16624,115088
5600,nuno-andre,1,0.00087,41624,36.16711,115088
5601,nupurbansal8,1,0.00087,41625,36.16798,115088
5602,nupur-neogy,1,0.00087,41626,36.16884,115088
5603,nurxbot,1,0.00087,41627,36.16971,115088
5604,nvenky,1,0.00087,41628,36.17058,115088
5605,nvoskuilen,1,0.00087,41629,36.17145,115088
5606,nvrmnd,1,0.00087,41630,36.17232,115088
5607,nwehr,1,0.00087,41631,36.17319,115088
5608,nyetwurk,1,0.00087,41632,36.17406,115088
5609,nynhex,1,0.00087,41633,36.17493,115088
5610,n-yusuke,1,0.00087,41634,36.17580,115088
5611,oanogin,1,0.00087,41635,36.17666,115088
5612,obsoleter,1,0.00087,41636,36.17753,115088
5613,ocastx,1,0.00087,41637,36.17840,115088
5614,occho,1,0.00087,41638,36.17927,115088
5615,odespesse,1,0.00087,41639,36.18014,115088
5616,oeegor,1,0.00087,41640,36.18101,115088
5617,ohadlahav,1,0.00087,41641,36.18188,115088
5618,ohdearaugustin,1,0.00087,41642,36.18275,115088
5619,ohkyutaeknology,1,0.00087,41643,36.18362,115088
5620,okanotor,1,0.00087,41644,36.18448,115088
5621,okdas,1,0.00087,41645,36.18535,115088
5622,omallo,1,0.00087,41646,36.18622,115088
5623,omaransari-home24,1,0.00087,41647,36.18709,115088
5624,omerh,1,0.00087,41648,36.18796,115088
5625,omitrowski,1,0.00087,41649,36.18883,115088
5626,onetinov,1,0.00087,41650,36.18970,115088
5627,onjectiondevops,1,0.00087,41651,36.19057,115088
5628,onlinebizsoft,1,0.00087,41652,36.19144,115088
5629,onyxet,1,0.00087,41653,36.19231,115088
5630,onzaro,1,0.00087,41654,36.19317,115088
5631,openfirmware,1,0.00087,41655,36.19404,115088
5632,openshift-poc,1,0.00087,41656,36.19491,115088
5633,ops-dev-sh,1,0.00087,41657,36.19578,115088
5634,orgads,1,0.00087,41658,36.19665,115088
5635,orion0616,1,0.00087,41659,36.19752,115088
5636,Oscar3170,1,0.00087,41660,36.19839,115088
5637,Os-carsun,1,0.00087,41661,36.19926,115088
5638,oshamin,1,0.00087,41662,36.20013,115088
5639,ostampflee,1,0.00087,41663,36.20099,115088
5640,oswcab,1,0.00087,41664,36.20186,115088
5641,oteku,1,0.00087,41665,36.20273,115088
5642,oudemen,1,0.00087,41666,36.20360,115088
5643,owaranaidobby,1,0.00087,41667,36.20447,115088
5644,Oyabi,1,0.00087,41668,36.20534,115088
5645,ozonni,1,0.00087,41669,36.20621,115088
5646,P15223971,1,0.00087,41670,36.20708,115088
5647,p53,1,0.00087,41671,36.20795,115088
5648,paassdc,1,0.00087,41672,36.20881,115088
5649,PacoDu,1,0.00087,41673,36.20968,115088
5650,pactera-cart-zhangtao,1,0.00087,41674,36.21055,115088
5651,paddycarey,1,0.00087,41675,36.21142,115088
5652,paerlundgren,1,0.00087,41676,36.21229,115088
5653,paigr,1,0.00087,41677,36.21316,115088
5654,Pakram,1,0.00087,41678,36.21403,115088
5655,paleksic,1,0.00087,41679,36.21490,115088
5656,palladius,1,0.00087,41680,36.21577,115088
5657,panatl,1,0.00087,41681,36.21663,115088
5658,panikumarm,1,0.00087,41682,36.21750,115088
5659,paoll,1,0.00087,41683,36.21837,115088
5660,PaoPao20170417,1,0.00087,41684,36.21924,115088
5661,parker20121,1,0.00087,41685,36.22011,115088
5662,parkjaeman,1,0.00087,41686,36.22098,115088
5663,parthivjoshi,1,0.00087,41687,36.22185,115088
5664,particledecay,1,0.00087,41688,36.22272,115088
5665,pasfoter,1,0.00087,41689,36.22359,115088
5666,paugay,1,0.00087,41690,36.22445,115088
5667,paulasmuth,1,0.00087,41691,36.22532,115088
5668,paulorsbrito,1,0.00087,41692,36.22619,115088
5669,paulsef,1,0.00087,41693,36.22706,115088
5670,pavel-pimenov,1,0.00087,41694,36.22793,115088
5671,pawel-lmcb,1,0.00087,41695,36.22880,115088
5672,pbhosale87,1,0.00087,41696,36.22967,115088
5673,pbialasiewicz,1,0.00087,41697,36.23054,115088
5674,peanig,1,0.00087,41698,36.23141,115088
5675,pedropovw,1,0.00087,41699,36.23227,115088
5676,peepa,1,0.00087,41700,36.23314,115088
5677,Pehesi97,1,0.00087,41701,36.23401,115088
5678,peixiaoqing,1,0.00087,41702,36.23488,115088
5679,penghuiy,1,0.00087,41703,36.23575,115088
5680,perederyaev,1,0.00087,41704,36.23662,115088
5681,permyakovsv,1,0.00087,41705,36.23749,115088
5682,peskic93,1,0.00087,41706,36.23836,115088
5683,peterbytes,1,0.00087,41707,36.23923,115088
5684,peterholak,1,0.00087,41708,36.24009,115088
5685,peterjanovsky,1,0.00087,41709,36.24096,115088
5686,peterkuiper,1,0.00087,41710,36.24183,115088
5687,peterromfeldhk,1,0.00087,41711,36.24270,115088
5688,petersu1974,1,0.00087,41712,36.24357,115088
5689,pgieniec5tar,1,0.00087,41713,36.24444,115088
5690,pgold30,1,0.00087,41714,36.24531,115088
5691,pguridi,1,0.00087,41715,36.24618,115088
5692,phhutter,1,0.00087,41716,36.24705,115088
5693,philippebn,1,0.00087,41717,36.24791,115088
5694,phillipmadlan,1,0.00087,41718,36.24878,115088
5695,philm,1,0.00087,41719,36.24965,115088
5696,philtweir,1,0.00087,41720,36.25052,115088
5697,PhML,1,0.00087,41721,36.25139,115088
5698,ph-One,1,0.00087,41722,36.25226,115088
5699,phuongnd08,1,0.00087,41723,36.25313,115088
5700,pianohacker,1,0.00087,41724,36.25400,115088
5701,piavlo,1,0.00087,41725,36.25487,115088
5702,picandocodigo,1,0.00087,41726,36.25573,115088
5703,PierrickI3,1,0.00087,41727,36.25660,115088
5704,pigri,1,0.00087,41728,36.25747,115088
5705,pik,1,0.00087,41729,36.25834,115088
5706,pinge,1,0.00087,41730,36.25921,115088
5707,pjnovas,1,0.00087,41731,36.26008,115088
5708,pjuanda,1,0.00087,41732,36.26095,115088
5709,pkillnine,1,0.00087,41733,36.26182,115088
5710,plorent,1,0.00087,41734,36.26269,115088
5711,Pluies,1,0.00087,41735,36.26355,115088
5712,pluralistix,1,0.00087,41736,36.26442,115088
5713,pmatev,1,0.00087,41737,36.26529,115088
5714,pnavkumar7,1,0.00087,41738,36.26616,115088
5715,pocket7878,1,0.00087,41739,36.26703,115088
5716,poinntt,1,0.00087,41740,36.26790,115088
5717,porc00,1,0.00087,41741,36.26877,115088
5718,PortaltechGithub,1,0.00087,41742,36.26964,115088
5719,postmastery,1,0.00087,41743,36.27051,115088
5720,potapum,1,0.00087,41744,36.27137,115088
5721,ppastuszkaocado,1,0.00087,41745,36.27224,115088
5722,ppeterson-evotek,1,0.00087,41746,36.27311,115088
5723,ppizzo,1,0.00087,41747,36.27398,115088
5724,prabhakm,1,0.00087,41748,36.27485,115088
5725,prabhu-natarajan,1,0.00087,41749,36.27572,115088
5726,prakashmishra1598,1,0.00087,41750,36.27659,115088
5727,prasadjjoshi,1,0.00087,41751,36.27746,115088
5728,prasadkhandagale,1,0.00087,41752,36.27833,115088
5729,prashant5375,1,0.00087,41753,36.27920,115088
5730,PraveenkumarDonga,1,0.00087,41754,36.28006,115088
5731,predragstosic,1,0.00087,41755,36.28093,115088
5732,Priyanrekha,1,0.00087,41756,36.28180,115088
5733,procyclinsur,1,0.00087,41757,36.28267,115088
5734,ProFfeSsoRr,1,0.00087,41758,36.28354,115088
5735,proger,1,0.00087,41759,36.28441,115088
5736,proligde,1,0.00087,41760,36.28528,115088
5737,protoss-player,1,0.00087,41761,36.28615,115088
5738,pshanoop,1,0.00087,41762,36.28702,115088
5739,psquickitjayant,1,0.00087,41763,36.28788,115088
5740,psyonix-luis,1,0.00087,41764,36.28875,115088
5741,pt300,1,0.00087,41765,36.28962,115088
5742,punneng,1,0.00087,41766,36.29049,115088
5743,puruslotion,1,0.00087,41767,36.29136,115088
5744,pvdvreede,1,0.00087,41768,36.29223,115088
5745,pydo,1,0.00087,41769,36.29310,115088
5746,q42jaap,1,0.00087,41770,36.29397,115088
5747,QiaolingTang,1,0.00087,41771,36.29484,115088
5748,qshine,1,0.00087,41772,36.29570,115088
5749,quartzmo,1,0.00087,41773,36.29657,115088
5750,qurname2,1,0.00087,41774,36.29744,115088
5751,r00t9,1,0.00087,41775,36.29831,115088
5752,r3lik,1,0.00087,41776,36.29918,115088
5753,raags,1,0.00087,41777,36.30005,115088
5754,rachirib,1,0.00087,41778,36.30092,115088
5755,radicalpi,1,0.00087,41779,36.30179,115088
5756,rafalitox2,1,0.00087,41780,36.30266,115088
5757,raftAtGit,1,0.00087,41781,36.30352,115088
5758,raghu999,1,0.00087,41782,36.30439,115088
5759,Raghu-rajanna,1,0.00087,41783,36.30526,115088
5760,Rahkeesh,1,0.00087,41784,36.30613,115088
5761,rahravee,1,0.00087,41785,36.30700,115088
5762,rahulbohra,1,0.00087,41786,36.30787,115088
5763,Rahul-Sharma-87,1,0.00087,41787,36.30874,115088
5764,rainard,1,0.00087,41788,36.30961,115088
5765,rainoko,1,0.00087,41789,36.31048,115088
5766,rajarajanpsj,1,0.00087,41790,36.31134,115088
5767,rajeshkp,1,0.00087,41791,36.31221,115088
5768,rajkumargithub,1,0.00087,41792,36.31308,115088
5769,rajpannu,1,0.00087,41793,36.31395,115088
5770,rajulm,1,0.00087,41794,36.31482,115088
5771,rakeshpatri,1,0.00087,41795,36.31569,115088
5772,rakshith-ponnappa,1,0.00087,41796,36.31656,115088
5773,ralfeus,1,0.00087,41797,36.31743,115088
5774,ram2valar,1,0.00087,41798,36.31830,115088
5775,ramachandranv,1,0.00087,41799,36.31916,115088
5776,ramamaddodi,1,0.00087,41800,36.32003,115088
5777,Ramasudhastv,1,0.00087,41801,36.32090,115088
5778,ramprasadpatnaik,1,0.00087,41802,36.32177,115088
5779,ramya397,1,0.00087,41803,36.32264,115088
5780,randomor,1,0.00087,41804,36.32351,115088
5781,randomyug,1,0.00087,41805,36.32438,115088
5782,rangedev,1,0.00087,41806,36.32525,115088
5783,raoul189,1,0.00087,41807,36.32612,115088
5784,RaphaelHerd,1,0.00087,41808,36.32698,115088
5785,raytung,1,0.00087,41809,36.32785,115088
5786,razvanphp,1,0.00087,41810,36.32872,115088
5787,rb1980,1,0.00087,41811,36.32959,115088
5788,rbkasat,1,0.00087,41812,36.33046,115088
5789,rbtr,1,0.00087,41813,36.33133,115088
5790,rda-dev,1,0.00087,41814,36.33220,115088
5791,rdpa,1,0.00087,41815,36.33307,115088
5792,rdr411,1,0.00087,41816,36.33394,115088
5793,rdxsuper,1,0.00087,41817,36.33480,115088
5794,reachgopal,1,0.00087,41818,36.33567,115088
5795,reasn,1,0.00087,41819,36.33654,115088
5796,rediculum,1,0.00087,41820,36.33741,115088
5797,reflectivedevelopment,1,0.00087,41821,36.33828,115088
5798,reidlai,1,0.00087,41822,36.33915,115088
5799,RemiSlv,1,0.00087,41823,36.34002,115088
5800,rennhak,1,0.00087,41824,36.34089,115088
5801,renzheng1987,1,0.00087,41825,36.34176,115088
5802,ReSTARTR,1,0.00087,41826,36.34262,115088
5803,revandarth,1,0.00087,41827,36.34349,115088
5804,reymont,1,0.00087,41828,36.34436,115088
5805,rfein-hearst,1,0.00087,41829,36.34523,115088
5806,rfitzhugh,1,0.00087,41830,36.34610,115088
5807,rholzhause,1,0.00087,41831,36.34697,115088
5808,rhtenhove,1,0.00087,41832,36.34784,115088
5809,rhuddleston,1,0.00087,41833,36.34871,115088
5810,rhunwicks,1,0.00087,41834,36.34958,115088
5811,rhysmccaig,1,0.00087,41835,36.35044,115088
5812,richardsondx,1,0.00087,41836,36.35131,115088
5813,richarwu,1,0.00087,41837,36.35218,115088
5814,rickw,1,0.00087,41838,36.35305,115088
5815,rifqifatih,1,0.00087,41839,36.35392,115088
5816,RIKIL,1,0.00087,41840,36.35479,115088
5817,Rikk,1,0.00087,41841,36.35566,115088
5818,rimantoro,1,0.00087,41842,36.35653,115088
5819,ringhiera,1,0.00087,41843,36.35740,115088
5820,riquito,1,0.00087,41844,36.35826,115088
5821,ritasker,1,0.00087,41845,36.35913,115088
5822,Ritwik28,1,0.00087,41846,36.36000,115088
5823,rivetmichael,1,0.00087,41847,36.36087,115088
5824,rkx-bloodshed,1,0.00087,41848,36.36174,115088
5825,rlewkowicz,1,0.00087,41849,36.36261,115088
5826,rlk5546,1,0.00087,41850,36.36348,115088
5827,rmalenko,1,0.00087,41851,36.36435,115088
5828,rmbreak,1,0.00087,41852,36.36522,115088
5829,roasties,1,0.00087,41853,36.36609,115088
5830,robbinscp,1,0.00087,41854,36.36695,115088
5831,robeatoz,1,0.00087,41855,36.36782,115088
5832,robertpitt,1,0.00087,41856,36.36869,115088
5833,robertrbruno,1,0.00087,41857,36.36956,115088
5834,robertwol,1,0.00087,41858,36.37043,115088
5835,robinkb,1,0.00087,41859,36.37130,115088
5836,RobinNil,1,0.00087,41860,36.37217,115088
5837,robrsprd,1,0.00087,41861,36.37304,115088
5838,robweiss,1,0.00087,41862,36.37391,115088
5839,Rocklviv,1,0.00087,41863,36.37477,115088
5840,rodlogic,1,0.00087,41864,36.37564,115088
5841,rodrigodiez,1,0.00087,41865,36.37651,115088
5842,roeera,1,0.00087,41866,36.37738,115088
5843,rogervila,1,0.00087,41867,36.37825,115088
5844,rohitgithub26,1,0.00087,41868,36.37912,115088
5845,RohitK89,1,0.00087,41869,36.37999,115088
5846,romanr,1,0.00087,41870,36.38086,115088
5847,romanvog,1,0.00087,41871,36.38173,115088
5848,romoy,1,0.00087,41872,36.38259,115088
5849,ronak-agarwal,1,0.00087,41873,36.38346,115088
5850,ronanbuke,1,0.00087,41874,36.38433,115088
5851,ronnyle,1,0.00087,41875,36.38520,115088
5852,rootvgusr,1,0.00087,41876,36.38607,115088
5853,rossbeehler,1,0.00087,41877,36.38694,115088
5854,rotmond,1,0.00087,41878,36.38781,115088
5855,rpahli,1,0.00087,41879,36.38868,115088
5856,rparsonsbb,1,0.00087,41880,36.38955,115088
5857,rpn588,1,0.00087,41881,36.39041,115088
5858,rsommer,1,0.00087,41882,36.39128,115088
5859,rtusys,1,0.00087,41883,36.39215,115088
5860,Rudolph-Miller,1,0.00087,41884,36.39302,115088
5861,RufusDerrid,1,0.00087,41885,36.39389,115088
5862,ruilapa,1,0.00087,41886,36.39476,115088
5863,rvojcik,1,0.00087,41887,36.39563,115088
5864,RX14,1,0.00087,41888,36.39650,115088
5865,ryank01,1,0.00087,41889,36.39737,115088
5866,ryo0301,1,0.00087,41890,36.39823,115088
5867,ryopeko,1,0.00087,41891,36.39910,115088
5868,rzenker,1,0.00087,41892,36.39997,115088
5869,sadhasivam,1,0.00087,41893,36.40084,115088
5870,sadovnychyi,1,0.00087,41894,36.40171,115088
5871,sadpirit,1,0.00087,41895,36.40258,115088
5872,safiyat,1,0.00087,41896,36.40345,115088
5873,sagarmujumale,1,0.00087,41897,36.40432,115088
5874,sage2k1,1,0.00087,41898,36.40519,115088
5875,saharajdeep,1,0.00087,41899,36.40605,115088
5876,saif-cl0ud,1,0.00087,41900,36.40692,115088
5877,sakatam,1,0.00087,41901,36.40779,115088
5878,sakshitrialacc,1,0.00087,41902,36.40866,115088
5879,salsa-dev,1,0.00087,41903,36.40953,115088
5880,saltenhub,1,0.00087,41904,36.41040,115088
5881,samgurtman,1,0.00087,41905,36.41127,115088
5882,samirspatel,1,0.00087,41906,36.41214,115088
5883,samlavery,1,0.00087,41907,36.41301,115088
5884,SamLiu79,1,0.00087,41908,36.41387,115088
5885,samsema4,1,0.00087,41909,36.41474,115088
5886,samstokes,1,0.00087,41910,36.41561,115088
5887,sanbornm,1,0.00087,41911,36.41648,115088
5888,sandeepmreddy,1,0.00087,41912,36.41735,115088
5889,sandrobonazzola,1,0.00087,41913,36.41822,115088
5890,sanguinoj,1,0.00087,41914,36.41909,115088
5891,sanjaykesavan,1,0.00087,41915,36.41996,115088
5892,sanjay-varanasi,1,0.00087,41916,36.42083,115088
5893,sankosa,1,0.00087,41917,36.42169,115088
5894,Santinell,1,0.00087,41918,36.42256,115088
5895,sanyer,1,0.00087,41919,36.42343,115088
5896,saritaverma,1,0.00087,41920,36.42430,115088
5897,sarlacpit,1,0.00087,41921,36.42517,115088
5898,sarmadali20,1,0.00087,41922,36.42604,115088
5899,sashich,1,0.00087,41923,36.42691,115088
5900,sasi1124,1,0.00087,41924,36.42778,115088
5901,SathyaPrabhu,1,0.00087,41925,36.42865,115088
5902,satyapraveen2002,1,0.00087,41926,36.42951,115088
5903,saurabtanej,1,0.00087,41927,36.43038,115088
5904,saurajeet,1,0.00087,41928,36.43125,115088
5905,savealive,1,0.00087,41929,36.43212,115088
5906,saviogl,1,0.00087,41930,36.43299,115088
5907,sb1975,1,0.00087,41931,36.43386,115088
5908,sboagibm,1,0.00087,41932,36.43473,115088
5909,sbusso,1,0.00087,41933,36.43560,115088
5910,scamfield,1,0.00087,41934,36.43647,115088
5911,schmooster,1,0.00087,41935,36.43733,115088
5912,schndr,1,0.00087,41936,36.43820,115088
5913,schneidmaster,1,0.00087,41937,36.43907,115088
5914,Schnitzel,1,0.00087,41938,36.43994,115088
5915,SchoIsles,1,0.00087,41939,36.44081,115088
5916,scottdhowell3,1,0.00087,41940,36.44168,115088
5917,scripter-v,1,0.00087,41941,36.44255,115088
5918,scrowbar,1,0.00087,41942,36.44342,115088
5919,scsibug,1,0.00087,41943,36.44429,115088
5920,sd2020bs,1,0.00087,41944,36.44516,115088
5921,seanmars,1,0.00087,41945,36.44602,115088
5922,seanmcguiganjcd,1,0.00087,41946,36.44689,115088
5923,sebastiendarocha,1,0.00087,41947,36.44776,115088
5924,Secathor,1,0.00087,41948,36.44863,115088
5925,secure0,1,0.00087,41949,36.44950,115088
5926,seedhunt,1,0.00087,41950,36.45037,115088
5927,Seji64,1,0.00087,41951,36.45124,115088
5928,selfieblue,1,0.00087,41952,36.45211,115088
5929,selslack,1,0.00087,41953,36.45298,115088
5930,senattcsgit,1,0.00087,41954,36.45384,115088
5931,sepich,1,0.00087,41955,36.45471,115088
5932,serbaut,1,0.00087,41956,36.45558,115088
5933,sergeyg-earnin,1,0.00087,41957,36.45645,115088
5934,sergeyglazyrindev,1,0.00087,41958,36.45732,115088
5935,seth-macpherson,1,0.00087,41959,36.45819,115088
5936,seungyongshim,1,0.00087,41960,36.45906,115088
5937,SFHfeihong,1,0.00087,41961,36.45993,115088
5938,sfrique,1,0.00087,41962,36.46080,115088
5939,sgeffken,1,0.00087,41963,36.46166,115088
5940,sgreco2002,1,0.00087,41964,36.46253,115088
5941,shahamit2,1,0.00087,41965,36.46340,115088
5942,ShahBinoy,1,0.00087,41966,36.46427,115088
5943,shai32,1,0.00087,41967,36.46514,115088
5944,shane-axiom,1,0.00087,41968,36.46601,115088
5945,shankerm-ti,1,0.00087,41969,36.46688,115088
5946,shao1555,1,0.00087,41970,36.46775,115088
5947,sharmarajat24,1,0.00087,41971,36.46862,115088
5948,shashanktyagi3192,1,0.00087,41972,36.46948,115088
5949,shawndream,1,0.00087,41973,36.47035,115088
5950,Shayner85,1,0.00087,41974,36.47122,115088
5951,shearer12345,1,0.00087,41975,36.47209,115088
5952,shengis,1,0.00087,41976,36.47296,115088
5953,Sherler,1,0.00087,41977,36.47383,115088
5954,shiftux,1,0.00087,41978,36.47470,115088
5955,shinbero,1,0.00087,41979,36.47557,115088
5956,shinjiikeda,1,0.00087,41980,36.47644,115088
5957,shinji-m,1,0.00087,41981,36.47730,115088
5958,shipilovds,1,0.00087,41982,36.47817,115088
5959,ShironB,1,0.00087,41983,36.47904,115088
5960,shmykyta,1,0.00087,41984,36.47991,115088
5961,sho-h,1,0.00087,41985,36.48078,115088
5962,shoutakenaka,1,0.00087,41986,36.48165,115088
5963,show168,1,0.00087,41987,36.48252,115088
5964,shrirangphadke,1,0.00087,41988,36.48339,115088
5965,ShunHsiangYou,1,0.00087,41989,36.48426,115088
5966,shunyy,1,0.00087,41990,36.48512,115088
5967,shusugmt,1,0.00087,41991,36.48599,115088
5968,shuttie,1,0.00087,41992,36.48686,115088
5969,siburu,1,0.00087,41993,36.48773,115088
5970,sicriops,1,0.00087,41994,36.48860,115088
5971,sidps,1,0.00087,41995,36.48947,115088
5972,sidSingla,1,0.00087,41996,36.49034,115088
5973,Siete-F,1,0.00087,41997,36.49121,115088
5974,silverbadge,1,0.00087,41998,36.49208,115088
5975,simonedimarzio,1,0.00087,41999,36.49294,115088
5976,simonz130,1,0.00087,42000,36.49381,115088
5977,sinkcup,1,0.00087,42001,36.49468,115088
5978,si-rob,1,0.00087,42002,36.49555,115088
5979,siseci,1,0.00087,42003,36.49642,115088
5980,sivabalans,1,0.00087,42004,36.49729,115088
5981,sivabizruntime,1,0.00087,42005,36.49816,115088
5982,sixdayhun,1,0.00087,42006,36.49903,115088
5983,Sixeight,1,0.00087,42007,36.49990,115088
5984,sjames-iberis,1,0.00087,42008,36.50076,115088
5985,sjentzsch,1,0.00087,42009,36.50163,115088
5986,sk3749614,1,0.00087,42010,36.50250,115088
5987,skalickym,1,0.00087,42011,36.50337,115088
5988,skbly7,1,0.00087,42012,36.50424,115088
5989,skny5,1,0.00087,42013,36.50511,115088
5990,skobaken7,1,0.00087,42014,36.50598,115088
5991,skuroki,1,0.00087,42015,36.50685,115088
5992,skyshard,1,0.00087,42016,36.50772,115088
5993,sl4dy,1,0.00087,42017,36.50858,115088
5994,slam,1,0.00087,42018,36.50945,115088
5995,sleptor,1,0.00087,42019,36.51032,115088
5996,slobodyanyuk,1,0.00087,42020,36.51119,115088
5997,smacpher-myst,1,0.00087,42021,36.51206,115088
5998,smahasa,1,0.00087,42022,36.51293,115088
5999,smallsong,1,0.00087,42023,36.51380,115088
6000,SManral,1,0.00087,42024,36.51467,115088
6001,smartlizzard,1,0.00087,42025,36.51554,115088
6002,smenon78,1,0.00087,42026,36.51640,115088
6003,smicha,1,0.00087,42027,36.51727,115088
6004,smilefish1987,1,0.00087,42028,36.51814,115088
6005,smitty4x4,1,0.00087,42029,36.51901,115088
6006,smmckay,1,0.00087,42030,36.51988,115088
6007,snaka,1,0.00087,42031,36.52075,115088
6008,sNathan13,1,0.00087,42032,36.52162,115088
6009,SnazzyBootMan,1,0.00087,42033,36.52249,115088
6010,snedi,1,0.00087,42034,36.52336,115088
6011,snltd,1,0.00087,42035,36.52422,115088
6012,snowhork,1,0.00087,42036,36.52509,115088
6013,sodabrew,1,0.00087,42037,36.52596,115088
6014,softcombiz,1,0.00087,42038,36.52683,115088
6015,softprops,1,0.00087,42039,36.52770,115088
6016,sonalkr132,1,0.00087,42040,36.52857,115088
6017,SongGithub,1,0.00087,42041,36.52944,115088
6018,sossickd,1,0.00087,42042,36.53031,115088
6019,sota0805,1,0.00087,42043,36.53118,115088
6020,soudaburger,1,0.00087,42044,36.53205,115088
6021,soukichi,1,0.00087,42045,36.53291,115088
6022,SowmyaNayan,1,0.00087,42046,36.53378,115088
6023,spacediver,1,0.00087,42047,36.53465,115088
6024,sparr,1,0.00087,42048,36.53552,115088
6025,spingel,1,0.00087,42049,36.53639,115088
6026,spiralman,1,0.00087,42050,36.53726,115088
6027,spirrello,1,0.00087,42051,36.53813,115088
6028,sporkmonger,1,0.00087,42052,36.53900,115088
6029,sqtran,1,0.00087,42053,36.53987,115088
6030,srabenhorst,1,0.00087,42054,36.54073,115088
6031,sreedharbukya,1,0.00087,42055,36.54160,115088
6032,srikanthbirada,1,0.00087,42056,36.54247,115088
6033,srirachapills,1,0.00087,42057,36.54334,115088
6034,sriramsv,1,0.00087,42058,36.54421,115088
6035,srivanibhompally,1,0.00087,42059,36.54508,115088
6036,ssergiienko,1,0.00087,42060,36.54595,115088
6037,sspreitzer,1,0.00087,42061,36.54682,115088
6038,st3xupery,1,0.00087,42062,36.54769,115088
6039,s-tajima,1,0.00087,42063,36.54855,115088
6040,stanhordiyenko,1,0.00087,42064,36.54942,115088
6041,stanisavs,1,0.00087,42065,36.55029,115088
6042,stefaneg,1,0.00087,42066,36.55116,115088
6043,stefannilsson,1,0.00087,42067,36.55203,115088
6044,stefano-pogliani,1,0.00087,42068,36.55290,115088
6045,StephenHynes7,1,0.00087,42069,36.55377,115088
6046,StephGit,1,0.00087,42070,36.55464,115088
6047,stepierc,1,0.00087,42071,36.55551,115088
6048,sterchelen,1,0.00087,42072,36.55637,115088
6049,stevelr,1,0.00087,42073,36.55724,115088
6050,stevenarvar,1,0.00087,42074,36.55811,115088
6051,stiak,1,0.00087,42075,36.55898,115088
6052,stmos,1,0.00087,42076,36.55985,115088
6053,StratusChris,1,0.00087,42077,36.56072,115088
6054,strictnerd,1,0.00087,42078,36.56159,115088
6055,strikingraghu,1,0.00087,42079,36.56246,115088
6056,stuartsan,1,0.00087,42080,36.56333,115088
6057,studiotomi,1,0.00087,42081,36.56419,115088
6058,suau,1,0.00087,42082,36.56506,115088
6059,subinmt,1,0.00087,42083,36.56593,115088
6060,suckowbiz,1,0.00087,42084,36.56680,115088
6061,sudamerushabh,1,0.00087,42085,36.56767,115088
6062,sudhanshu-dev,1,0.00087,42086,36.56854,115088
6063,sudharsh,1,0.00087,42087,36.56941,115088
6064,sugahara,1,0.00087,42088,36.57028,115088
6065,sumeshpremraj,1,0.00087,42089,36.57115,115088
6066,suneeta-mall,1,0.00087,42090,36.57201,115088
6067,sunhao-java,1,0.00087,42091,36.57288,115088
6068,sunny4381,1,0.00087,42092,36.57375,115088
6069,sunyi620,1,0.00087,42093,36.57462,115088
6070,superguillen,1,0.00087,42094,36.57549,115088
6071,sureshamk,1,0.00087,42095,36.57636,115088
6072,sutetotanuki,1,0.00087,42096,36.57723,115088
6073,suxiaobai,1,0.00087,42097,36.57810,115088
6074,suzuken,1,0.00087,42098,36.57897,115088
6075,svalentino,1,0.00087,42099,36.57983,115088
6076,svenhenry,1,0.00087,42100,36.58070,115088
6077,swatanabeidcf,1,0.00087,42101,36.58157,115088
6078,swfortier,1,0.00087,42102,36.58244,115088
6079,sww0825521xy,1,0.00087,42103,36.58331,115088
6080,s-yata,1,0.00087,42104,36.58418,115088
6081,SylvainDe,1,0.00087,42105,36.58505,115088
6082,sylvainkalache,1,0.00087,42106,36.58592,115088
6083,sysadmind,1,0.00087,42107,36.58679,115088
6084,Sytten,1,0.00087,42108,36.58765,115088
6085,syukur91,1,0.00087,42109,36.58852,115088
6086,szimonek,1,0.00087,42110,36.58939,115088
6087,T0MASD,1,0.00087,42111,36.59026,115088
6088,T4cC0re,1,0.00087,42112,36.59113,115088
6089,tachiba,1,0.00087,42113,36.59200,115088
6090,tachyon29,1,0.00087,42114,36.59287,115088
6091,taer,1,0.00087,42115,36.59374,115088
6092,taglines,1,0.00087,42116,36.59461,115088
6093,tahajahangir,1,0.00087,42117,36.59547,115088
6094,TaikiKawamura,1,0.00087,42118,36.59634,115088
6095,taka0125,1,0.00087,42119,36.59721,115088
6096,takashibagura,1,0.00087,42120,36.59808,115088
6097,takashikami,1,0.00087,42121,36.59895,115088
6098,takasix,1,0.00087,42122,36.59982,115088
6099,takayahilton,1,0.00087,42123,36.60069,115088
6100,takemim,1,0.00087,42124,36.60156,115088
6101,takeru,1,0.00087,42125,36.60243,115088
6102,tako63,1,0.00087,42126,36.60329,115088
6103,takumin,1,0.00087,42127,36.60416,115088
6104,talhelfgott-cx,1,0.00087,42128,36.60503,115088
6105,tamsel,1,0.00087,42129,36.60590,115088
6106,tanel-andreson,1,0.00087,42130,36.60677,115088
6107,tangerstein,1,0.00087,42131,36.60764,115088
6108,tanimichi,1,0.00087,42132,36.60851,115088
6109,taormania,1,0.00087,42133,36.60938,115088
6110,taras2358,1,0.00087,42134,36.61025,115088
6111,tatuze,1,0.00087,42135,36.61111,115088
6112,Tavio,1,0.00087,42136,36.61198,115088
6113,tavisma,1,0.00087,42137,36.61285,115088
6114,taylorshaulis,1,0.00087,42138,36.61372,115088
6115,tbragin,1,0.00087,42139,36.61459,115088
6116,tcnksm,1,0.00087,42140,36.61546,115088
6117,tecbird,1,0.00087,42141,36.61633,115088
6118,TechCanuck,1,0.00087,42142,36.61720,115088
6119,techmng,1,0.00087,42143,36.61807,115088
6120,tedkol,1,0.00087,42144,36.61894,115088
6121,terciodemelo,1,0.00087,42145,36.61980,115088
6122,tesh11,1,0.00087,42146,36.62067,115088
6123,TeslaCtroitel,1,0.00087,42147,36.62154,115088
6124,texasbobs,1,0.00087,42148,36.62241,115088
6125,thaohien1812,1,0.00087,42149,36.62328,115088
6126,thearifismail,1,0.00087,42150,36.62415,115088
6127,thebitguru,1,0.00087,42151,36.62502,115088
6128,thenayr,1,0.00087,42152,36.62589,115088
6129,TheNotTooDistantFuture,1,0.00087,42153,36.62676,115088
6130,thenovacreator,1,0.00087,42154,36.62762,115088
6131,theothermike,1,0.00087,42155,36.62849,115088
6132,Thericho,1,0.00087,42156,36.62936,115088
6133,thiago,1,0.00087,42157,36.63023,115088
6134,ThiagoMiranda,1,0.00087,42158,36.63110,115088
6135,thiendd,1,0.00087,42159,36.63197,115088
6136,thirtyseven,1,0.00087,42160,36.63284,115088
6137,ThomKoomen,1,0.00087,42161,36.63371,115088
6138,ThomWright,1,0.00087,42162,36.63458,115088
6139,thorro,1,0.00087,42163,36.63544,115088
6140,thr3a,1,0.00087,42164,36.63631,115088
6141,threetreeslight,1,0.00087,42165,36.63718,115088
6142,TiagoJMartins,1,0.00087,42166,36.63805,115088
6143,tiendungitd,1,0.00087,42167,36.63892,115088
6144,tilan7663,1,0.00087,42168,36.63979,115088
6145,Till--H,1,0.00087,42169,36.64066,115088
6146,timblackwell,1,0.00087,42170,36.64153,115088
6147,timka,1,0.00087,42171,36.64240,115088
6148,timosellin,1,0.00087,42172,36.64326,115088
6149,tinproject,1,0.00087,42173,36.64413,115088
6150,tjinjin,1,0.00087,42174,36.64500,115088
6151,tkrs,1,0.00087,42175,36.64587,115088
6152,tlohner,1,0.00087,42176,36.64674,115088
6153,tmcgann,1,0.00087,42177,36.64761,115088
6154,tmojlupo,1,0.00087,42178,36.64848,115088
6155,tmomy,1,0.00087,42179,36.64935,115088
6156,tmontney,1,0.00087,42180,36.65022,115088
6157,tmor,1,0.00087,42181,36.65108,115088
6158,tmurakam,1,0.00087,42182,36.65195,115088
6159,tnaoto,1,0.00087,42183,36.65282,115088
6160,tobyfoo,1,0.00087,42184,36.65369,115088
6161,toddaa,1,0.00087,42185,36.65456,115088
6162,toddlers,1,0.00087,42186,36.65543,115088
6163,tomasdubec,1,0.00087,42187,36.65630,115088
6164,tomasiew,1,0.00087,42188,36.65717,115088
6165,tombailey,1,0.00087,42189,36.65804,115088
6166,tombart,1,0.00087,42190,36.65890,115088
6167,tomghuang,1,0.00087,42191,36.65977,115088
6168,tommiatplayfish,1,0.00087,42192,36.66064,115088
6169,tommyjakobsen,1,0.00087,42193,36.66151,115088
6170,tomola,1,0.00087,42194,36.66238,115088
6171,toniov,1,0.00087,42195,36.66325,115088
6172,toniree,1,0.00087,42196,36.66412,115088
6173,TonyHuiHUI,1,0.00087,42197,36.66499,115088
6174,tonyjiang,1,0.00087,42198,36.66586,115088
6175,toritori0318,1,0.00087,42199,36.66672,115088
6176,toshirov,1,0.00087,42200,36.66759,115088
6177,toughrogrammer,1,0.00087,42201,36.66846,115088
6178,tracers2222,1,0.00087,42202,36.66933,115088
6179,trantor,1,0.00087,42203,36.67020,115088
6180,travis5491811,1,0.00087,42204,36.67107,115088
6181,travisghansen,1,0.00087,42205,36.67194,115088
6182,traviswdev,1,0.00087,42206,36.67281,115088
6183,traytonwhite,1,0.00087,42207,36.67368,115088
6184,tremolo,1,0.00087,42208,36.67454,115088
6185,trevorriles,1,0.00087,42209,36.67541,115088
6186,triethuynh92,1,0.00087,42210,36.67628,115088
6187,triha74,1,0.00087,42211,36.67715,115088
6188,tri-star,1,0.00087,42212,36.67802,115088
6189,tsangacw,1,0.00087,42213,36.67889,115088
6190,tskardal,1,0.00087,42214,36.67976,115088
6191,tsu1980,1,0.00087,42215,36.68063,115088
6192,tszming,1,0.00087,42216,36.68150,115088
6193,ttqin,1,0.00087,42217,36.68236,115088
6194,tuananh170489,1,0.00087,42218,36.68323,115088
6195,tuasowro,1,0.00087,42219,36.68410,115088
6196,tuiaswath,1,0.00087,42220,36.68497,115088
6197,tukeJonny,1,0.00087,42221,36.68584,115088
6198,turnon,1,0.00087,42222,36.68671,115088
6199,tvvignesh,1,0.00087,42223,36.68758,115088
6200,twang2218,1,0.00087,42224,36.68845,115088
6201,tweettypography,1,0.00087,42225,36.68932,115088
6202,twili9ht,1,0.00087,42226,36.69018,115088
6203,twittyc,1,0.00087,42227,36.69105,115088
6204,two8g,1,0.00087,42228,36.69192,115088
6205,twosider,1,0.00087,42229,36.69279,115088
6206,tw-tmac,1,0.00087,42230,36.69366,115088
6207,t-yamo,1,0.00087,42231,36.69453,115088
6208,TyeMcQueen,1,0.00087,42232,36.69540,115088
6209,Tyrael,1,0.00087,42233,36.69627,115088
6210,ugifractal,1,0.00087,42234,36.69714,115088
6211,ujun,1,0.00087,42235,36.69801,115088
6212,uklg,1,0.00087,42236,36.69887,115088
6213,UladzimirSemiankou,1,0.00087,42237,36.69974,115088
6214,ultinous-lawliet,1,0.00087,42238,36.70061,115088
6215,uMag,1,0.00087,42239,36.70148,115088
6216,umathivagit,1,0.00087,42240,36.70235,115088
6217,umeshchhabra,1,0.00087,42241,36.70322,115088
6218,umkt,1,0.00087,42242,36.70409,115088
6219,umutkocasarac,1,0.00087,42243,36.70496,115088
6220,UncleIS,1,0.00087,42244,36.70583,115088
6221,unikmhz,1,0.00087,42245,36.70669,115088
6222,unknown321,1,0.00087,42246,36.70756,115088
6223,uover82,1,0.00087,42247,36.70843,115088
6224,upendrasahu,1,0.00087,42248,36.70930,115088
6225,uppfinnarn,1,0.00087,42249,36.71017,115088
6226,usergoodvery,1,0.00087,42250,36.71104,115088
6227,utkudarilmaz,1,0.00087,42251,36.71191,115088
6228,uzzz,1,0.00087,42252,36.71278,115088
6229,vaivars,1,0.00087,42253,36.71365,115088
6230,valeba,1,0.00087,42254,36.71451,115088
6231,valentin2105,1,0.00087,42255,36.71538,115088
6232,vanomashey,1,0.00087,42256,36.71625,115088
6233,Vanshika093,1,0.00087,42257,36.71712,115088
6234,Vardhaman-Surana,1,0.00087,42258,36.71799,115088
6235,varghgeorge,1,0.00087,42259,36.71886,115088
6236,varusan,1,0.00087,42260,36.71973,115088
6237,vasilij-icabbi,1,0.00087,42261,36.72060,115088
6238,vatcher,1,0.00087,42262,36.72147,115088
6239,vedaprasad,1,0.00087,42263,36.72233,115088
6240,Vehyla,1,0.00087,42264,36.72320,115088
6241,Veiasai,1,0.00087,42265,36.72407,115088
6242,VenkatNarayanaYarava,1,0.00087,42266,36.72494,115088
6243,VennilaJ,1,0.00087,42267,36.72581,115088
6244,verbunk,1,0.00087,42268,36.72668,115088
6245,veryluckyguy,1,0.00087,42269,36.72755,115088
6246,vfreitas-cit,1,0.00087,42270,36.72842,115088
6247,vhdevera,1,0.00087,42271,36.72929,115088
6248,Vhodnoylogin,1,0.00087,42272,36.73015,115088
6249,via-justa,1,0.00087,42273,36.73102,115088
6250,vially,1,0.00087,42274,36.73189,115088
6251,Viking-Bird,1,0.00087,42275,36.73276,115088
6252,Viktor86,1,0.00087,42276,36.73363,115088
6253,vilar-rivendel,1,0.00087,42277,36.73450,115088
6254,vinceferro,1,0.00087,42278,36.73537,115088
6255,VinceMD,1,0.00087,42279,36.73624,115088
6256,vinkdong,1,0.00087,42280,36.73711,115088
6257,vinogradovs,1,0.00087,42281,36.73797,115088
6258,vishal8k,1,0.00087,42282,36.73884,115088
6259,vishalgupta1988,1,0.00087,42283,36.73971,115088
6260,vishnubraj,1,0.00087,42284,36.74058,115088
6261,vittee,1,0.00087,42285,36.74145,115088
6262,vivekguptacse,1,0.00087,42286,36.74232,115088
6263,viveklanjekar,1,0.00087,42287,36.74319,115088
6264,viveksamaga,1,0.00087,42288,36.74406,115088
6265,viveksatasiya,1,0.00087,42289,36.74493,115088
6266,vkareh,1,0.00087,42290,36.74579,115088
6267,vkperumal,1,0.00087,42291,36.74666,115088
6268,VladaPetrovic,1,0.00087,42292,36.74753,115088
6269,vlad-dragos,1,0.00087,42293,36.74840,115088
6270,vladget,1,0.00087,42294,36.74927,115088
6271,vmahe35,1,0.00087,42295,36.75014,115088
6272,vmanikes,1,0.00087,42296,36.75101,115088
6273,vmenonvz,1,0.00087,42297,36.75188,115088
6274,vnnw,1,0.00087,42298,36.75275,115088
6275,VogonogoV,1,0.00087,42299,36.75361,115088
6276,voidpirate,1,0.00087,42300,36.75448,115088
6277,voltairevi,1,0.00087,42301,36.75535,115088
6278,vosdev,1,0.00087,42302,36.75622,115088
6279,vrastogi13,1,0.00087,42303,36.75709,115088
6280,vrivellino,1,0.00087,42304,36.75796,115088
6281,vsxen,1,0.00087,42305,36.75883,115088
6282,vthornheart-bng,1,0.00087,42306,36.75970,115088
6283,vurt007,1,0.00087,42307,36.76057,115088
6284,vuul,1,0.00087,42308,36.76143,115088
6285,w1mvy,1,0.00087,42309,36.76230,115088
6286,w8193277,1,0.00087,42310,36.76317,115088
6287,waderobson,1,0.00087,42311,36.76404,115088
6288,waleedsamy,1,0.00087,42312,36.76491,115088
6289,waltsims,1,0.00087,42313,36.76578,115088
6290,wandera-pchung,1,0.00087,42314,36.76665,115088
6291,wardviaene,1,0.00087,42315,36.76752,115088
6292,waseem-h,1,0.00087,42316,36.76839,115088
6293,wataru420,1,0.00087,42317,36.76925,115088
6294,wawadukan,1,0.00087,42318,36.77012,115088
6295,Wesdesignz,1,0.00087,42319,36.77099,115088
6296,wgtmpeters,1,0.00087,42320,36.77186,115088
6297,WhatDream,1,0.00087,42321,36.77273,115088
6298,whitelynx,1,0.00087,42322,36.77360,115088
6299,whm0627,1,0.00087,42323,36.77447,115088
6300,whoard,1,0.00087,42324,36.77534,115088
6301,wilesna25,1,0.00087,42325,36.77621,115088
6302,willylee,1,0.00087,42326,36.77707,115088
6303,willysamz,1,0.00087,42327,36.77794,115088
6304,windgan,1,0.00087,42328,36.77881,115088
6305,windmgc,1,0.00087,42329,36.77968,115088
6306,WishCow,1,0.00087,42330,36.78055,115088
6307,Wiston999,1,0.00087,42331,36.78142,115088
6308,wiza,1,0.00087,42332,36.78229,115088
6309,wolfgangihloff,1,0.00087,42333,36.78316,115088
6310,wonderphil,1,0.00087,42334,36.78403,115088
6311,wonohe,1,0.00087,42335,36.78490,115088
6312,WoodProgrammer,1,0.00087,42336,36.78576,115088
6313,woodsae,1,0.00087,42337,36.78663,115088
6314,WOoWBOo,1,0.00087,42338,36.78750,115088
6315,worldchanger,1,0.00087,42339,36.78837,115088
6316,wrossmann,1,0.00087,42340,36.78924,115088
6317,wsimmonds,1,0.00087,42341,36.79011,115088
6318,wsw70,1,0.00087,42342,36.79098,115088
6319,wulfgar93,1,0.00087,42343,36.79185,115088
6320,WUMUXIAN,1,0.00087,42344,36.79272,115088
6321,wzcwts521,1,0.00087,42345,36.79358,115088
6322,wzrdtales,1,0.00087,42346,36.79445,115088
6323,x09,1,0.00087,42347,36.79532,115088
6324,xadcoh,1,0.00087,42348,36.79619,115088
6325,xellsys,1,0.00087,42349,36.79706,115088
6326,xiaomage008,1,0.00087,42350,36.79793,115088
6327,xiaozhouzhou,1,0.00087,42351,36.79880,115088
6328,xinghui-hou,1,0.00087,42352,36.79967,115088
6329,xitation,1,0.00087,42353,36.80054,115088
6330,xjtian,1,0.00087,42354,36.80140,115088
6331,xoroz,1,0.00087,42355,36.80227,115088
6332,xpflying,1,0.00087,42356,36.80314,115088
6333,xrismck,1,0.00087,42357,36.80401,115088
6334,xud6,1,0.00087,42358,36.80488,115088
6335,xuejipeng,1,0.00087,42359,36.80575,115088
6336,xujihui1985,1,0.00087,42360,36.80662,115088
6337,y13i,1,0.00087,42361,36.80749,115088
6338,yakexi07,1,0.00087,42362,36.80836,115088
6339,yakult1995,1,0.00087,42363,36.80922,115088
6340,yama-3,1,0.00087,42364,36.81009,115088
6341,yamotonalds,1,0.00087,42365,36.81096,115088
6342,yangsong1993,1,0.00087,42366,36.81183,115088
6343,yangzb09,1,0.00087,42367,36.81270,115088
6344,yanivroz,1,0.00087,42368,36.81357,115088
6345,y-batsianouski,1,0.00087,42369,36.81444,115088
6346,ydawant,1,0.00087,42370,36.81531,115088
6347,yehosef,1,0.00087,42371,36.81618,115088
6348,yelavalli,1,0.00087,42372,36.81704,115088
6349,yfoelling,1,0.00087,42373,36.81791,115088
6350,yfried,1,0.00087,42374,36.81878,115088
6351,yhb001002,1,0.00087,42375,36.81965,115088
6352,yishaihl,1,0.00087,42376,36.82052,115088
6353,yishenggudou,1,0.00087,42377,36.82139,115088
6354,ykfq,1,0.00087,42378,36.82226,115088
6355,ykolomiets,1,0.00087,42379,36.82313,115088
6356,ylopatin-earnin,1,0.00087,42380,36.82400,115088
6357,ymartincds,1,0.00087,42381,36.82486,115088
6358,ymitsos,1,0.00087,42382,36.82573,115088
6359,ymmtmsys,1,0.00087,42383,36.82660,115088
6360,ynuyasha,1,0.00087,42384,36.82747,115088
6361,yoni1306,1,0.00087,42385,36.82834,115088
6362,yoshida564,1,0.00087,42386,36.82921,115088
6363,yosisa,1,0.00087,42387,36.83008,115088
6364,youske,1,0.00087,42388,36.83095,115088
6365,ypjin,1,0.00087,42389,36.83182,115088
6366,yqwang-ms,1,0.00087,42390,36.83268,115088
6367,ysd002,1,0.00087,42391,36.83355,115088
6368,yshemesh,1,0.00087,42392,36.83442,115088
6369,ysubach,1,0.00087,42393,36.83529,115088
6370,y-t,1,0.00087,42394,36.83616,115088
6371,ytkang,1,0.00087,42395,36.83703,115088
6372,yuan-make,1,0.00087,42396,36.83790,115088
6373,yuanzy1994,1,0.00087,42397,36.83877,115088
6374,YueHonghui,1,0.00087,42398,36.83964,115088
6375,yuezijian,1,0.00087,42399,36.84050,115088
6376,yugoslavskiy,1,0.00087,42400,36.84137,115088
6377,yujinkay,1,0.00087,42401,36.84224,115088
6378,yunsunghan,1,0.00087,42402,36.84311,115088
6379,yuri-1987,1,0.00087,42403,36.84398,115088
6380,yuripastushenko,1,0.00087,42404,36.84485,115088
6381,yusong-shen,1,0.00087,42405,36.84572,115088
6382,yuvraj2987,1,0.00087,42406,36.84659,115088
6383,yybear,1,0.00087,42407,36.84746,115088
6384,Z0T0,1,0.00087,42408,36.84832,115088
6385,zac-nixon,1,0.00087,42409,36.84919,115088
6386,zakariahoussa,1,0.00087,42410,36.85006,115088
6387,zellski,1,0.00087,42411,36.85093,115088
6388,Zenlil,1,0.00087,42412,36.85180,115088
6389,zensoftdevops,1,0.00087,42413,36.85267,115088
6390,Zephery,1,0.00087,42414,36.85354,115088
6391,zerkms,1,0.00087,42415,36.85441,115088
6392,zersh01,1,0.00087,42416,36.85528,115088
6393,zeushammer,1,0.00087,42417,36.85614,115088
6394,zexi,1,0.00087,42418,36.85701,115088
6395,zfoxdev,1,0.00087,42419,36.85788,115088
6396,zhangbin666888,1,0.00087,42420,36.85875,115088
6397,zhanghjster,1,0.00087,42421,36.85962,115088
6398,zhangyunjian-qiniu,1,0.00087,42422,36.86049,115088
6399,zhasik911,1,0.00087,42423,36.86136,115088
6400,zhijiangwang,1,0.00087,42424,36.86223,115088
6401,zhxiaom5,1,0.00087,42425,36.86310,115088
6402,ziaudin,1,0.00087,42426,36.86396,115088
6403,zironycho,1,0.00087,42427,36.86483,115088
6404,zkf9971,1,0.00087,42428,36.86570,115088
6405,zkrhm,1,0.00087,42429,36.86657,115088
6406,zmichael,1,0.00087,42430,36.86744,115088
6407,zoell,1,0.00087,42431,36.86831,115088
6408,zOndra42,1,0.00087,42432,36.86918,115088
6409,zonepalms91,1,0.00087,42433,36.87005,115088
6410,zonywhoop,1,0.00087,42434,36.87092,115088
6411,zpDeveloper,1,0.00087,42435,36.87179,115088
6412,zvickery,1,0.00087,42436,36.87265,115088
6413,zycbobby,1,0.00087,42437,36.87352,115088
6414,zzswang,1,0.00087,42438,36.87439,115088
