rank_number,actor,contributions,percent,cumulative_sum,cumulative_percent,all_contributions
1,nigels-com,266,0.45476,266,0.45476,58493
2,PettitWesley,158,0.27012,424,0.72487,58493
3,coto,108,0.18464,532,0.90951,58493
4,loveshell,65,0.11112,597,1.02063,58493
5,rolandjitsu,55,0.09403,652,1.11466,58493
6,jordo1138,47,0.08035,699,1.19501,58493
7,ahsandar,44,0.07522,743,1.27024,58493
8,AkshayDubey29,41,0.07009,784,1.34033,58493
9,dtboctor,36,0.06155,820,1.40188,58493
10,marckamerbeek,36,0.06155,856,1.46342,58493
11,papiveron,36,0.06155,892,1.52497,58493
12,perrin4869,34,0.05813,926,1.58310,58493
13,kantica,32,0.05471,958,1.63780,58493
14,alexlry,31,0.05300,989,1.69080,58493
15,breath-co2,30,0.05129,1019,1.74209,58493
16,ginobiliwang,30,0.05129,1049,1.79338,58493
17,shinebayar-g,30,0.05129,1079,1.84467,58493
18,amitdhawan,29,0.04958,1108,1.89424,58493
19,bungoume,29,0.04958,1137,1.94382,58493
20,BentCoder,28,0.04787,1165,1.99169,58493
21,hassaku,28,0.04787,1193,2.03956,58493
22,sxd,28,0.04787,1221,2.08743,58493
23,ahrtr,27,0.04616,1248,2.13359,58493
24,GLStephen,27,0.04616,1275,2.17975,58493
25,huanggze,27,0.04616,1302,2.22591,58493
26,newtoncorp,27,0.04616,1329,2.27207,58493
27,tatsu-yam,27,0.04616,1356,2.31823,58493
28,jenningsloy318,26,0.04445,1382,2.36268,58493
29,dmnfortytwo,25,0.04274,1407,2.40542,58493
30,jeremywu0127,25,0.04274,1432,2.44816,58493
31,keyolk,25,0.04274,1457,2.49090,58493
32,AkashKrDutta,24,0.04103,1481,2.53193,58493
33,t-osakada,24,0.04103,1505,2.57296,58493
34,clamoriniere,23,0.03932,1528,2.61228,58493
35,Hearen,23,0.03932,1551,2.65160,58493
36,jamesgoodhouse,23,0.03932,1574,2.69092,58493
37,kaizen1,23,0.03932,1597,2.73024,58493
38,itiut,22,0.03761,1619,2.76785,58493
39,jitran,22,0.03761,1641,2.80546,58493
40,Theoooooo,22,0.03761,1663,2.84308,58493
41,golgoth31,21,0.03590,1684,2.87898,58493
42,scumola,21,0.03590,1705,2.91488,58493
43,aknapp,20,0.03419,1725,2.94907,58493
44,blaggacao,20,0.03419,1745,2.98326,58493
45,gitfool,20,0.03419,1765,3.01746,58493
46,Jackyjjc,20,0.03419,1785,3.05165,58493
47,jain108shubhamtbt,20,0.03419,1805,3.08584,58493
48,ksandrmatveyev,20,0.03419,1825,3.12003,58493
49,ZMMWMY,20,0.03419,1845,3.15422,58493
50,adamchainz,19,0.03248,1864,3.18671,58493
51,bcharboneauiherb,19,0.03248,1883,3.21919,58493
52,jbhilton11,19,0.03248,1902,3.25167,58493
53,shahbour,19,0.03248,1921,3.28415,58493
54,yonchin,19,0.03248,1940,3.31664,58493
55,zw963,19,0.03248,1959,3.34912,58493
56,aSquare14,18,0.03077,1977,3.37989,58493
57,dieend,18,0.03077,1995,3.41066,58493
58,dterror,18,0.03077,2013,3.44144,58493
59,llhhbc,18,0.03077,2031,3.47221,58493
60,rmacian,18,0.03077,2049,3.50298,58493
61,stevenjm,18,0.03077,2067,3.53376,58493
62,ValFadeev,18,0.03077,2085,3.56453,58493
63,wst-casd,18,0.03077,2103,3.59530,58493
64,Yanson,18,0.03077,2121,3.62607,58493
65,2x-bullet-time,17,0.02906,2138,3.65514,58493
66,ashishtilara,17,0.02906,2155,3.68420,58493
67,JiHyunSong,17,0.02906,2172,3.71326,58493
68,novegit,17,0.02906,2189,3.74233,58493
69,vichargrave,17,0.02906,2206,3.77139,58493
70,yechanpark,17,0.02906,2223,3.80045,58493
71,alitoufighi,16,0.02735,2239,3.82781,58493
72,brava-vinh,16,0.02735,2255,3.85516,58493
73,himmatb,16,0.02735,2271,3.88252,58493
74,jesk78,16,0.02735,2287,3.90987,58493
75,kimutansk,16,0.02735,2303,3.93722,58493
76,mitchellmaler,16,0.02735,2319,3.96458,58493
77,pensz,16,0.02735,2335,3.99193,58493
78,scottbuettner,16,0.02735,2351,4.01928,58493
79,TaLoN1x,16,0.02735,2367,4.04664,58493
80,yantang-msft,16,0.02735,2383,4.07399,58493
81,yaron-idan,16,0.02735,2399,4.10135,58493
82,yui-knk,16,0.02735,2415,4.12870,58493
83,alexfridlyand,15,0.02564,2430,4.15434,58493
84,atkinsj,15,0.02564,2445,4.17999,58493
85,cbh34680,15,0.02564,2460,4.20563,58493
86,felixzh2015,15,0.02564,2475,4.23128,58493
87,hdiass,15,0.02564,2490,4.25692,58493
88,jespersoderlund,15,0.02564,2505,4.28256,58493
89,kevinkirkup,15,0.02564,2520,4.30821,58493
90,Misterhex,15,0.02564,2535,4.33385,58493
91,sasezaki,15,0.02564,2550,4.35950,58493
92,sergeyarl,15,0.02564,2565,4.38514,58493
93,taoeffect,15,0.02564,2580,4.41078,58493
94,tomohisaota,15,0.02564,2595,4.43643,58493
95,trstringer,15,0.02564,2610,4.46207,58493
96,tsgan,15,0.02564,2625,4.48772,58493
97,xncbf,15,0.02564,2640,4.51336,58493
98,yyamano,15,0.02564,2655,4.53900,58493
99,andbuitra,14,0.02393,2669,4.56294,58493
100,attila123,14,0.02393,2683,4.58687,58493
101,bragi92,14,0.02393,2697,4.61081,58493
102,dwoo4dwoo,14,0.02393,2711,4.63474,58493
103,gabe-sorensen,14,0.02393,2725,4.65868,58493
104,gorilych,14,0.02393,2739,4.68261,58493
105,hjet,14,0.02393,2753,4.70655,58493
106,jlpettersson,14,0.02393,2767,4.73048,58493
107,jurgenhaas,14,0.02393,2781,4.75442,58493
108,phiremande,14,0.02393,2795,4.77835,58493
109,spatialvlad,14,0.02393,2809,4.80228,58493
110,wbchn,14,0.02393,2823,4.82622,58493
111,wkruse,14,0.02393,2837,4.85015,58493
112,yubobo,14,0.02393,2851,4.87409,58493
113,abecciu,13,0.02222,2864,4.89631,58493
114,amyth,13,0.02222,2877,4.91854,58493
115,arabustams,13,0.02222,2890,4.94076,58493
116,bat9r,13,0.02222,2903,4.96299,58493
117,cosmok,13,0.02222,2916,4.98521,58493
118,fpytloun,13,0.02222,2929,5.00744,58493
119,FraLarghi,13,0.02222,2942,5.02966,58493
120,linxuanwei,13,0.02222,2955,5.05189,58493
121,mseka1,13,0.02222,2968,5.07411,58493
122,varun-da,13,0.02222,2981,5.09634,58493
123,warmfusion,13,0.02222,2994,5.11856,58493
124,zohararad,13,0.02222,3007,5.14079,58493
125,BananaWanted,12,0.02052,3019,5.16130,58493
126,berlincount,12,0.02052,3031,5.18182,58493
127,betazep,12,0.02052,3043,5.20233,58493
128,Brandl,12,0.02052,3055,5.22285,58493
129,candlerb,12,0.02052,3067,5.24336,58493
130,danmx,12,0.02052,3079,5.26388,58493
131,dmamalis,12,0.02052,3091,5.28439,58493
132,donato,12,0.02052,3103,5.30491,58493
133,ecristea,12,0.02052,3115,5.32542,58493
134,elafontaine,12,0.02052,3127,5.34594,58493
135,fhoy,12,0.02052,3139,5.36645,58493
136,gaui,12,0.02052,3151,5.38697,58493
137,gcs-github,12,0.02052,3163,5.40748,58493
138,girgen,12,0.02052,3175,5.42800,58493
139,HatsuneMiku3939,12,0.02052,3187,5.44852,58493
140,JayTeli,12,0.02052,3199,5.46903,58493
141,koooge,12,0.02052,3211,5.48955,58493
142,mahdi-asadpour-rr,12,0.02052,3223,5.51006,58493
143,marktheunissen,12,0.02052,3235,5.53058,58493
144,mitsos1os,12,0.02052,3247,5.55109,58493
145,osimmasgard,12,0.02052,3259,5.57161,58493
146,Ponyboy47,12,0.02052,3271,5.59212,58493
147,saki7,12,0.02052,3283,5.61264,58493
148,scrwr,12,0.02052,3295,5.63315,58493
149,shoichikaji,12,0.02052,3307,5.65367,58493
150,summerwind,12,0.02052,3319,5.67418,58493
151,tantra35,12,0.02052,3331,5.69470,58493
152,tbrosman,12,0.02052,3343,5.71521,58493
153,ted222,12,0.02052,3355,5.73573,58493
154,vanke-renzhe,12,0.02052,3367,5.75624,58493
155,vlvasilev,12,0.02052,3379,5.77676,58493
156,alanyee,11,0.01881,3390,5.79557,58493
157,aldnav,11,0.01881,3401,5.81437,58493
158,benwh,11,0.01881,3412,5.83318,58493
159,flowl,11,0.01881,3423,5.85198,58493
160,hkailantzis,11,0.01881,3434,5.87079,58493
161,kakalo24,11,0.01881,3445,5.88959,58493
162,LanceNorskog,11,0.01881,3456,5.90840,58493
163,naiduarvind,11,0.01881,3467,5.92720,58493
164,pauldavidgilligan,11,0.01881,3478,5.94601,58493
165,quasipedia,11,0.01881,3489,5.96482,58493
166,reversi-fun,11,0.01881,3500,5.98362,58493
167,rolele,11,0.01881,3511,6.00243,58493
168,salekseev,11,0.01881,3522,6.02123,58493
169,shawnbutts,11,0.01881,3533,6.04004,58493
170,sphansekar-cci,11,0.01881,3544,6.05884,58493
171,szhem,11,0.01881,3555,6.07765,58493
172,talonx,11,0.01881,3566,6.09646,58493
173,tanaka51-jp,11,0.01881,3577,6.11526,58493
174,TetianaKuziaieva,11,0.01881,3588,6.13407,58493
175,tszming,11,0.01881,3599,6.15287,58493
176,vixns,11,0.01881,3610,6.17168,58493
177,zerthimon,11,0.01881,3621,6.19048,58493
178,arrowfeng,10,0.01710,3631,6.20758,58493
179,baepiff,10,0.01710,3641,6.22468,58493
180,cherrot,10,0.01710,3651,6.24177,58493
181,chrisrecalis,10,0.01710,3661,6.25887,58493
182,cve-reporting,10,0.01710,3671,6.27596,58493
183,darek-dymek-i,10,0.01710,3681,6.29306,58493
184,digikin,10,0.01710,3691,6.31016,58493
185,ephemeralsnow,10,0.01710,3701,6.32725,58493
186,Git-Rajkumar,10,0.01710,3711,6.34435,58493
187,iShiBin,10,0.01710,3721,6.36144,58493
188,IssuehuntBot,10,0.01710,3731,6.37854,58493
189,jakeswenson,10,0.01710,3741,6.39564,58493
190,JavaCS3,10,0.01710,3751,6.41273,58493
191,kikumoto,10,0.01710,3761,6.42983,58493
192,konstantin-kornienko,10,0.01710,3771,6.44693,58493
193,larsf,10,0.01710,3781,6.46402,58493
194,Lawouach,10,0.01710,3791,6.48112,58493
195,ljt2016,10,0.01710,3801,6.49821,58493
196,markuman,10,0.01710,3811,6.51531,58493
197,MasayukiKiyota,10,0.01710,3821,6.53241,58493
198,mchesler,10,0.01710,3831,6.54950,58493
199,mhf-ir,10,0.01710,3841,6.56660,58493
200,moleskin-smile,10,0.01710,3851,6.58369,58493
201,pirasakat,10,0.01710,3861,6.60079,58493
202,pokehanai,10,0.01710,3871,6.61789,58493
203,sandstrom,10,0.01710,3881,6.63498,58493
204,shivpathak,10,0.01710,3891,6.65208,58493
205,shou10152208,10,0.01710,3901,6.66917,58493
206,static-max,10,0.01710,3911,6.68627,58493
207,tomity,10,0.01710,3921,6.70337,58493
208,torbjorn2000,10,0.01710,3931,6.72046,58493
209,wittenst,10,0.01710,3941,6.73756,58493
210,wtan825,10,0.01710,3951,6.75465,58493
211,yalamber,10,0.01710,3961,6.77175,58493
212,adrianlzt,9,0.01539,3970,6.78714,58493
213,bai,9,0.01539,3979,6.80252,58493
214,bobykus31,9,0.01539,3988,6.81791,58493
215,ceecko,9,0.01539,3997,6.83330,58493
216,elfring,9,0.01539,4006,6.84868,58493
217,fgreinacher,9,0.01539,4015,6.86407,58493
218,fragtom,9,0.01539,4024,6.87946,58493
219,GaoyangWang,9,0.01539,4033,6.89484,58493
220,garysmith-github,9,0.01539,4042,6.91023,58493
221,hassanfarid,9,0.01539,4051,6.92562,58493
222,jaisharma0009,9,0.01539,4060,6.94100,58493
223,jiaqianjing,9,0.01539,4069,6.95639,58493
224,joechromo,9,0.01539,4078,6.97177,58493
225,jomach,9,0.01539,4087,6.98716,58493
226,jstaffans,9,0.01539,4096,7.00255,58493
227,keithjohnhowe,9,0.01539,4105,7.01793,58493
228,kiddingl,9,0.01539,4114,7.03332,58493
229,kmotrebski,9,0.01539,4123,7.04871,58493
230,langzi-zmg,9,0.01539,4132,7.06409,58493
231,liujiawinds,9,0.01539,4141,7.07948,58493
232,maglun2,9,0.01539,4150,7.09487,58493
233,mazerty,9,0.01539,4159,7.11025,58493
234,mbolek,9,0.01539,4168,7.12564,58493
235,navono,9,0.01539,4177,7.14103,58493
236,ogibayashi,9,0.01539,4186,7.15641,58493
237,petergillardmoss,9,0.01539,4195,7.17180,58493
238,rahulwa,9,0.01539,4204,7.18718,58493
239,Renz2018,9,0.01539,4213,7.20257,58493
240,scuzhanglei,9,0.01539,4222,7.21796,58493
241,SilverDragon135,9,0.01539,4231,7.23334,58493
242,simonasr,9,0.01539,4240,7.24873,58493
243,singhravi1,9,0.01539,4249,7.26412,58493
244,sivaparams,9,0.01539,4258,7.27950,58493
245,tchelovilar,9,0.01539,4267,7.29489,58493
246,Telmo,9,0.01539,4276,7.31028,58493
247,TheRealDwright,9,0.01539,4285,7.32566,58493
248,travail,9,0.01539,4294,7.34105,58493
249,Verhaeg,9,0.01539,4303,7.35644,58493
250,xxwassyxx,9,0.01539,4312,7.37182,58493
251,yohei1126,9,0.01539,4321,7.38721,58493
252,yusufcan141,9,0.01539,4330,7.40260,58493
253,zette,9,0.01539,4339,7.41798,58493
254,zhulinwei,9,0.01539,4348,7.43337,58493
255,zozzz,9,0.01539,4357,7.44875,58493
256,aeber,8,0.01368,4365,7.46243,58493
257,alikhil,8,0.01368,4373,7.47611,58493
258,apollo13,8,0.01368,4381,7.48979,58493
259,ayenter,8,0.01368,4389,7.50346,58493
260,benkap,8,0.01368,4397,7.51714,58493
261,bizlevel,8,0.01368,4405,7.53082,58493
262,cvuillemez,8,0.01368,4413,7.54449,58493
263,DarrienG,8,0.01368,4421,7.55817,58493
264,dgarros,8,0.01368,4429,7.57185,58493
265,dmgcodevil,8,0.01368,4437,7.58552,58493
266,dsbrng25b,8,0.01368,4445,7.59920,58493
267,eldargab,8,0.01368,4453,7.61288,58493
268,ferminromero,8,0.01368,4461,7.62655,58493
269,flurreN,8,0.01368,4469,7.64023,58493
270,fmax,8,0.01368,4477,7.65391,58493
271,fogine,8,0.01368,4485,7.66758,58493
272,Gabriel1688,8,0.01368,4493,7.68126,58493
273,ghicks-rmn,8,0.01368,4501,7.69494,58493
274,giammy2290,8,0.01368,4509,7.70861,58493
275,hlakshmi,8,0.01368,4517,7.72229,58493
276,hobbsh,8,0.01368,4525,7.73597,58493
277,hochdorf,8,0.01368,4533,7.74965,58493
278,homer6,8,0.01368,4541,7.76332,58493
279,ixai,8,0.01368,4549,7.77700,58493
280,jgehrcke,8,0.01368,4557,7.79068,58493
281,Jimflip,8,0.01368,4565,7.80435,58493
282,jkschulz,8,0.01368,4573,7.81803,58493
283,jpraet,8,0.01368,4581,7.83171,58493
284,keperry,8,0.01368,4589,7.84538,58493
285,kkniffin,8,0.01368,4597,7.85906,58493
286,knqyf263,8,0.01368,4605,7.87274,58493
287,lktslionel,8,0.01368,4613,7.88641,58493
288,martin21,8,0.01368,4621,7.90009,58493
289,meggarr,8,0.01368,4629,7.91377,58493
290,mia-0032,8,0.01368,4637,7.92744,58493
291,mohitanchlia,8,0.01368,4645,7.94112,58493
292,mothershipper,8,0.01368,4653,7.95480,58493
293,musaprg,8,0.01368,4661,7.96847,58493
294,Nepoxx,8,0.01368,4669,7.98215,58493
295,ngiallelis,8,0.01368,4677,7.99583,58493
296,NicholasK13,8,0.01368,4685,8.00951,58493
297,onet-git,8,0.01368,4693,8.02318,58493
298,ota42y,8,0.01368,4701,8.03686,58493
299,pangxudong,8,0.01368,4709,8.05054,58493
300,perchten,8,0.01368,4717,8.06421,58493
301,pitr,8,0.01368,4725,8.07789,58493
302,pjaitken,8,0.01368,4733,8.09157,58493
303,plinkable,8,0.01368,4741,8.10524,58493
304,Quarky9,8,0.01368,4749,8.11892,58493
305,rashidng,8,0.01368,4757,8.13260,58493
306,reinerRubin,8,0.01368,4765,8.14627,58493
307,rtartler-desres,8,0.01368,4773,8.15995,58493
308,ryanjjung,8,0.01368,4781,8.17363,58493
309,skizot722,8,0.01368,4789,8.18730,58493
310,stachdude,8,0.01368,4797,8.20098,58493
311,StevTheDev,8,0.01368,4805,8.21466,58493
312,svett,8,0.01368,4813,8.22834,58493
313,tako774,8,0.01368,4821,8.24201,58493
314,takumakanari,8,0.01368,4829,8.25569,58493
315,Tesseract242,8,0.01368,4837,8.26937,58493
316,thodquach,8,0.01368,4845,8.28304,58493
317,vaibhavt19,8,0.01368,4853,8.29672,58493
318,withsmilo,8,0.01368,4861,8.31040,58493
319,yugunji,8,0.01368,4869,8.32407,58493
320,advidi-alex,7,0.01197,4876,8.33604,58493
321,amagnus,7,0.01197,4883,8.34801,58493
322,andye2004,7,0.01197,4890,8.35997,58493
323,ashutoshdhundhara,7,0.01197,4897,8.37194,58493
324,bamb00,7,0.01197,4904,8.38391,58493
325,Barbazoo,7,0.01197,4911,8.39588,58493
326,bhperry,7,0.01197,4918,8.40784,58493
327,cabiad,7,0.01197,4925,8.41981,58493
328,cccdemon,7,0.01197,4932,8.43178,58493
329,comtef,7,0.01197,4939,8.44375,58493
330,datawrangl3r,7,0.01197,4946,8.45571,58493
331,disigma,7,0.01197,4953,8.46768,58493
332,dlbarduzzi,7,0.01197,4960,8.47965,58493
333,dominique-pfister,7,0.01197,4967,8.49161,58493
334,EricFortin,7,0.01197,4974,8.50358,58493
335,f0,7,0.01197,4981,8.51555,58493
336,five-iron,7,0.01197,4988,8.52752,58493
337,HackToHell,7,0.01197,4995,8.53948,58493
338,HansMeijer-AvidentIT,7,0.01197,5002,8.55145,58493
339,hari9973,7,0.01197,5009,8.56342,58493
340,heidemn,7,0.01197,5016,8.57539,58493
341,henrich,7,0.01197,5023,8.58735,58493
342,herby,7,0.01197,5030,8.59932,58493
343,hyserver,7,0.01197,5037,8.61129,58493
344,icio,7,0.01197,5044,8.62325,58493
345,intelliguy,7,0.01197,5051,8.63522,58493
346,iyagi15,7,0.01197,5058,8.64719,58493
347,jaywayjayway,7,0.01197,5065,8.65916,58493
348,jeesim2,7,0.01197,5072,8.67112,58493
349,jklap,7,0.01197,5079,8.68309,58493
350,JohnStarich,7,0.01197,5086,8.69506,58493
351,kenhys,7,0.01197,5093,8.70702,58493
352,komeda-shinji,7,0.01197,5100,8.71899,58493
353,kpmbro,7,0.01197,5107,8.73096,58493
354,kumaravel29,7,0.01197,5114,8.74293,58493
355,lht,7,0.01197,5121,8.75489,58493
356,mariomarin,7,0.01197,5128,8.76686,58493
357,megamorf,7,0.01197,5135,8.77883,58493
358,michaelcrunch,7,0.01197,5142,8.79080,58493
359,mightwork,7,0.01197,5149,8.80276,58493
360,MingqingLi,7,0.01197,5156,8.81473,58493
361,MOZGIII,7,0.01197,5163,8.82670,58493
362,mvernimmen,7,0.01197,5170,8.83866,58493
363,nreddy67,7,0.01197,5177,8.85063,58493
364,nsaud01,7,0.01197,5184,8.86260,58493
365,Nuru,7,0.01197,5191,8.87457,58493
366,phaothu,7,0.01197,5198,8.88653,58493
367,pyama86,7,0.01197,5205,8.89850,58493
368,sachintaware,7,0.01197,5212,8.91047,58493
369,sawanoboly,7,0.01197,5219,8.92244,58493
370,shyouhei,7,0.01197,5226,8.93440,58493
371,Sikwan,7,0.01197,5233,8.94637,58493
372,snowjunkie,7,0.01197,5240,8.95834,58493
373,soultemple,7,0.01197,5247,8.97030,58493
374,soulware,7,0.01197,5254,8.98227,58493
375,spackle0,7,0.01197,5261,8.99424,58493
376,stanhu,7,0.01197,5268,9.00621,58493
377,summer0nguyen,7,0.01197,5275,9.01817,58493
378,sysword,7,0.01197,5282,9.03014,58493
379,takawitter,7,0.01197,5289,9.04211,58493
380,talawahtech,7,0.01197,5296,9.05407,58493
381,Thoro,7,0.01197,5303,9.06604,58493
382,tkawachi,7,0.01197,5310,9.07801,58493
383,tomohiro-n,7,0.01197,5317,9.08998,58493
384,tomschlenkhoff,7,0.01197,5324,9.10194,58493
385,toyama-h,7,0.01197,5331,9.11391,58493
386,UijunLee,7,0.01197,5338,9.12588,58493
387,venkat-rafay,7,0.01197,5345,9.13785,58493
388,VinkDong,7,0.01197,5352,9.14981,58493
389,viztastic,7,0.01197,5359,9.16178,58493
390,wangzhuzhen,7,0.01197,5366,9.17375,58493
391,wd,7,0.01197,5373,9.18571,58493
392,wlbhiro,7,0.01197,5380,9.19768,58493
393,yangsongx,7,0.01197,5387,9.20965,58493
394,ymattw,7,0.01197,5394,9.22162,58493
395,yteraoka,7,0.01197,5401,9.23358,58493
396,yurano,7,0.01197,5408,9.24555,58493
397,zhigang,7,0.01197,5415,9.25752,58493
398,zlwu,7,0.01197,5422,9.26949,58493
399,zopanix,7,0.01197,5429,9.28145,58493
400,27bharath,6,0.01026,5435,9.29171,58493
401,acarsercan,6,0.01026,5441,9.30197,58493
402,adinaclaudia,6,0.01026,5447,9.31223,58493
403,akihiro17,6,0.01026,5453,9.32248,58493
404,alexandersm,6,0.01026,5459,9.33274,58493
405,anandsinghkunwar,6,0.01026,5465,9.34300,58493
406,ananth07reddy,6,0.01026,5471,9.35326,58493
407,aniketoss,6,0.01026,5477,9.36351,58493
408,antoninblanc,6,0.01026,5483,9.37377,58493
409,apigirl,6,0.01026,5489,9.38403,58493
410,azman0101,6,0.01026,5495,9.39429,58493
411,bayaro,6,0.01026,5501,9.40454,58493
412,BDuelz,6,0.01026,5507,9.41480,58493
413,beatlejuse,6,0.01026,5513,9.42506,58493
414,bhaveshmodiatekaplus,6,0.01026,5519,9.43532,58493
415,bnyu,6,0.01026,5525,9.44557,58493
416,calinah,6,0.01026,5531,9.45583,58493
417,capt-abhi,6,0.01026,5537,9.46609,58493
418,cpedro,6,0.01026,5543,9.47635,58493
419,ctyjrsy,6,0.01026,5549,9.48661,58493
420,DanKans,6,0.01026,5555,9.49686,58493
421,dbluxo,6,0.01026,5561,9.50712,58493
422,dennusb,6,0.01026,5567,9.51738,58493
423,dennyzhang,6,0.01026,5573,9.52764,58493
424,dperetti,6,0.01026,5579,9.53789,58493
425,dpgaspar,6,0.01026,5585,9.54815,58493
426,dshmatov,6,0.01026,5591,9.55841,58493
427,dusty73,6,0.01026,5597,9.56867,58493
428,eddgrant,6,0.01026,5603,9.57892,58493
429,edvakf,6,0.01026,5609,9.58918,58493
430,eino-makitalo,6,0.01026,5615,9.59944,58493
431,elelement,6,0.01026,5621,9.60970,58493
432,Erouan50,6,0.01026,5627,9.61995,58493
433,eyalzek,6,0.01026,5633,9.63021,58493
434,fenicks,6,0.01026,5639,9.64047,58493
435,foxracle,6,0.01026,5645,9.65073,58493
436,fullee,6,0.01026,5651,9.66099,58493
437,g3kr,6,0.01026,5657,9.67124,58493
438,gajus,6,0.01026,5663,9.68150,58493
439,gamer22026,6,0.01026,5669,9.69176,58493
440,gauravcdac,6,0.01026,5675,9.70202,58493
441,geek876,6,0.01026,5681,9.71227,58493
442,gregsymons,6,0.01026,5687,9.72253,58493
443,gunyarakun,6,0.01026,5693,9.73279,58493
444,heartrobotninja,6,0.01026,5699,9.74305,58493
445,hellobhaskar,6,0.01026,5705,9.75330,58493
446,Imunhatep,6,0.01026,5711,9.76356,58493
447,james-crowley,6,0.01026,5717,9.77382,58493
448,jiuchongxiao,6,0.01026,5723,9.78408,58493
449,joshuacox,6,0.01026,5729,9.79433,58493
450,joshughes,6,0.01026,5735,9.80459,58493
451,jottos,6,0.01026,5741,9.81485,58493
452,konstantin-kornienko-epam,6,0.01026,5747,9.82511,58493
453,krystiannowak,6,0.01026,5753,9.83536,58493
454,kvborodin,6,0.01026,5759,9.84562,58493
455,KYannick,6,0.01026,5765,9.85588,58493
456,m15o,6,0.01026,5771,9.86614,58493
457,macavity23,6,0.01026,5777,9.87640,58493
458,macdjord,6,0.01026,5783,9.88665,58493
459,martinhynar,6,0.01026,5789,9.89691,58493
460,masato25,6,0.01026,5795,9.90717,58493
461,mcarriere-seedbox,6,0.01026,5801,9.91743,58493
462,mdalley,6,0.01026,5807,9.92768,58493
463,megamind79,6,0.01026,5813,9.93794,58493
464,michaeltravisuk,6,0.01026,5819,9.94820,58493
465,miguelortize,6,0.01026,5825,9.95846,58493
466,mleneveut,6,0.01026,5831,9.96871,58493
467,mpergament,6,0.01026,5837,9.97897,58493
468,mredivo,6,0.01026,5843,9.98923,58493
469,mxk1235,6,0.01026,5849,9.99949,58493
470,MyOldSkyGrandfather,6,0.01026,5855,10.00974,58493
471,naumanrana,6,0.01026,5861,10.02000,58493
472,nikhilkakade2108,6,0.01026,5867,10.03026,58493
473,nikinaydenov,6,0.01026,5873,10.04052,58493
474,nikolaiderzhak,6,0.01026,5879,10.05078,58493
475,nmaludy,6,0.01026,5885,10.06103,58493
476,okumin,6,0.01026,5891,10.07129,58493
477,parishs73,6,0.01026,5897,10.08155,58493
478,paulqi,6,0.01026,5903,10.09181,58493
479,penuel-leo,6,0.01026,5909,10.10206,58493
480,perk,6,0.01026,5915,10.11232,58493
481,PhilGrayson,6,0.01026,5921,10.12258,58493
482,pydolan,6,0.01026,5927,10.13284,58493
483,rahuldahiya,6,0.01026,5933,10.14309,58493
484,Raznak,6,0.01026,5939,10.15335,58493
485,sam701,6,0.01026,5945,10.16361,58493
486,SamirFarhat,6,0.01026,5951,10.17387,58493
487,sandstonewater,6,0.01026,5957,10.18412,58493
488,sgessa,6,0.01026,5963,10.19438,58493
489,s-kostyaev,6,0.01026,5969,10.20464,58493
490,sonofachamp,6,0.01026,5975,10.21490,58493
491,soylent,6,0.01026,5981,10.22516,58493
492,spacewander,6,0.01026,5987,10.23541,58493
493,Spycomb,6,0.01026,5993,10.24567,58493
494,sugi,6,0.01026,5999,10.25593,58493
495,tbe,6,0.01026,6005,10.26619,58493
496,TheConnMan,6,0.01026,6011,10.27644,58493
497,therealgambo,6,0.01026,6017,10.28670,58493
498,tjamet,6,0.01026,6023,10.29696,58493
499,tjratch,6,0.01026,6029,10.30722,58493
500,tkimura,6,0.01026,6035,10.31747,58493
501,toan-hf,6,0.01026,6041,10.32773,58493
502,tobiasmuehl,6,0.01026,6047,10.33799,58493
503,turbotankist,6,0.01026,6053,10.34825,58493
504,userguy,6,0.01026,6059,10.35850,58493
505,wjzhangcsu,6,0.01026,6065,10.36876,58493
506,xanonid,6,0.01026,6071,10.37902,58493
507,yangmillstheory,6,0.01026,6077,10.38928,58493
508,yatirdagan,6,0.01026,6083,10.39953,58493
509,YerisAntonio,6,0.01026,6089,10.40979,58493
510,zephinzer,6,0.01026,6095,10.42005,58493
511,zhangchao2015,6,0.01026,6101,10.43031,58493
512,zoneofjin,6,0.01026,6107,10.44057,58493
513,zs787,6,0.01026,6113,10.45082,58493
514,010akv,5,0.00855,6118,10.45937,58493
515,2n3906,5,0.00855,6123,10.46792,58493
516,97-109-107,5,0.00855,6128,10.47647,58493
517,abh,5,0.00855,6133,10.48502,58493
518,AdrienKuhn,5,0.00855,6138,10.49356,58493
519,aeoluswing,5,0.00855,6143,10.50211,58493
520,ajthenewguy,5,0.00855,6148,10.51066,58493
521,alanchchen,5,0.00855,6153,10.51921,58493
522,AlenJun,5,0.00855,6158,10.52776,58493
523,AlexRiedler,5,0.00855,6163,10.53630,58493
524,Allenhaozi,5,0.00855,6168,10.54485,58493
525,altenhof,5,0.00855,6173,10.55340,58493
526,alterx,5,0.00855,6178,10.56195,58493
527,amdelamar,5,0.00855,6183,10.57050,58493
528,ameyrk18,5,0.00855,6188,10.57904,58493
529,aplsms,5,0.00855,6193,10.58759,58493
530,Apple-a-Day,5,0.00855,6198,10.59614,58493
531,arjun921,5,0.00855,6203,10.60469,58493
532,artempronevskiy,5,0.00855,6208,10.61324,58493
533,auxbuss,5,0.00855,6213,10.62178,58493
534,barrachri,5,0.00855,6218,10.63033,58493
535,bhavsi,5,0.00855,6223,10.63888,58493
536,bokutin,5,0.00855,6228,10.64743,58493
537,bortok,5,0.00855,6233,10.65598,58493
538,boynet,5,0.00855,6238,10.66452,58493
539,brycefisher,5,0.00855,6243,10.67307,58493
540,c0ze,5,0.00855,6248,10.68162,58493
541,canertosuner,5,0.00855,6253,10.69017,58493
542,cdaringe,5,0.00855,6258,10.69872,58493
543,ChipmunkV,5,0.00855,6263,10.70726,58493
544,ChSch3000,5,0.00855,6268,10.71581,58493
545,cite,5,0.00855,6273,10.72436,58493
546,cjcc1,5,0.00855,6278,10.73291,58493
547,codeout,5,0.00855,6283,10.74146,58493
548,crazw,5,0.00855,6288,10.75000,58493
549,damianprzygodzki,5,0.00855,6293,10.75855,58493
550,danielzepp,5,0.00855,6298,10.76710,58493
551,darashenka,5,0.00855,6303,10.77565,58493
552,davgibney1,5,0.00855,6308,10.78420,58493
553,davidwtf,5,0.00855,6313,10.79274,58493
554,discostur,5,0.00855,6318,10.80129,58493
555,ducky-hong,5,0.00855,6323,10.80984,58493
556,eldadvcita,5,0.00855,6328,10.81839,58493
557,elinshu,5,0.00855,6333,10.82694,58493
558,fahimeh2010,5,0.00855,6338,10.83548,58493
559,fengyingjie2018,5,0.00855,6343,10.84403,58493
560,fevlake,5,0.00855,6348,10.85258,58493
561,fishg,5,0.00855,6353,10.86113,58493
562,Fl0rianH,5,0.00855,6358,10.86968,58493
563,floriankoch,5,0.00855,6363,10.87822,58493
564,f-ueno,5,0.00855,6368,10.88677,58493
565,gabfl,5,0.00855,6373,10.89532,58493
566,gaogj,5,0.00855,6378,10.90387,58493
567,ghostylee,5,0.00855,6383,10.91242,58493
568,gitvc,5,0.00855,6388,10.92096,58493
569,gjobin,5,0.00855,6393,10.92951,58493
570,goakley,5,0.00855,6398,10.93806,58493
571,HarishHothi,5,0.00855,6403,10.94661,58493
572,hetile-ssense,5,0.00855,6408,10.95516,58493
573,hfinucane,5,0.00855,6413,10.96371,58493
574,hiro-su,5,0.00855,6418,10.97225,58493
575,hlx98007,5,0.00855,6423,10.98080,58493
576,holysugar,5,0.00855,6428,10.98935,58493
577,hongbk,5,0.00855,6433,10.99790,58493
578,Horkyze,5,0.00855,6438,11.00645,58493
579,idohalevi,5,0.00855,6443,11.01499,58493
580,ierceg,5,0.00855,6448,11.02354,58493
581,iktiar,5,0.00855,6453,11.03209,58493
582,imaemo,5,0.00855,6458,11.04064,58493
583,itoffshore,5,0.00855,6463,11.04919,58493
584,iwasakims,5,0.00855,6468,11.05773,58493
585,iwilltry42,5,0.00855,6473,11.06628,58493
586,jalalahmad,5,0.00855,6478,11.07483,58493
587,jamesweb1,5,0.00855,6483,11.08338,58493
588,JanKowalik,5,0.00855,6488,11.09193,58493
589,jaygorrell,5,0.00855,6493,11.10047,58493
590,jedisct1,5,0.00855,6498,11.10902,58493
591,jiangfengbing,5,0.00855,6503,11.11757,58493
592,jmoseley,5,0.00855,6508,11.12612,58493
593,JoeOrtiz,5,0.00855,6513,11.13467,58493
594,joerx,5,0.00855,6518,11.14321,58493
595,johnnason,5,0.00855,6523,11.15176,58493
596,jonathanjuursema,5,0.00855,6528,11.16031,58493
597,Jonnymcc,5,0.00855,6533,11.16886,58493
598,Jorge-Rodriguez,5,0.00855,6538,11.17741,58493
599,josephsu,5,0.00855,6543,11.18595,58493
600,joshiggins,5,0.00855,6548,11.19450,58493
601,jpackagejasonc,5,0.00855,6553,11.20305,58493
602,judexzhu,5,0.00855,6558,11.21160,58493
603,jyuan,5,0.00855,6563,11.22015,58493
604,Kanshiroron,5,0.00855,6568,11.22869,58493
605,katriel,5,0.00855,6573,11.23724,58493
606,katrielt,5,0.00855,6578,11.24579,58493
607,Kesslerb2,5,0.00855,6583,11.25434,58493
608,kgrodzicki,5,0.00855,6588,11.26289,58493
609,khetman,5,0.00855,6593,11.27143,58493
610,khilman,5,0.00855,6598,11.27998,58493
611,krithiga90,5,0.00855,6603,11.28853,58493
612,Kuckkuck,5,0.00855,6608,11.29708,58493
613,KunalAggarwal,5,0.00855,6613,11.30563,58493
614,KunalArora,5,0.00855,6618,11.31417,58493
615,L3n41c,5,0.00855,6623,11.32272,58493
616,LarryLo,5,0.00855,6628,11.33127,58493
617,LarsKumbier,5,0.00855,6633,11.33982,58493
618,Lavakush7,5,0.00855,6638,11.34837,58493
619,lee2014,5,0.00855,6643,11.35691,58493
620,liutao6869,5,0.00855,6648,11.36546,58493
621,lp060,5,0.00855,6653,11.37401,58493
622,lw8008,5,0.00855,6658,11.38256,58493
623,macgahe,5,0.00855,6663,11.39111,58493
624,majst01,5,0.00855,6668,11.39965,58493
625,manicole,5,0.00855,6673,11.40820,58493
626,mansinahar,5,0.00855,6678,11.41675,58493
627,marcofranssen,5,0.00855,6683,11.42530,58493
628,marcuslindfeldt,5,0.00855,6688,11.43385,58493
629,markokostovski,5,0.00855,6693,11.44239,58493
630,marqc,5,0.00855,6698,11.45094,58493
631,masaomoc,5,0.00855,6703,11.45949,58493
632,matiji66,5,0.00855,6708,11.46804,58493
633,MattiDeGrauwe,5,0.00855,6713,11.47659,58493
634,mikkohoo,5,0.00855,6718,11.48513,58493
635,m-mizutani,5,0.00855,6723,11.49368,58493
636,mpas,5,0.00855,6728,11.50223,58493
637,mpucholblasco,5,0.00855,6733,11.51078,58493
638,MrMMorris,5,0.00855,6738,11.51933,58493
639,mzp,5,0.00855,6743,11.52788,58493
640,Nabilliban14,5,0.00855,6748,11.53642,58493
641,naveennadhv,5,0.00855,6753,11.54497,58493
642,neurogenesis,5,0.00855,6758,11.55352,58493
643,nguyenvulong,5,0.00855,6763,11.56207,58493
644,nickchang,5,0.00855,6768,11.57062,58493
645,nicosto,5,0.00855,6773,11.57916,58493
646,ninja-,5,0.00855,6778,11.58771,58493
647,NixM0nk3y,5,0.00855,6783,11.59626,58493
648,ntavares,5,0.00855,6788,11.60481,58493
649,nullkarma,5,0.00855,6793,11.61336,58493
650,opklnm102,5,0.00855,6798,11.62190,58493
651,Oscil8,5,0.00855,6803,11.63045,58493
652,osela,5,0.00855,6808,11.63900,58493
653,panage,5,0.00855,6813,11.64755,58493
654,pankajtalk,5,0.00855,6818,11.65610,58493
655,Ping-GAO,5,0.00855,6823,11.66464,58493
656,raihanhbh,5,0.00855,6828,11.67319,58493
657,rameshVeeramani,5,0.00855,6833,11.68174,58493
658,randude,5,0.00855,6838,11.69029,58493
659,rdumi7ru,5,0.00855,6843,11.69884,58493
660,reidrac,5,0.00855,6848,11.70738,58493
661,salty-g,5,0.00855,6853,11.71593,58493
662,sathishkumar64,5,0.00855,6858,11.72448,58493
663,schmidtjohannes,5,0.00855,6863,11.73303,58493
664,sevensees,5,0.00855,6868,11.74158,58493
665,sharmmoh1983,5,0.00855,6873,11.75012,58493
666,shunwen,5,0.00855,6878,11.75867,58493
667,singhjagmohan1000,5,0.00855,6883,11.76722,58493
668,slimee,5,0.00855,6888,11.77577,58493
669,south37,5,0.00855,6893,11.78432,58493
670,Spazzy757,5,0.00855,6898,11.79286,58493
671,sriramana,5,0.00855,6903,11.80141,58493
672,s-shubh,5,0.00855,6908,11.80996,58493
673,sudeep-quantelai,5,0.00855,6913,11.81851,58493
674,Sunanda-S2,5,0.00855,6918,11.82706,58493
675,superdump,5,0.00855,6923,11.83560,58493
676,suupic,5,0.00855,6928,11.84415,58493
677,tanjunchen,5,0.00855,6933,11.85270,58493
678,tarokkk,5,0.00855,6938,11.86125,58493
679,tboothman,5,0.00855,6943,11.86980,58493
680,test-account-0,5,0.00855,6948,11.87834,58493
681,TheRealJoeLinux,5,0.00855,6953,11.88689,58493
682,thrift24,5,0.00855,6958,11.89544,58493
683,tomfitzhenry,5,0.00855,6963,11.90399,58493
684,tratch,5,0.00855,6968,11.91254,58493
685,tsuda7,5,0.00855,6973,11.92108,58493
686,vaseeharan,5,0.00855,6978,11.92963,58493
687,vide,5,0.00855,6983,11.93818,58493
688,WangMingJue,5,0.00855,6988,11.94673,58493
689,whaon,5,0.00855,6993,11.95528,58493
690,wsorenson,5,0.00855,6998,11.96382,58493
691,xdays,5,0.00855,7003,11.97237,58493
692,xPB12,5,0.00855,7008,11.98092,58493
693,xprom,5,0.00855,7013,11.98947,58493
694,yuxiaobo96,5,0.00855,7018,11.99802,58493
695,zenglian,5,0.00855,7023,12.00656,58493
696,abhishekkr,4,0.00684,7027,12.01340,58493
697,adalrsjr1,4,0.00684,7031,12.02024,58493
698,AdamVB,4,0.00684,7035,12.02708,58493
699,AdimUser,4,0.00684,7039,12.03392,58493
700,aiueo4u,4,0.00684,7043,12.04076,58493
701,AKoetsier,4,0.00684,7047,12.04760,58493
702,akrus,4,0.00684,7051,12.05443,58493
703,AlexHeylin,4,0.00684,7055,12.06127,58493
704,alter,4,0.00684,7059,12.06811,58493
705,althepcman,4,0.00684,7063,12.07495,58493
706,amarcionek,4,0.00684,7067,12.08179,58493
707,anhldbk,4,0.00684,7071,12.08863,58493
708,an-matviyevich,4,0.00684,7075,12.09546,58493
709,arikfr,4,0.00684,7079,12.10230,58493
710,arodriguezdlc,4,0.00684,7083,12.10914,58493
711,artysidorenko,4,0.00684,7087,12.11598,58493
712,arunakalla,4,0.00684,7091,12.12282,58493
713,arunv707,4,0.00684,7095,12.12966,58493
714,asahu569,4,0.00684,7099,12.13649,58493
715,Ashraf-Hassan,4,0.00684,7103,12.14333,58493
716,athom,4,0.00684,7107,12.15017,58493
717,avii-wix,4,0.00684,7111,12.15701,58493
718,banderas07,4,0.00684,7115,12.16385,58493
719,bdentino,4,0.00684,7119,12.17069,58493
720,beckjim,4,0.00684,7123,12.17753,58493
721,benkiefer,4,0.00684,7127,12.18436,58493
722,bernie4321,4,0.00684,7131,12.19120,58493
723,bhargavamin,4,0.00684,7135,12.19804,58493
724,bivas6,4,0.00684,7139,12.20488,58493
725,bohyn,4,0.00684,7143,12.21172,58493
726,boldt,4,0.00684,7147,12.21856,58493
727,brianwwilliams,4,0.00684,7151,12.22539,58493
728,bshy522,4,0.00684,7155,12.23223,58493
729,byplayer,4,0.00684,7159,12.23907,58493
730,cassador,4,0.00684,7163,12.24591,58493
731,cde0,4,0.00684,7167,12.25275,58493
732,cgspohn,4,0.00684,7171,12.25959,58493
733,chaodhib,4,0.00684,7175,12.26643,58493
734,Charith32,4,0.00684,7179,12.27326,58493
735,Charles-WYC,4,0.00684,7183,12.28010,58493
736,chenjienn,4,0.00684,7187,12.28694,58493
737,chewi,4,0.00684,7191,12.29378,58493
738,chicofranchico,4,0.00684,7195,12.30062,58493
739,chkt,4,0.00684,7199,12.30746,58493
740,chorny,4,0.00684,7203,12.31429,58493
741,chrfergen,4,0.00684,7207,12.32113,58493
742,chrischillibean,4,0.00684,7211,12.32797,58493
743,chrisolido,4,0.00684,7215,12.33481,58493
744,comicfans,4,0.00684,7219,12.34165,58493
745,computeracer,4,0.00684,7223,12.34849,58493
746,cpfriend1721994,4,0.00684,7227,12.35532,58493
747,cronolio,4,0.00684,7231,12.36216,58493
748,cswilliams,4,0.00684,7235,12.36900,58493
749,ctison,4,0.00684,7239,12.37584,58493
750,cwiggs,4,0.00684,7243,12.38268,58493
751,CyberSeppi,4,0.00684,7247,12.38952,58493
752,cynipe,4,0.00684,7251,12.39636,58493
753,Darkheir,4,0.00684,7255,12.40319,58493
754,darrug,4,0.00684,7259,12.41003,58493
755,DaveSlinn,4,0.00684,7263,12.41687,58493
756,DavidTPate,4,0.00684,7267,12.42371,58493
757,dcosson,4,0.00684,7271,12.43055,58493
758,dehatanes,4,0.00684,7275,12.43739,58493
759,den-is,4,0.00684,7279,12.44422,58493
760,devopsjonas,4,0.00684,7283,12.45106,58493
761,diclophis,4,0.00684,7287,12.45790,58493
762,DonMartin76,4,0.00684,7291,12.46474,58493
763,dtjm,4,0.00684,7295,12.47158,58493
764,dylan-cooper,4,0.00684,7299,12.47842,58493
765,eakarsu,4,0.00684,7303,12.48525,58493
766,edgegoldberg,4,0.00684,7307,12.49209,58493
767,enekofb,4,0.00684,7311,12.49893,58493
768,et304383,4,0.00684,7315,12.50577,58493
769,evgeny-myasishchev,4,0.00684,7319,12.51261,58493
770,evgkrsk,4,0.00684,7323,12.51945,58493
771,exquisitus,4,0.00684,7327,12.52629,58493
772,FabianFrank,4,0.00684,7331,12.53312,58493
773,fatum,4,0.00684,7335,12.53996,58493
774,fcnrk,4,0.00684,7339,12.54680,58493
775,Filirom1,4,0.00684,7343,12.55364,58493
776,foobarnum,4,0.00684,7347,12.56048,58493
777,gaia,4,0.00684,7351,12.56732,58493
778,gasmith-nutanix,4,0.00684,7355,12.57415,58493
779,geerlingguy,4,0.00684,7359,12.58099,58493
780,gganssauge,4,0.00684,7363,12.58783,58493
781,ggpaue,4,0.00684,7367,12.59467,58493
782,gimmi,4,0.00684,7371,12.60151,58493
783,giner,4,0.00684,7375,12.60835,58493
784,Goddywu,4,0.00684,7379,12.61518,58493
785,goodservicedev,4,0.00684,7383,12.62202,58493
786,grachevko,4,0.00684,7387,12.62886,58493
787,gtrevg,4,0.00684,7391,12.63570,58493
788,guedressel,4,0.00684,7395,12.64254,58493
789,hansmeijerprotegrity,4,0.00684,7399,12.64938,58493
790,Hapa29,4,0.00684,7403,12.65622,58493
791,hassanf1,4,0.00684,7407,12.66305,58493
792,hirokikana,4,0.00684,7411,12.66989,58493
793,hixichen,4,0.00684,7415,12.67673,58493
794,homma-takamasa,4,0.00684,7419,12.68357,58493
795,howardkr,4,0.00684,7423,12.69041,58493
796,ibrasec,4,0.00684,7427,12.69725,58493
797,IppX,4,0.00684,7431,12.70408,58493
798,islue,4,0.00684,7435,12.71092,58493
799,ivandotv,4,0.00684,7439,12.71776,58493
800,ivankennethwang,4,0.00684,7443,12.72460,58493
801,jack2ngon,4,0.00684,7447,12.73144,58493
802,JakeBecker,4,0.00684,7451,12.73828,58493
803,jakubbujny,4,0.00684,7455,12.74511,58493
804,jamroks,4,0.00684,7459,12.75195,58493
805,januswel,4,0.00684,7463,12.75879,58493
806,jayhding,4,0.00684,7467,12.76563,58493
807,jaynblue,4,0.00684,7471,12.77247,58493
808,jcardoso-bv,4,0.00684,7475,12.77931,58493
809,jeremydonahue,4,0.00684,7479,12.78615,58493
810,jhaohai,4,0.00684,7483,12.79298,58493
811,jiachenzhong,4,0.00684,7487,12.79982,58493
812,jkawamoto,4,0.00684,7491,12.80666,58493
813,jmellor,4,0.00684,7495,12.81350,58493
814,joell,4,0.00684,7499,12.82034,58493
815,johntrabelsi,4,0.00684,7503,12.82718,58493
816,jojotheboss,4,0.00684,7507,12.83401,58493
817,jonapich,4,0.00684,7511,12.84085,58493
818,jondoe1337,4,0.00684,7515,12.84769,58493
819,jonmoter,4,0.00684,7519,12.85453,58493
820,joostcoelingh,4,0.00684,7523,12.86137,58493
821,josephine-rueckert,4,0.00684,7527,12.86821,58493
822,jpaulodit,4,0.00684,7531,12.87504,58493
823,jrottenberg,4,0.00684,7535,12.88188,58493
824,jujugrrr,4,0.00684,7539,12.88872,58493
825,j-un,4,0.00684,7543,12.89556,58493
826,k1nger,4,0.00684,7547,12.90240,58493
827,Kaimlo,4,0.00684,7551,12.90924,58493
828,kalexii,4,0.00684,7555,12.91608,58493
829,karatekidandy,4,0.00684,7559,12.92291,58493
830,kaxap,4,0.00684,7563,12.92975,58493
831,keithseahus,4,0.00684,7567,12.93659,58493
832,kevinburkenotion,4,0.00684,7571,12.94343,58493
833,kevinscholz,4,0.00684,7575,12.95027,58493
834,khteh,4,0.00684,7579,12.95711,58493
835,kinghuang,4,0.00684,7583,12.96394,58493
836,koolok,4,0.00684,7587,12.97078,58493
837,kprasad99,4,0.00684,7591,12.97762,58493
838,ksRaffaelSenn,4,0.00684,7595,12.98446,58493
839,kvidhya,4,0.00684,7599,12.99130,58493
840,kyleboyer-optum,4,0.00684,7603,12.99814,58493
841,kyu999,4,0.00684,7607,13.00497,58493
842,lanyuyang,4,0.00684,7611,13.01181,58493
843,leandroandrade-hotmart,4,0.00684,7615,13.01865,58493
844,linbingdouzhe,4,0.00684,7619,13.02549,58493
845,lingethan,4,0.00684,7623,13.03233,58493
846,liuxin95,4,0.00684,7627,13.03917,58493
847,ljuaneda,4,0.00684,7631,13.04601,58493
848,lorenmh,4,0.00684,7635,13.05284,58493
849,luoweb,4,0.00684,7639,13.05968,58493
850,luweiv9988,4,0.00684,7643,13.06652,58493
851,mailtoraja18,4,0.00684,7647,13.07336,58493
852,MajedFarhat,4,0.00684,7651,13.08020,58493
853,makknife,4,0.00684,7655,13.08704,58493
854,malingaraj,4,0.00684,7659,13.09387,58493
855,mblaschke,4,0.00684,7663,13.10071,58493
856,mcbain,4,0.00684,7667,13.10755,58493
857,megamk,4,0.00684,7671,13.11439,58493
858,Mengying-Li,4,0.00684,7675,13.12123,58493
859,mew109,4,0.00684,7679,13.12807,58493
860,MihaiAnei,4,0.00684,7683,13.13491,58493
861,mikeatlas,4,0.00684,7687,13.14174,58493
862,mikeshi80,4,0.00684,7691,13.14858,58493
863,mingshi,4,0.00684,7695,13.15542,58493
864,mitrakanuri,4,0.00684,7699,13.16226,58493
865,mogman1,4,0.00684,7703,13.16910,58493
866,MohdAhmad,4,0.00684,7707,13.17594,58493
867,mohit5540,4,0.00684,7711,13.18277,58493
868,mperriere,4,0.00684,7715,13.18961,58493
869,msergg,4,0.00684,7719,13.19645,58493
870,NareshAnaparthi,4,0.00684,7723,13.20329,58493
871,NBParis,4,0.00684,7727,13.21013,58493
872,nc-ruth,4,0.00684,7731,13.21697,58493
873,nderzhak,4,0.00684,7735,13.22380,58493
874,nesl247,4,0.00684,7739,13.23064,58493
875,nicktgr15,4,0.00684,7743,13.23748,58493
876,niku4i,4,0.00684,7747,13.24432,58493
877,NitinRanjan,4,0.00684,7751,13.25116,58493
878,njam,4,0.00684,7755,13.25800,58493
879,openchung,4,0.00684,7759,13.26484,58493
880,orenzp,4,0.00684,7763,13.27167,58493
881,ostkrok,4,0.00684,7767,13.27851,58493
882,PACordonnier,4,0.00684,7771,13.28535,58493
883,pankajgrovertt,4,0.00684,7775,13.29219,58493
884,Passpes,4,0.00684,7779,13.29903,58493
885,pathikritmodak,4,0.00684,7783,13.30587,58493
886,pepov,4,0.00684,7787,13.31270,58493
887,phoefflin,4,0.00684,7791,13.31954,58493
888,pi3ch,4,0.00684,7795,13.32638,58493
889,Pigmalion,4,0.00684,7799,13.33322,58493
890,pocke,4,0.00684,7803,13.34006,58493
891,port22,4,0.00684,7807,13.34690,58493
892,pranavgaikwad,4,0.00684,7811,13.35373,58493
893,Projoke,4,0.00684,7815,13.36057,58493
894,puyuan,4,0.00684,7819,13.36741,58493
895,qburst-anoop,4,0.00684,7823,13.37425,58493
896,qqbuby,4,0.00684,7827,13.38109,58493
897,r0039,4,0.00684,7831,13.38793,58493
898,RafaelSzefler,4,0.00684,7835,13.39477,58493
899,rail44,4,0.00684,7839,13.40160,58493
900,rchady,4,0.00684,7843,13.40844,58493
901,recipedude,4,0.00684,7847,13.41528,58493
902,redlolgeerf,4,0.00684,7851,13.42212,58493
903,reubentonna,4,0.00684,7855,13.42896,58493
904,rgomesf,4,0.00684,7859,13.43580,58493
905,richardburakowski,4,0.00684,7863,13.44263,58493
906,rkooo567,4,0.00684,7867,13.44947,58493
907,robertchen,4,0.00684,7871,13.45631,58493
908,rodaan,4,0.00684,7875,13.46315,58493
909,roemsi,4,0.00684,7879,13.46999,58493
910,romainr,4,0.00684,7883,13.47683,58493
911,roycarser,4,0.00684,7887,13.48366,58493
912,rsilva-nk,4,0.00684,7891,13.49050,58493
913,ruanwz,4,0.00684,7895,13.49734,58493
914,rud,4,0.00684,7899,13.50418,58493
915,rudolf-focuscura,4,0.00684,7903,13.51102,58493
916,rykov,4,0.00684,7907,13.51786,58493
917,salla2,4,0.00684,7911,13.52470,58493
918,samitpal,4,0.00684,7915,13.53153,58493
919,sandats,4,0.00684,7919,13.53837,58493
920,sanemat,4,0.00684,7923,13.54521,58493
921,sanju090,4,0.00684,7927,13.55205,58493
922,SatyabrataPadhi,4,0.00684,7931,13.55889,58493
923,sbocinec,4,0.00684,7935,13.56573,58493
924,Screwland,4,0.00684,7939,13.57256,58493
925,sdanieru,4,0.00684,7943,13.57940,58493
926,semoac,4,0.00684,7947,13.58624,58493
927,Seobeeee,4,0.00684,7951,13.59308,58493
928,sestrel,4,0.00684,7955,13.59992,58493
929,sethest,4,0.00684,7959,13.60676,58493
930,singalravi,4,0.00684,7963,13.61359,58493
931,SkyV0x,4,0.00684,7967,13.62043,58493
932,smanpathak,4,0.00684,7971,13.62727,58493
933,songshuone,4,0.00684,7975,13.63411,58493
934,sonirahul,4,0.00684,7979,13.64095,58493
935,sony-shinichi-hatayama,4,0.00684,7983,13.64779,58493
936,spanktar,4,0.00684,7987,13.65463,58493
937,spohn-acc,4,0.00684,7991,13.66146,58493
938,sri-05,4,0.00684,7995,13.66830,58493
939,srkiNZ84,4,0.00684,7999,13.67514,58493
940,srlps,4,0.00684,8003,13.68198,58493
941,stankud,4,0.00684,8007,13.68882,58493
942,stoshiya,4,0.00684,8011,13.69566,58493
943,suchisubhra,4,0.00684,8015,13.70249,58493
944,superwangvip,4,0.00684,8019,13.70933,58493
945,syepes,4,0.00684,8023,13.71617,58493
946,syohex,4,0.00684,8027,13.72301,58493
947,tanermelikoglu,4,0.00684,8031,13.72985,58493
948,tanipee323,4,0.00684,8035,13.73669,58493
949,tatsuyafw,4,0.00684,8039,13.74352,58493
950,tboerger,4,0.00684,8043,13.75036,58493
951,tech-talks-india,4,0.00684,8047,13.75720,58493
952,theogravity,4,0.00684,8051,13.76404,58493
953,tmeinlschmidt,4,0.00684,8055,13.77088,58493
954,tokyowizard,4,0.00684,8059,13.77772,58493
955,tom932,4,0.00684,8063,13.78456,58493
956,TomekLacina,4,0.00684,8067,13.79139,58493
957,tomstreet,4,0.00684,8071,13.79823,58493
958,toruuetani,4,0.00684,8075,13.80507,58493
959,toshimaru,4,0.00684,8079,13.81191,58493
960,urtho,4,0.00684,8083,13.81875,58493
961,uttamanand,4,0.00684,8087,13.82559,58493
962,vasi-grigo,4,0.00684,8091,13.83242,58493
963,vguaglione,4,0.00684,8095,13.83926,58493
964,vitclone,4,0.00684,8099,13.84610,58493
965,vwbusguy,4,0.00684,8103,13.85294,58493
966,wanghonglei5181,4,0.00684,8107,13.85978,58493
967,wangjiqing,4,0.00684,8111,13.86662,58493
968,wcarlsen,4,0.00684,8115,13.87345,58493
969,wolf31o2,4,0.00684,8119,13.88029,58493
970,Wolodija,4,0.00684,8123,13.88713,58493
971,woostundy,4,0.00684,8127,13.89397,58493
972,wzyplus,4,0.00684,8131,13.90081,58493
973,yarinm,4,0.00684,8135,13.90765,58493
974,ysksn,4,0.00684,8139,13.91449,58493
975,ysundar,4,0.00684,8143,13.92132,58493
976,yuchen9459,4,0.00684,8147,13.92816,58493
977,yudppp,4,0.00684,8151,13.93500,58493
978,zensh,4,0.00684,8155,13.94184,58493
979,zjesse713,4,0.00684,8159,13.94868,58493
980,13567436138,3,0.00513,8162,13.95381,58493
981,178inaba,3,0.00513,8165,13.95894,58493
982,7FX,3,0.00513,8168,13.96406,58493
983,aa23,3,0.00513,8171,13.96919,58493
984,abhishek-buragadda,3,0.00513,8174,13.97432,58493
985,acgustafson,3,0.00513,8177,13.97945,58493
986,achied,3,0.00513,8180,13.98458,58493
987,achinchen,3,0.00513,8183,13.98971,58493
988,adejongh,3,0.00513,8186,13.99484,58493
989,admssa,3,0.00513,8189,13.99997,58493
990,ae-dg,3,0.00513,8192,14.00509,58493
991,aehlke,3,0.00513,8195,14.01022,58493
992,ajcrowe,3,0.00513,8198,14.01535,58493
993,AjeetK,3,0.00513,8201,14.02048,58493
994,aj-jester,3,0.00513,8204,14.02561,58493
995,AJouaneau-CS,3,0.00513,8207,14.03074,58493
996,akalbhor,3,0.00513,8210,14.03587,58493
997,akshatsharma4,3,0.00513,8213,14.04100,58493
998,alexander-stepanov,3,0.00513,8216,14.04613,58493
999,AlexMorreale,3,0.00513,8219,14.05125,58493
1000,alexnguyen91,3,0.00513,8222,14.05638,58493
1001,alihushyar,3,0.00513,8225,14.06151,58493
1002,alwinmarkcf,3,0.00513,8228,14.06664,58493
1003,amarkelov,3,0.00513,8231,14.07177,58493
1004,andersosthus,3,0.00513,8234,14.07690,58493
1005,andrzejwp,3,0.00513,8237,14.08203,58493
1006,AniGarikipati,3,0.00513,8240,14.08716,58493
1007,anjanimax,3,0.00513,8243,14.09228,58493
1008,anthonyhaussman,3,0.00513,8246,14.09741,58493
1009,antonionappi88,3,0.00513,8249,14.10254,58493
1010,anuragensemble,3,0.00513,8252,14.10767,58493
1011,AqD,3,0.00513,8255,14.11280,58493
1012,arikunbotify,3,0.00513,8258,14.11793,58493
1013,Arvon2014,3,0.00513,8261,14.12306,58493
1014,asdf2014,3,0.00513,8264,14.12819,58493
1015,ashutalewar,3,0.00513,8267,14.13332,58493
1016,Avanzato,3,0.00513,8270,14.13844,58493
1017,AyliD,3,0.00513,8273,14.14357,58493
1018,azrle,3,0.00513,8276,14.14870,58493
1019,baldeynz,3,0.00513,8279,14.15383,58493
1020,balraj111,3,0.00513,8282,14.15896,58493
1021,bash0C7,3,0.00513,8285,14.16409,58493
1022,bbkgh,3,0.00513,8288,14.16922,58493
1023,bernhardttom,3,0.00513,8291,14.17435,58493
1024,bgola-signalfx,3,0.00513,8294,14.17947,58493
1025,bidiudiu,3,0.00513,8297,14.18460,58493
1026,bingxunali,3,0.00513,8300,14.18973,58493
1027,bmandrade,3,0.00513,8303,14.19486,58493
1028,brainlid,3,0.00513,8306,14.19999,58493
1029,brandonmp,3,0.00513,8309,14.20512,58493
1030,brendanhill,3,0.00513,8312,14.21025,58493
1031,BrunoAndrade,3,0.00513,8315,14.21538,58493
1032,bryanchapman9999,3,0.00513,8318,14.22051,58493
1033,brycied00d,3,0.00513,8321,14.22563,58493
1034,btwood,3,0.00513,8324,14.23076,58493
1035,burningalchemist,3,0.00513,8327,14.23589,58493
1036,camelmasa,3,0.00513,8330,14.24102,58493
1037,caquino,3,0.00513,8333,14.24615,58493
1038,cheer1hao,3,0.00513,8336,14.25128,58493
1039,chenguolin,3,0.00513,8339,14.25641,58493
1040,ChenZheOnePiece,3,0.00513,8342,14.26154,58493
1041,chris060986,3,0.00513,8345,14.26666,58493
1042,chrislee87,3,0.00513,8348,14.27179,58493
1043,ChristianTrolleMikkelsen,3,0.00513,8351,14.27692,58493
1044,Cisneiros,3,0.00513,8354,14.28205,58493
1045,civik,3,0.00513,8357,14.28718,58493
1046,ckannon,3,0.00513,8360,14.29231,58493
1047,clintkim88,3,0.00513,8363,14.29744,58493
1048,cloud-sec,3,0.00513,8366,14.30257,58493
1049,cmarodrigues,3,0.00513,8369,14.30769,58493
1050,cmrust,3,0.00513,8372,14.31282,58493
1051,codepainters,3,0.00513,8375,14.31795,58493
1052,Code-ReaQtor,3,0.00513,8378,14.32308,58493
1053,compucandi,3,0.00513,8381,14.32821,58493
1054,cristgl,3,0.00513,8384,14.33334,58493
1055,cyberabis,3,0.00513,8387,14.33847,58493
1056,daic-h,3,0.00513,8390,14.34360,58493
1057,danfoxley,3,0.00513,8393,14.34873,58493
1058,danischroeter,3,0.00513,8396,14.35385,58493
1059,darkdep,3,0.00513,8399,14.35898,58493
1060,darktim,3,0.00513,8402,14.36411,58493
1061,Darrelk,3,0.00513,8405,14.36924,58493
1062,dbeal-wiser,3,0.00513,8408,14.37437,58493
1063,dcvtruong,3,0.00513,8411,14.37950,58493
1064,d-dmitry,3,0.00513,8414,14.38463,58493
1065,ddzero2c,3,0.00513,8417,14.38976,58493
1066,DEGoodman,3,0.00513,8420,14.39488,58493
1067,DengTin,3,0.00513,8423,14.40001,58493
1068,derryos,3,0.00513,8426,14.40514,58493
1069,devin-hpcnt,3,0.00513,8429,14.41027,58493
1070,dguendisch,3,0.00513,8432,14.41540,58493
1071,didodido85,3,0.00513,8435,14.42053,58493
1072,digitalsanity,3,0.00513,8438,14.42566,58493
1073,disq,3,0.00513,8441,14.43079,58493
1074,diwakergupta,3,0.00513,8444,14.43592,58493
1075,dkalashnik,3,0.00513,8447,14.44104,58493
1076,dkavraal,3,0.00513,8450,14.44617,58493
1077,dkirrane,3,0.00513,8453,14.45130,58493
1078,dmigous,3,0.00513,8456,14.45643,58493
1079,dminca,3,0.00513,8459,14.46156,58493
1080,dmxlsj,3,0.00513,8462,14.46669,58493
1081,dorzeidman,3,0.00513,8465,14.47182,58493
1082,dtmistry,3,0.00513,8468,14.47695,58493
1083,dukex,3,0.00513,8471,14.48207,58493
1084,dvydra,3,0.00513,8474,14.48720,58493
1085,edmeister,3,0.00513,8477,14.49233,58493
1086,ekesken,3,0.00513,8480,14.49746,58493
1087,EliFinkelshteyn,3,0.00513,8483,14.50259,58493
1088,emanueleliardo,3,0.00513,8486,14.50772,58493
1089,enarciso,3,0.00513,8489,14.51285,58493
1090,eplodn,3,0.00513,8492,14.51798,58493
1091,ericln,3,0.00513,8495,14.52311,58493
1092,ericsage,3,0.00513,8498,14.52823,58493
1093,eskuai,3,0.00513,8501,14.53336,58493
1094,evenh,3,0.00513,8504,14.53849,58493
1095,EverGreen5455,3,0.00513,8507,14.54362,58493
1096,Evertvz,3,0.00513,8510,14.54875,58493
1097,ewolinetz,3,0.00513,8513,14.55388,58493
1098,falau,3,0.00513,8516,14.55901,58493
1099,fatfatson,3,0.00513,8519,14.56414,58493
1100,fazil1987,3,0.00513,8522,14.56926,58493
1101,fessmage,3,0.00513,8525,14.57439,58493
1102,fetaro,3,0.00513,8528,14.57952,58493
1103,ffahri,3,0.00513,8531,14.58465,58493
1104,fleischer932,3,0.00513,8534,14.58978,58493
1105,fleprovost,3,0.00513,8537,14.59491,58493
1106,flippyflap,3,0.00513,8540,14.60004,58493
1107,florimondmanca,3,0.00513,8543,14.60517,58493
1108,gappan,3,0.00513,8546,14.61030,58493
1109,george-unbotify,3,0.00513,8549,14.61542,58493
1110,glesperance,3,0.00513,8552,14.62055,58493
1111,gma-git-admin,3,0.00513,8555,14.62568,58493
1112,gmsecrieru,3,0.00513,8558,14.63081,58493
1113,gordonlee,3,0.00513,8561,14.63594,58493
1114,grepory,3,0.00513,8564,14.64107,58493
1115,grigorov,3,0.00513,8567,14.64620,58493
1116,grv231,3,0.00513,8570,14.65133,58493
1117,gshively11,3,0.00513,8573,14.65645,58493
1118,GypsyCosmonaut,3,0.00513,8576,14.66158,58493
1119,hanachin,3,0.00513,8579,14.66671,58493
1120,hanyijun,3,0.00513,8582,14.67184,58493
1121,haoyujiang1994,3,0.00513,8585,14.67697,58493
1122,harsxv,3,0.00513,8588,14.68210,58493
1123,hc-chien,3,0.00513,8591,14.68723,58493
1124,hichamuntitled,3,0.00513,8594,14.69236,58493
1125,hitochan777,3,0.00513,8597,14.69749,58493
1126,hmac,3,0.00513,8600,14.70261,58493
1127,holycheater,3,0.00513,8603,14.70774,58493
1128,hoperays,3,0.00513,8606,14.71287,58493
1129,huangyingting,3,0.00513,8609,14.71800,58493
1130,huegelc,3,0.00513,8612,14.72313,58493
1131,huembi,3,0.00513,8615,14.72826,58493
1132,hunshenshi,3,0.00513,8618,14.73339,58493
1133,Hwting,3,0.00513,8621,14.73852,58493
1134,iamshreeram,3,0.00513,8624,14.74364,58493
1135,ianjoneill,3,0.00513,8627,14.74877,58493
1136,IBUMBLEBEE,3,0.00513,8630,14.75390,58493
1137,id774,3,0.00513,8633,14.75903,58493
1138,iitenkida7,3,0.00513,8636,14.76416,58493
1139,imkira,3,0.00513,8639,14.76929,58493
1140,imranrazakhan,3,0.00513,8642,14.77442,58493
1141,inthuriel,3,0.00513,8645,14.77955,58493
1142,ioquatix,3,0.00513,8648,14.78468,58493
1143,ISChetverikov,3,0.00513,8651,14.78980,58493
1144,ishkanan,3,0.00513,8654,14.79493,58493
1145,itkq,3,0.00513,8657,14.80006,58493
1146,j30ng,3,0.00513,8660,14.80519,58493
1147,j3grewal,3,0.00513,8663,14.81032,58493
1148,jace,3,0.00513,8666,14.81545,58493
1149,Jacky2,3,0.00513,8669,14.82058,58493
1150,jacoelho,3,0.00513,8672,14.82571,58493
1151,jalberto,3,0.00513,8675,14.83083,58493
1152,jamesdburgess,3,0.00513,8678,14.83596,58493
1153,Jamlee,3,0.00513,8681,14.84109,58493
1154,jantzenallphin,3,0.00513,8684,14.84622,58493
1155,jasimmk,3,0.00513,8687,14.85135,58493
1156,jaul,3,0.00513,8690,14.85648,58493
1157,jayeshnazre,3,0.00513,8693,14.86161,58493
1158,j-chao,3,0.00513,8696,14.86674,58493
1159,jhuntwork,3,0.00513,8699,14.87187,58493
1160,Jitsusama,3,0.00513,8702,14.87699,58493
1161,jmcastellote,3,0.00513,8705,14.88212,58493
1162,jmglsn,3,0.00513,8708,14.88725,58493
1163,joelthompson,3,0.00513,8711,14.89238,58493
1164,joesonw,3,0.00513,8714,14.89751,58493
1165,jogendrajangid1,3,0.00513,8717,14.90264,58493
1166,JohannWeging,3,0.00513,8720,14.90777,58493
1167,johnnadratowski,3,0.00513,8723,14.91290,58493
1168,johnr-spindance,3,0.00513,8726,14.91802,58493
1169,jonahb,3,0.00513,8729,14.92315,58493
1170,jonathanhle,3,0.00513,8732,14.92828,58493
1171,jondot,3,0.00513,8735,14.93341,58493
1172,jonhadfield,3,0.00513,8738,14.93854,58493
1173,jordanwu97,3,0.00513,8741,14.94367,58493
1174,jorgebirck,3,0.00513,8744,14.94880,58493
1175,josh-tepper,3,0.00513,8747,14.95393,58493
1176,joyarzun,3,0.00513,8750,14.95905,58493
1177,jpds,3,0.00513,8753,14.96418,58493
1178,jshen28,3,0.00513,8756,14.96931,58493
1179,jt1,3,0.00513,8759,14.97444,58493
1180,julienvincent,3,0.00513,8762,14.97957,58493
1181,jwp23,3,0.00513,8765,14.98470,58493
1182,kamikaseda,3,0.00513,8768,14.98983,58493
1183,karol-brejna-i,3,0.00513,8771,14.99496,58493
1184,karvin,3,0.00513,8774,15.00009,58493
1185,kasiprasad,3,0.00513,8777,15.00521,58493
1186,Kefa7y,3,0.00513,8780,15.01034,58493
1187,kei-q,3,0.00513,8783,15.01547,58493
1188,kelonye,3,0.00513,8786,15.02060,58493
1189,kesuzuki,3,0.00513,8789,15.02573,58493
1190,k-hal,3,0.00513,8792,15.03086,58493
1191,kilya11,3,0.00513,8795,15.03599,58493
1192,kishoreck,3,0.00513,8798,15.04112,58493
1193,kochp,3,0.00513,8801,15.04624,58493
1194,kouk,3,0.00513,8804,15.05137,58493
1195,kplimack,3,0.00513,8807,15.05650,58493
1196,krankin,3,0.00513,8810,15.06163,58493
1197,ksemaev,3,0.00513,8813,15.06676,58493
1198,kuno,3,0.00513,8816,15.07189,58493
1199,kureikain,3,0.00513,8819,15.07702,58493
1200,kyleroot,3,0.00513,8822,15.08215,58493
1201,lala7573,3,0.00513,8825,15.08728,58493
1202,lcrash,3,0.00513,8828,15.09240,58493
1203,leafchild0,3,0.00513,8831,15.09753,58493
1204,ledroide,3,0.00513,8834,15.10266,58493
1205,lee-byeoksan,3,0.00513,8837,15.10779,58493
1206,lesovsky,3,0.00513,8840,15.11292,58493
1207,LesTR,3,0.00513,8843,15.11805,58493
1208,lidocaineus,3,0.00513,8846,15.12318,58493
1209,lijunyong,3,0.00513,8849,15.12831,58493
1210,ljou,3,0.00513,8852,15.13343,58493
1211,llarsson,3,0.00513,8855,15.13856,58493
1212,Lokicity,3,0.00513,8858,15.14369,58493
1213,loposk,3,0.00513,8861,15.14882,58493
1214,lruslan,3,0.00513,8864,15.15395,58493
1215,lucasbasquerotto,3,0.00513,8867,15.15908,58493
1216,luqasz,3,0.00513,8870,15.16421,58493
1217,madkote,3,0.00513,8873,15.16934,58493
1218,malinoff,3,0.00513,8876,15.17447,58493
1219,Manikandan-Raj,3,0.00513,8879,15.17959,58493
1220,MarkHeddaeus,3,0.00513,8882,15.18472,58493
1221,Marki4711,3,0.00513,8885,15.18985,58493
1222,MartinForReal,3,0.00513,8888,15.19498,58493
1223,mastak,3,0.00513,8891,15.20011,58493
1224,masterkain,3,0.00513,8894,15.20524,58493
1225,maust,3,0.00513,8897,15.21037,58493
1226,maverick-racheal,3,0.00513,8900,15.21550,58493
1227,maxd,3,0.00513,8903,15.22062,58493
1228,maxwellzdm,3,0.00513,8906,15.22575,58493
1229,mbelchin,3,0.00513,8909,15.23088,58493
1230,mburns,3,0.00513,8912,15.23601,58493
1231,mcarbonneaux,3,0.00513,8915,15.24114,58493
1232,Mehonoshin,3,0.00513,8918,15.24627,58493
1233,meskai,3,0.00513,8921,15.25140,58493
1234,mgcrea,3,0.00513,8924,15.25653,58493
1235,micdah,3,0.00513,8927,15.26166,58493
1236,micklonge,3,0.00513,8930,15.26678,58493
1237,mikeleeme,3,0.00513,8933,15.27191,58493
1238,mikesphar,3,0.00513,8936,15.27704,58493
1239,miketonks,3,0.00513,8939,15.28217,58493
1240,milan-koudelka,3,0.00513,8942,15.28730,58493
1241,miono,3,0.00513,8945,15.29243,58493
1242,missourian55,3,0.00513,8948,15.29756,58493
1243,misteryiz,3,0.00513,8951,15.30269,58493
1244,mjhoffman65,3,0.00513,8954,15.30781,58493
1245,mokaymakci,3,0.00513,8957,15.31294,58493
1246,moserke,3,0.00513,8960,15.31807,58493
1247,mrudrego,3,0.00513,8963,15.32320,58493
1248,muceres,3,0.00513,8966,15.32833,58493
1249,munangst,3,0.00513,8969,15.33346,58493
1250,muraliready,3,0.00513,8972,15.33859,58493
1251,myspotontheweb,3,0.00513,8975,15.34372,58493
1252,naoya,3,0.00513,8978,15.34885,58493
1253,NawarA,3,0.00513,8981,15.35397,58493
1254,nbvehbq,3,0.00513,8984,15.35910,58493
1255,neoxack,3,0.00513,8987,15.36423,58493
1256,nerro,3,0.00513,8990,15.36936,58493
1257,NetForces,3,0.00513,8993,15.37449,58493
1258,nhamlh,3,0.00513,8996,15.37962,58493
1259,nickwq,3,0.00513,8999,15.38475,58493
1260,nikitka,3,0.00513,9002,15.38988,58493
1261,npappin-wsu,3,0.00513,9005,15.39500,58493
1262,nqbao,3,0.00513,9008,15.40013,58493
1263,nttdbpo-liudengke,3,0.00513,9011,15.40526,58493
1264,ods94065,3,0.00513,9014,15.41039,58493
1265,ofcourseican,3,0.00513,9017,15.41552,58493
1266,ofirnn,3,0.00513,9020,15.42065,58493
1267,openbob,3,0.00513,9023,15.42578,58493
1268,osamingo,3,0.00513,9026,15.43091,58493
1269,ovcharenko,3,0.00513,9029,15.43604,58493
1270,panda87,3,0.00513,9032,15.44116,58493
1271,paraita,3,0.00513,9035,15.44629,58493
1272,pareeksanjay05,3,0.00513,9038,15.45142,58493
1273,passos,3,0.00513,9041,15.45655,58493
1274,PatrikCyvoct,3,0.00513,9044,15.46168,58493
1275,pavgup,3,0.00513,9047,15.46681,58493
1276,peelandsee,3,0.00513,9050,15.47194,58493
1277,pellaeon,3,0.00513,9053,15.47707,58493
1278,perriea,3,0.00513,9056,15.48219,58493
1279,pfremm,3,0.00513,9059,15.48732,58493
1280,phagunbaya,3,0.00513,9062,15.49245,58493
1281,pierce300,3,0.00513,9065,15.49758,58493
1282,pikrzysztof,3,0.00513,9068,15.50271,58493
1283,PiotrKlimczak,3,0.00513,9071,15.50784,58493
1284,pirankashani,3,0.00513,9074,15.51297,58493
1285,pkaeding,3,0.00513,9077,15.51810,58493
1286,pkout,3,0.00513,9080,15.52323,58493
1287,porkbeans,3,0.00513,9083,15.52835,58493
1288,ppp0,3,0.00513,9086,15.53348,58493
1289,prasadkarkera,3,0.00513,9089,15.53861,58493
1290,prashantvicky,3,0.00513,9092,15.54374,58493
1291,profhase,3,0.00513,9095,15.54887,58493
1292,psychomelet,3,0.00513,9098,15.55400,58493
1293,Psyered,3,0.00513,9101,15.55913,58493
1294,putaotao,3,0.00513,9104,15.56426,58493
1295,r7kamura,3,0.00513,9107,15.56938,58493
1296,raghuram-megharaj,3,0.00513,9110,15.57451,58493
1297,rajan471,3,0.00513,9113,15.57964,58493
1298,rajatvcsbuild,3,0.00513,9116,15.58477,58493
1299,ReadmeCritic,3,0.00513,9119,15.58990,58493
1300,rewiko,3,0.00513,9122,15.59503,58493
1301,Rice-tt,3,0.00513,9125,15.60016,58493
1302,riuvshin,3,0.00513,9128,15.60529,58493
1303,riuvshyn,3,0.00513,9131,15.61041,58493
1304,rmelick,3,0.00513,9134,15.61554,58493
1305,RodolpheGohard,3,0.00513,9137,15.62067,58493
1306,roffe,3,0.00513,9140,15.62580,58493
1307,RomanManz,3,0.00513,9143,15.63093,58493
1308,rrichardson,3,0.00513,9146,15.63606,58493
1309,rubencabrera,3,0.00513,9149,15.64119,58493
1310,RubenHoms,3,0.00513,9152,15.64632,58493
1311,rudyryk,3,0.00513,9155,15.65145,58493
1312,runningstream,3,0.00513,9158,15.65657,58493
1313,runseb,3,0.00513,9161,15.66170,58493
1314,ruseel,3,0.00513,9164,15.66683,58493
1315,ryushu,3,0.00513,9167,15.67196,58493
1316,Sam123ben,3,0.00513,9170,15.67709,58493
1317,sanoyphilippe,3,0.00513,9173,15.68222,58493
1318,scanlonjts,3,0.00513,9176,15.68735,58493
1319,schmurfy,3,0.00513,9179,15.69248,58493
1320,selerite,3,0.00513,9182,15.69760,58493
1321,serge-jomedia,3,0.00513,9185,15.70273,58493
1322,SergeyD,3,0.00513,9188,15.70786,58493
1323,servo1x,3,0.00513,9191,15.71299,58493
1324,Set4now,3,0.00513,9194,15.71812,58493
1325,sgulati89,3,0.00513,9197,15.72325,58493
1326,shacharz,3,0.00513,9200,15.72838,58493
1327,shagabutdinov,3,0.00513,9203,15.73351,58493
1328,sharadkejriwal,3,0.00513,9206,15.73864,58493
1329,sherwinwangs,3,0.00513,9209,15.74376,58493
1330,shinji3887,3,0.00513,9212,15.74889,58493
1331,shuxiang,3,0.00513,9215,15.75402,58493
1332,simonwh,3,0.00513,9218,15.75915,58493
1333,SireeshaKucherlapati,3,0.00513,9221,15.76428,58493
1334,Skarlso,3,0.00513,9224,15.76941,58493
1335,slene,3,0.00513,9227,15.77454,58493
1336,smlx,3,0.00513,9230,15.77967,58493
1337,sokoow,3,0.00513,9233,15.78479,58493
1338,sotayamashita,3,0.00513,9236,15.78992,58493
1339,spaelet,3,0.00513,9239,15.79505,58493
1340,srini38,3,0.00513,9242,15.80018,58493
1341,ssweens,3,0.00513,9245,15.80531,58493
1342,stager0909-ray,3,0.00513,9248,15.81044,58493
1343,stang,3,0.00513,9251,15.81557,58493
1344,stanimirovv,3,0.00513,9254,15.82070,58493
1345,staylor774,3,0.00513,9257,15.82583,58493
1346,stefanax,3,0.00513,9260,15.83095,58493
1347,stephen-lazarionok,3,0.00513,9263,15.83608,58493
1348,stevenc81,3,0.00513,9266,15.84121,58493
1349,strantalis,3,0.00513,9269,15.84634,58493
1350,stuh84,3,0.00513,9272,15.85147,58493
1351,sueken5,3,0.00513,9275,15.85660,58493
1352,suganyp07,3,0.00513,9278,15.86173,58493
1353,summed,3,0.00513,9281,15.86686,58493
1354,surajsunrays,3,0.00513,9284,15.87198,58493
1355,Sushisource,3,0.00513,9287,15.87711,58493
1356,suxarik,3,0.00513,9290,15.88224,58493
1357,suyambuganesh,3,0.00513,9293,15.88737,58493
1358,swapnilpatil1682,3,0.00513,9296,15.89250,58493
1359,syst0m,3,0.00513,9299,15.89763,58493
1360,ta32,3,0.00513,9302,15.90276,58493
1361,TamerDev,3,0.00513,9305,15.90789,58493
1362,tamer-hassan,3,0.00513,9308,15.91302,58493
1363,tangjiaxing669,3,0.00513,9311,15.91814,58493
1364,TankNut,3,0.00513,9314,15.92327,58493
1365,tbickford,3,0.00513,9317,15.92840,58493
1366,teotwaki,3,0.00513,9320,15.93353,58493
1367,testzlx,3,0.00513,9323,15.93866,58493
1368,tetramin,3,0.00513,9326,15.94379,58493
1369,tgalyean,3,0.00513,9329,15.94892,58493
1370,thekantian,3,0.00513,9332,15.95405,58493
1371,thereverendtom,3,0.00513,9335,15.95917,58493
1372,thkoch2001,3,0.00513,9338,15.96430,58493
1373,thokari,3,0.00513,9341,15.96943,58493
1374,thomaskrag,3,0.00513,9344,15.97456,58493
1375,thoriqsatriya,3,0.00513,9347,15.97969,58493
1376,ThorstenHans,3,0.00513,9350,15.98482,58493
1377,threewordphrase,3,0.00513,9353,15.98995,58493
1378,todesking,3,0.00513,9356,15.99508,58493
1379,tomykaira,3,0.00513,9359,16.00021,58493
1380,truedat101,3,0.00513,9362,16.00533,58493
1381,tuki0918,3,0.00513,9365,16.01046,58493
1382,twalla,3,0.00513,9368,16.01559,58493
1383,tylerjl,3,0.00513,9371,16.02072,58493
1384,tylux,3,0.00513,9374,16.02585,58493
1385,udf2457,3,0.00513,9377,16.03098,58493
1386,udzura,3,0.00513,9380,16.03611,58493
1387,u-shunya,3,0.00513,9383,16.04124,58493
1388,varunkumta,3,0.00513,9386,16.04636,58493
1389,vbuciuc,3,0.00513,9389,16.05149,58493
1390,vector-sec,3,0.00513,9392,16.05662,58493
1391,vgoloviznin,3,0.00513,9395,16.06175,58493
1392,vigohe,3,0.00513,9398,16.06688,58493
1393,vijaykramesh,3,0.00513,9401,16.07201,58493
1394,vijaypa1,3,0.00513,9404,16.07714,58493
1395,vimalmpatel,3,0.00513,9407,16.08227,58493
1396,viskoo,3,0.00513,9410,16.08740,58493
1397,vpistis,3,0.00513,9413,16.09252,58493
1398,vsinghal13,3,0.00513,9416,16.09765,58493
1399,vvk,3,0.00513,9419,16.10278,58493
1400,walfie,3,0.00513,9422,16.10791,58493
1401,wgzhao,3,0.00513,9425,16.11304,58493
1402,whithajess,3,0.00513,9428,16.11817,58493
1403,WilliamBurdett,3,0.00513,9431,16.12330,58493
1404,wkuranowski,3,0.00513,9434,16.12843,58493
1405,worldcitizen,3,0.00513,9437,16.13355,58493
1406,wudebao,3,0.00513,9440,16.13868,58493
1407,xaque208,3,0.00513,9443,16.14381,58493
1408,xdh-ops,3,0.00513,9446,16.14894,58493
1409,xingxing9688,3,0.00513,9449,16.15407,58493
1410,y0zg,3,0.00513,9452,16.15920,58493
1411,yanrong1990,3,0.00513,9455,16.16433,58493
1412,YanXiaobin-Ben,3,0.00513,9458,16.16946,58493
1413,yas-ysd,3,0.00513,9461,16.17458,58493
1414,yhidai,3,0.00513,9464,16.17971,58493
1415,yigal-rozenberg,3,0.00513,9467,16.18484,58493
1416,ymatsiuk,3,0.00513,9470,16.18997,58493
1417,yoshi-taka,3,0.00513,9473,16.19510,58493
1418,zarakay,3,0.00513,9476,16.20023,58493
1419,Zexi,3,0.00513,9479,16.20536,58493
1420,zffocussss,3,0.00513,9482,16.21049,58493
1421,zfouts,3,0.00513,9485,16.21562,58493
1422,zhangzhengstrive,3,0.00513,9488,16.22074,58493
1423,zhuoyikang,3,0.00513,9491,16.22587,58493
1424,zhuqinghua,3,0.00513,9494,16.23100,58493
1425,zimathon,3,0.00513,9497,16.23613,58493
1426,ZPerling,3,0.00513,9500,16.24126,58493
1427,zskulcsar,3,0.00513,9503,16.24639,58493
1428,zuehlke-dea,3,0.00513,9506,16.25152,58493
1429,1tarak,2,0.00342,9508,16.25494,58493
1430,2solt,2,0.00342,9510,16.25836,58493
1431,3tinkers,2,0.00342,9512,16.26177,58493
1432,abhinaya04,2,0.00342,9514,16.26519,58493
1433,adamcheney,2,0.00342,9516,16.26861,58493
1434,adamp524,2,0.00342,9518,16.27203,58493
1435,adamthedeveloper,2,0.00342,9520,16.27545,58493
1436,AddChickpeas,2,0.00342,9522,16.27887,58493
1437,adeadman,2,0.00342,9524,16.28229,58493
1438,afirst,2,0.00342,9526,16.28571,58493
1439,afshinm,2,0.00342,9528,16.28913,58493
1440,agerro,2,0.00342,9530,16.29255,58493
1441,a-hat,2,0.00342,9532,16.29597,58493
1442,ahevenor,2,0.00342,9534,16.29939,58493
1443,aido93,2,0.00342,9536,16.30281,58493
1444,airtoxin,2,0.00342,9538,16.30622,58493
1445,aiwantaozi,2,0.00342,9540,16.30964,58493
1446,aj-rame3,2,0.00342,9542,16.31306,58493
1447,ajturner,2,0.00342,9544,16.31648,58493
1448,akira-kuriyama,2,0.00342,9546,16.31990,58493
1449,Aktau,2,0.00342,9548,16.32332,58493
1450,alekseydemidov,2,0.00342,9550,16.32674,58493
1451,Alewex,2,0.00342,9552,16.33016,58493
1452,alexanderkiel,2,0.00342,9554,16.33358,58493
1453,alexander-mayr,2,0.00342,9556,16.33700,58493
1454,alexanderoot,2,0.00342,9558,16.34042,58493
1455,alexdyas,2,0.00342,9560,16.34384,58493
1456,alexmanno,2,0.00342,9562,16.34726,58493
1457,algestam,2,0.00342,9564,16.35067,58493
1458,alnat2,2,0.00342,9566,16.35409,58493
1459,amanmahajan26,2,0.00342,9568,16.35751,58493
1460,Amirioelmos,2,0.00342,9570,16.36093,58493
1461,amitkumarjha,2,0.00342,9572,16.36435,58493
1462,amread,2,0.00342,9574,16.36777,58493
1463,amritb,2,0.00342,9576,16.37119,58493
1464,andrewgdavis,2,0.00342,9578,16.37461,58493
1465,andrii29,2,0.00342,9580,16.37803,58493
1466,AndyJS,2,0.00342,9582,16.38145,58493
1467,andyprinceuk,2,0.00342,9584,16.38487,58493
1468,AnkurJain10,2,0.00342,9586,16.38829,58493
1469,ankurjha7,2,0.00342,9588,16.39170,58493
1470,anshumgargdd,2,0.00342,9590,16.39512,58493
1471,Antarion,2,0.00342,9592,16.39854,58493
1472,apmcodes,2,0.00342,9594,16.40196,58493
1473,apolloclark,2,0.00342,9596,16.40538,58493
1474,apu1111,2,0.00342,9598,16.40880,58493
1475,artur-fijalkowski,2,0.00342,9600,16.41222,58493
1476,asyd,2,0.00342,9602,16.41564,58493
1477,avarf,2,0.00342,9604,16.41906,58493
1478,awwx,2,0.00342,9606,16.42248,58493
1479,ayandev007,2,0.00342,9608,16.42590,58493
1480,ayushmathur86,2,0.00342,9610,16.42932,58493
1481,azyata,2,0.00342,9612,16.43274,58493
1482,baihe,2,0.00342,9614,16.43615,58493
1483,bartelsb,2,0.00342,9616,16.43957,58493
1484,bastichelaar,2,0.00342,9618,16.44299,58493
1485,basvandenbrink,2,0.00342,9620,16.44641,58493
1486,baznikin,2,0.00342,9622,16.44983,58493
1487,bcallanan,2,0.00342,9624,16.45325,58493
1488,bcismariu,2,0.00342,9626,16.45667,58493
1489,behbas,2,0.00342,9628,16.46009,58493
1490,belljustin,2,0.00342,9630,16.46351,58493
1491,bench87,2,0.00342,9632,16.46693,58493
1492,beradrian,2,0.00342,9634,16.47035,58493
1493,beriberikix,2,0.00342,9636,16.47377,58493
1494,bhavikchitroda,2,0.00342,9638,16.47719,58493
1495,bhuntington25,2,0.00342,9640,16.48060,58493
1496,bigsleep,2,0.00342,9642,16.48402,58493
1497,birdy81,2,0.00342,9644,16.48744,58493
1498,bitterb,2,0.00342,9646,16.49086,58493
1499,Bizzelicious,2,0.00342,9648,16.49428,58493
1500,bkupidura,2,0.00342,9650,16.49770,58493
1501,blopker,2,0.00342,9652,16.50112,58493
1502,bodanc,2,0.00342,9654,16.50454,58493
1503,bogdanov1609,2,0.00342,9656,16.50796,58493
1504,bperel,2,0.00342,9658,16.51138,58493
1505,brandshaide,2,0.00342,9660,16.51480,58493
1506,breath103,2,0.00342,9662,16.51822,58493
1507,BrendanBall,2,0.00342,9664,16.52164,58493
1508,briantopping,2,0.00342,9666,16.52505,58493
1509,briceburg,2,0.00342,9668,16.52847,58493
1510,brunoyb,2,0.00342,9670,16.53189,58493
1511,BuckarewBanzai,2,0.00342,9672,16.53531,58493
1512,Bulat-Gumerov,2,0.00342,9674,16.53873,58493
1513,c0b,2,0.00342,9676,16.54215,58493
1514,cadyb,2,0.00342,9678,16.54557,58493
1515,calibr,2,0.00342,9680,16.54899,58493
1516,calumah,2,0.00342,9682,16.55241,58493
1517,camallen,2,0.00342,9684,16.55583,58493
1518,captn3m0,2,0.00342,9686,16.55925,58493
1519,cathy-js,2,0.00342,9688,16.56267,58493
1520,CBR09,2,0.00342,9690,16.56608,58493
1521,chamilad,2,0.00342,9692,16.56950,58493
1522,chandertechavidity,2,0.00342,9694,16.57292,58493
1523,chaosoldier,2,0.00342,9696,16.57634,58493
1524,chapitos,2,0.00342,9698,16.57976,58493
1525,charmingcoder,2,0.00342,9700,16.58318,58493
1526,ches,2,0.00342,9702,16.58660,58493
1527,chipx,2,0.00342,9704,16.59002,58493
1528,chs-bnet,2,0.00342,9706,16.59344,58493
1529,chsnell,2,0.00342,9708,16.59686,58493
1530,clarktlaugh,2,0.00342,9710,16.60028,58493
1531,cloud-rocket,2,0.00342,9712,16.60370,58493
1532,CMseventeen,2,0.00342,9714,16.60712,58493
1533,coderFPV,2,0.00342,9716,16.61053,58493
1534,CoderOwl,2,0.00342,9718,16.61395,58493
1535,Coldln,2,0.00342,9720,16.61737,58493
1536,collimarco,2,0.00342,9722,16.62079,58493
1537,commanderrikker,2,0.00342,9724,16.62421,58493
1538,condor,2,0.00342,9726,16.62763,58493
1539,congliu01,2,0.00342,9728,16.63105,58493
1540,creactiviti,2,0.00342,9730,16.63447,58493
1541,cristifalcas,2,0.00342,9732,16.63789,58493
1542,ctohastek,2,0.00342,9734,16.64131,58493
1543,cwhatley,2,0.00342,9736,16.64473,58493
1544,CyanPZ,2,0.00342,9738,16.64815,58493
1545,cyberroadie,2,0.00342,9740,16.65157,58493
1546,cypherfox,2,0.00342,9742,16.65498,58493
1547,da125,2,0.00342,9744,16.65840,58493
1548,Dakadivya,2,0.00342,9746,16.66182,58493
1549,dana,2,0.00342,9748,16.66524,58493
1550,daparthi001,2,0.00342,9750,16.66866,58493
1551,daveb0t,2,0.00342,9752,16.67208,58493
1552,david-streamlio,2,0.00342,9754,16.67550,58493
1553,dawidrabiega,2,0.00342,9756,16.67892,58493
1554,dborysenko,2,0.00342,9758,16.68234,58493
1555,dbyron0,2,0.00342,9760,16.68576,58493
1556,dCSeven,2,0.00342,9762,16.68918,58493
1557,deancarr,2,0.00342,9764,16.69260,58493
1558,denji,2,0.00342,9766,16.69601,58493
1559,deripas,2,0.00342,9768,16.69943,58493
1560,dhiltonp,2,0.00342,9770,16.70285,58493
1561,didjcodt,2,0.00342,9772,16.70627,58493
1562,Dinidu,2,0.00342,9774,16.70969,58493
1563,djoker911,2,0.00342,9776,16.71311,58493
1564,dkarthi,2,0.00342,9778,16.71653,58493
1565,dmarkwat,2,0.00342,9780,16.71995,58493
1566,dmfenton,2,0.00342,9782,16.72337,58493
1567,dmitrycm,2,0.00342,9784,16.72679,58493
1568,dnascimento,2,0.00342,9786,16.73021,58493
1569,dotlambda,2,0.00342,9788,16.73363,58493
1570,dp-farm,2,0.00342,9790,16.73705,58493
1571,drshin81,2,0.00342,9792,16.74046,58493
1572,drywheat,2,0.00342,9794,16.74388,58493
1573,dumoknam,2,0.00342,9796,16.74730,58493
1574,DuskoV,2,0.00342,9798,16.75072,58493
1575,duxthefux,2,0.00342,9800,16.75414,58493
1576,duythinht,2,0.00342,9802,16.75756,58493
1577,dvdklnr,2,0.00342,9804,16.76098,58493
1578,dvfeinblum,2,0.00342,9806,16.76440,58493
1579,dypublic,2,0.00342,9808,16.76782,58493
1580,ealebed,2,0.00342,9810,16.77124,58493
1581,eddycharly,2,0.00342,9812,16.77466,58493
1582,edisonch,2,0.00342,9814,16.77808,58493
1583,eelke-at-bolt,2,0.00342,9816,16.78150,58493
1584,eiszfuchs,2,0.00342,9818,16.78491,58493
1585,e-koma,2,0.00342,9820,16.78833,58493
1586,elain,2,0.00342,9822,16.79175,58493
1587,eldad87,2,0.00342,9824,16.79517,58493
1588,eldondev,2,0.00342,9826,16.79859,58493
1589,elecay,2,0.00342,9828,16.80201,58493
1590,electromecca,2,0.00342,9830,16.80543,58493
1591,elyoncyber,2,0.00342,9832,16.80885,58493
1592,emcay,2,0.00342,9834,16.81227,58493
1593,emilaasa,2,0.00342,9836,16.81569,58493
1594,enami,2,0.00342,9838,16.81911,58493
1595,enm10k,2,0.00342,9840,16.82253,58493
1596,epelc,2,0.00342,9842,16.82594,58493
1597,erbdex,2,0.00342,9844,16.82936,58493
1598,ericdill,2,0.00342,9846,16.83278,58493
1599,ericyan,2,0.00342,9848,16.83620,58493
1600,eskornev,2,0.00342,9850,16.83962,58493
1601,esselius,2,0.00342,9852,16.84304,58493
1602,essh,2,0.00342,9854,16.84646,58493
1603,esteban1983cl,2,0.00342,9856,16.84988,58493
1604,ethanlieske,2,0.00342,9858,16.85330,58493
1605,etiennejournet,2,0.00342,9860,16.85672,58493
1606,etwillbefine,2,0.00342,9862,16.86014,58493
1607,eudoxa,2,0.00342,9864,16.86356,58493
1608,eugenetaranov,2,0.00342,9866,16.86698,58493
1609,EVODelavega,2,0.00342,9868,16.87039,58493
1610,eXtrem0us,2,0.00342,9870,16.87381,58493
1611,faisal-khalique,2,0.00342,9872,16.87723,58493
1612,fatroller,2,0.00342,9874,16.88065,58493
1613,fchiorascu,2,0.00342,9876,16.88407,58493
1614,ferbar,2,0.00342,9878,16.88749,58493
1615,fiskeben,2,0.00342,9880,16.89091,58493
1616,fizyk,2,0.00342,9882,16.89433,58493
1617,flypenguin,2,0.00342,9884,16.89775,58493
1618,forewei,2,0.00342,9886,16.90117,58493
1619,forging2012,2,0.00342,9888,16.90459,58493
1620,fradee,2,0.00342,9890,16.90801,58493
1621,francjohny,2,0.00342,9892,16.91143,58493
1622,frootkeyk,2,0.00342,9894,16.91484,58493
1623,fruuf,2,0.00342,9896,16.91826,58493
1624,fsperling,2,0.00342,9898,16.92168,58493
1625,fukata,2,0.00342,9900,16.92510,58493
1626,fukutomy,2,0.00342,9902,16.92852,58493
1627,funwun,2,0.00342,9904,16.93194,58493
1628,fvj,2,0.00342,9906,16.93536,58493
1629,fwojciak,2,0.00342,9908,16.93878,58493
1630,GAHila,2,0.00342,9910,16.94220,58493
1631,Ganezu79,2,0.00342,9912,16.94562,58493
1632,gatolim,2,0.00342,9914,16.94904,58493
1633,gauravaroraoyo,2,0.00342,9916,16.95246,58493
1634,gavin-shr,2,0.00342,9918,16.95588,58493
1635,gentoid,2,0.00342,9920,16.95929,58493
1636,geofffranks,2,0.00342,9922,16.96271,58493
1637,gerasym,2,0.00342,9924,16.96613,58493
1638,gerricchaplin,2,0.00342,9926,16.96955,58493
1639,gheon,2,0.00342,9928,16.97297,58493
1640,giannello,2,0.00342,9930,16.97639,58493
1641,gibban69,2,0.00342,9932,16.97981,58493
1642,gioialorusso,2,0.00342,9934,16.98323,58493
1643,gmlexx,2,0.00342,9936,16.98665,58493
1644,goelsatyam,2,0.00342,9938,16.99007,58493
1645,Gourds,2,0.00342,9940,16.99349,58493
1646,graniterocks,2,0.00342,9942,16.99691,58493
1647,Grant1219,2,0.00342,9944,17.00032,58493
1648,grayaii,2,0.00342,9946,17.00374,58493
1649,graysky,2,0.00342,9948,17.00716,58493
1650,greggilbert,2,0.00342,9950,17.01058,58493
1651,gregoryb,2,0.00342,9952,17.01400,58493
1652,groner,2,0.00342,9954,17.01742,58493
1653,grpubr,2,0.00342,9956,17.02084,58493
1654,gtrafimenkov,2,0.00342,9958,17.02426,58493
1655,gtt116,2,0.00342,9960,17.02768,58493
1656,guiocavalcanti,2,0.00342,9962,17.03110,58493
1657,h0tw1r3,2,0.00342,9964,17.03452,58493
1658,hackeracc,2,0.00342,9966,17.03794,58493
1659,hamishforbes,2,0.00342,9968,17.04136,58493
1660,hana-da,2,0.00342,9970,17.04477,58493
1661,hardcorexcat,2,0.00342,9972,17.04819,58493
1662,hashbrowncipher,2,0.00342,9974,17.05161,58493
1663,Hatayaman,2,0.00342,9976,17.05503,58493
1664,hayamiz,2,0.00342,9978,17.05845,58493
1665,hei-,2,0.00342,9980,17.06187,58493
1666,HenryYao369,2,0.00342,9982,17.06529,58493
1667,herrsebi,2,0.00342,9984,17.06871,58493
1668,heyaWorld,2,0.00342,9986,17.07213,58493
1669,hfm,2,0.00342,9988,17.07555,58493
1670,hiddletian,2,0.00342,9990,17.07897,58493
1671,hidetaka-f-matsumoto,2,0.00342,9992,17.08239,58493
1672,hir3npatel,2,0.00342,9994,17.08581,58493
1673,hiscal2015,2,0.00342,9996,17.08922,58493
1674,hligit,2,0.00342,9998,17.09264,58493
1675,hlosukwakha,2,0.00342,10000,17.09606,58493
1676,holajoyce,2,0.00342,10002,17.09948,58493
1677,holinnn,2,0.00342,10004,17.10290,58493
1678,HotdogWang,2,0.00342,10006,17.10632,58493
1679,Hugmeir,2,0.00342,10008,17.10974,58493
1680,iam404,2,0.00342,10010,17.11316,58493
1681,icpenguins,2,0.00342,10012,17.11658,58493
1682,igortin,2,0.00342,10014,17.12000,58493
1683,infa-ddeore,2,0.00342,10016,17.12342,58493
1684,inokappa,2,0.00342,10018,17.12684,58493
1685,inv-joby,2,0.00342,10020,17.13025,58493
1686,ioprotium,2,0.00342,10022,17.13367,58493
1687,itaiMona,2,0.00342,10024,17.13709,58493
1688,itayariel,2,0.00342,10026,17.14051,58493
1689,j0057,2,0.00342,10028,17.14393,58493
1690,jamesalford,2,0.00342,10030,17.14735,58493
1691,jan-warchol,2,0.00342,10032,17.15077,58493
1692,jasonzio,2,0.00342,10034,17.15419,58493
1693,javier-sanz,2,0.00342,10036,17.15761,58493
1694,jayson,2,0.00342,10038,17.16103,58493
1695,jbarreneche,2,0.00342,10040,17.16445,58493
1696,jbrownsc,2,0.00342,10042,17.16787,58493
1697,jcerjak,2,0.00342,10044,17.17129,58493
1698,jdirwin,2,0.00342,10046,17.17470,58493
1699,jdoss,2,0.00342,10048,17.17812,58493
1700,jdrago999,2,0.00342,10050,17.18154,58493
1701,jessebond2,2,0.00342,10052,17.18496,58493
1702,jfeeny,2,0.00342,10054,17.18838,58493
1703,jgunnink,2,0.00342,10056,17.19180,58493
1704,jhelmo,2,0.00342,10058,17.19522,58493
1705,jhuenges,2,0.00342,10060,17.19864,58493
1706,jicowan,2,0.00342,10062,17.20206,58493
1707,jigetage,2,0.00342,10064,17.20548,58493
1708,jinchaoxiang,2,0.00342,10066,17.20890,58493
1709,JinyongKim,2,0.00342,10068,17.21232,58493
1710,Jlonghi,2,0.00342,10070,17.21574,58493
1711,JoaquinSV,2,0.00342,10072,17.21915,58493
1712,joetym,2,0.00342,10074,17.22257,58493
1713,johanavril,2,0.00342,10076,17.22599,58493
1714,johne9087,2,0.00342,10078,17.22941,58493
1715,johnfg10,2,0.00342,10080,17.23283,58493
1716,johnmarcou,2,0.00342,10082,17.23625,58493
1717,JohnMealy23,2,0.00342,10084,17.23967,58493
1718,jokester,2,0.00342,10086,17.24309,58493
1719,JonathanSerafini,2,0.00342,10088,17.24651,58493
1720,jon-stumpf,2,0.00342,10090,17.24993,58493
1721,joshk0,2,0.00342,10092,17.25335,58493
1722,joshualan,2,0.00342,10094,17.25677,58493
1723,joyzhang-dd,2,0.00342,10096,17.26018,58493
1724,jpke,2,0.00342,10098,17.26360,58493
1725,jraby,2,0.00342,10100,17.26702,58493
1726,jsdoe,2,0.00342,10102,17.27044,58493
1727,juan-domenech,2,0.00342,10104,17.27386,58493
1728,JustinHead,2,0.00342,10106,17.27728,58493
1729,jzimmek,2,0.00342,10108,17.28070,58493
1730,Kageetai,2,0.00342,10110,17.28412,58493
1731,kalinkrustev,2,0.00342,10112,17.28754,58493
1732,kanupriya15025,2,0.00342,10114,17.29096,58493
1733,karthicgit,2,0.00342,10116,17.29438,58493
1734,karthikeayan,2,0.00342,10118,17.29780,58493
1735,katopz,2,0.00342,10120,17.30122,58493
1736,kayawari,2,0.00342,10122,17.30463,58493
1737,kaybinwong,2,0.00342,10124,17.30805,58493
1738,kazeula,2,0.00342,10126,17.31147,58493
1739,kbowerma,2,0.00342,10128,17.31489,58493
1740,kdeldycke,2,0.00342,10130,17.31831,58493
1741,kdevendran-branch,2,0.00342,10132,17.32173,58493
1742,khanage,2,0.00342,10134,17.32515,58493
1743,Kirchen99,2,0.00342,10136,17.32857,58493
1744,kjmrknsn,2,0.00342,10138,17.33199,58493
1745,kklemmicknvidia,2,0.00342,10140,17.33541,58493
1746,kkurten,2,0.00342,10142,17.33883,58493
1747,klo2k,2,0.00342,10144,17.34225,58493
1748,knockubo,2,0.00342,10146,17.34567,58493
1749,krysennn,2,0.00342,10148,17.34908,58493
1750,kSandr-ki,2,0.00342,10150,17.35250,58493
1751,kswapd,2,0.00342,10152,17.35592,58493
1752,kumavis,2,0.00342,10154,17.35934,58493
1753,kuromike0629,2,0.00342,10156,17.36276,58493
1754,kuroneko25,2,0.00342,10158,17.36618,58493
1755,kuzukami,2,0.00342,10160,17.36960,58493
1756,Kwelity,2,0.00342,10162,17.37302,58493
1757,kyentei,2,0.00342,10164,17.37644,58493
1758,lance-edmodo,2,0.00342,10166,17.37986,58493
1759,lang710,2,0.00342,10168,17.38328,58493
1760,leedohyun,2,0.00342,10170,17.38670,58493
1761,leehoawki,2,0.00342,10172,17.39012,58493
1762,LeeYearJ,2,0.00342,10174,17.39353,58493
1763,lel085,2,0.00342,10176,17.39695,58493
1764,Leninmarker,2,0.00342,10178,17.40037,58493
1765,lenoAlex,2,0.00342,10180,17.40379,58493
1766,lhucinequr,2,0.00342,10182,17.40721,58493
1767,lintingbin2009,2,0.00342,10184,17.41063,58493
1768,linzhaoming,2,0.00342,10186,17.41405,58493
1769,lionux2,2,0.00342,10188,17.41747,58493
1770,liuqianxin,2,0.00342,10190,17.42089,58493
1771,liusunpan,2,0.00342,10192,17.42431,58493
1772,ljagiello,2,0.00342,10194,17.42773,58493
1773,llernestal,2,0.00342,10196,17.43115,58493
1774,lstiebel,2,0.00342,10198,17.43456,58493
1775,lubouski,2,0.00342,10200,17.43798,58493
1776,lucaim,2,0.00342,10202,17.44140,58493
1777,lucj,2,0.00342,10204,17.44482,58493
1778,LudwigTirazona,2,0.00342,10206,17.44824,58493
1779,luopeng,2,0.00342,10208,17.45166,58493
1780,madamkiwi,2,0.00342,10210,17.45508,58493
1781,madfist,2,0.00342,10212,17.45850,58493
1782,Madhansudhan,2,0.00342,10214,17.46192,58493
1783,mafuyuk,2,0.00342,10216,17.46534,58493
1784,mandyjohar23,2,0.00342,10218,17.46876,58493
1785,Manikantan22,2,0.00342,10220,17.47218,58493
1786,manu844,2,0.00342,10222,17.47560,58493
1787,mapcuk,2,0.00342,10224,17.47901,58493
1788,marcin-je,2,0.00342,10226,17.48243,58493
1789,MarcSchmitzer,2,0.00342,10228,17.48585,58493
1790,marcy,2,0.00342,10230,17.48927,58493
1791,markgewurz,2,0.00342,10232,17.49269,58493
1792,MartinVUALTO,2,0.00342,10234,17.49611,58493
1793,mashiro,2,0.00342,10236,17.49953,58493
1794,masterada,2,0.00342,10238,17.50295,58493
1795,matrey,2,0.00342,10240,17.50637,58493
1796,matthewmodestino,2,0.00342,10242,17.50979,58493
1797,mattheworiordan,2,0.00342,10244,17.51321,58493
1798,Maxpain177,2,0.00342,10246,17.51663,58493
1799,maxsakharov,2,0.00342,10248,17.52005,58493
1800,mbenabda,2,0.00342,10250,17.52346,58493
1801,mbennett-zendesk,2,0.00342,10252,17.52688,58493
1802,mcgeeco,2,0.00342,10254,17.53030,58493
1803,mcswaroop19,2,0.00342,10256,17.53372,58493
1804,mcuelenaere,2,0.00342,10258,17.53714,58493
1805,medox,2,0.00342,10260,17.54056,58493
1806,medzin,2,0.00342,10262,17.54398,58493
1807,memosstilvi,2,0.00342,10264,17.54740,58493
1808,meoooh,2,0.00342,10266,17.55082,58493
1809,MerkAndreas,2,0.00342,10268,17.55424,58493
1810,mffiedler,2,0.00342,10270,17.55766,58493
1811,mgherman,2,0.00342,10272,17.56108,58493
1812,mgsh,2,0.00342,10274,17.56449,58493
1813,mhoshino,2,0.00342,10276,17.56791,58493
1814,michaelharrer,2,0.00342,10278,17.57133,58493
1815,michaelsteiner,2,0.00342,10280,17.57475,58493
1816,michimartini,2,0.00342,10282,17.57817,58493
1817,mihir2402,2,0.00342,10284,17.58159,58493
1818,mineyang,2,0.00342,10286,17.58501,58493
1819,mingqi,2,0.00342,10288,17.58843,58493
1820,mitchhh22,2,0.00342,10290,17.59185,58493
1821,mkorkalo,2,0.00342,10292,17.59527,58493
1822,m-masaki,2,0.00342,10294,17.59869,58493
1823,mmlb,2,0.00342,10296,17.60211,58493
1824,moaikids,2,0.00342,10298,17.60553,58493
1825,moccos,2,0.00342,10300,17.60894,58493
1826,moeryomenko,2,0.00342,10302,17.61236,58493
1827,mohdahmad17,2,0.00342,10304,17.61578,58493
1828,mohit-gupta,2,0.00342,10306,17.61920,58493
1829,mohitkhanna,2,0.00342,10308,17.62262,58493
1830,mooperd,2,0.00342,10310,17.62604,58493
1831,Mosibi,2,0.00342,10312,17.62946,58493
1832,motemen,2,0.00342,10314,17.63288,58493
1833,moznion,2,0.00342,10316,17.63630,58493
1834,mperezco,2,0.00342,10318,17.63972,58493
1835,mplachter,2,0.00342,10320,17.64314,58493
1836,mraczynska,2,0.00342,10322,17.64656,58493
1837,mrdulin,2,0.00342,10324,17.64998,58493
1838,mrkn,2,0.00342,10326,17.65339,58493
1839,mrkstate,2,0.00342,10328,17.65681,58493
1840,mrnonz,2,0.00342,10330,17.66023,58493
1841,mrozentsvayg,2,0.00342,10332,17.66365,58493
1842,muddydixon,2,0.00342,10334,17.66707,58493
1843,muhahacz,2,0.00342,10336,17.67049,58493
1844,muuuuwa,2,0.00342,10338,17.67391,58493
1845,Mvpanswer7,2,0.00342,10340,17.67733,58493
1846,my-dev,2,0.00342,10342,17.68075,58493
1847,Mymetique,2,0.00342,10344,17.68417,58493
1848,nagata-logly,2,0.00342,10346,17.68759,58493
1849,nareshnani529,2,0.00342,10348,17.69101,58493
1850,navaati,2,0.00342,10350,17.69442,58493
1851,nazar554,2,0.00342,10352,17.69784,58493
1852,nbaoping,2,0.00342,10354,17.70126,58493
1853,ncepuwanghui,2,0.00342,10356,17.70468,58493
1854,Nebulis,2,0.00342,10358,17.70810,58493
1855,neeravarora,2,0.00342,10360,17.71152,58493
1856,nelson-ks,2,0.00342,10362,17.71494,58493
1857,Neozaru,2,0.00342,10364,17.71836,58493
1858,nevill,2,0.00342,10366,17.72178,58493
1859,Nevon,2,0.00342,10368,17.72520,58493
1860,newbenji,2,0.00342,10370,17.72862,58493
1861,nfo,2,0.00342,10372,17.73204,58493
1862,nhosoi,2,0.00342,10374,17.73546,58493
1863,nico1106,2,0.00342,10376,17.73887,58493
1864,NidhiArien,2,0.00342,10378,17.74229,58493
1865,nieldomingo,2,0.00342,10380,17.74571,58493
1866,NikhilTejSR,2,0.00342,10382,17.74913,58493
1867,niku,2,0.00342,10384,17.75255,58493
1868,nitzanav,2,0.00342,10386,17.75597,58493
1869,nkrendel,2,0.00342,10388,17.75939,58493
1870,nnovikov,2,0.00342,10390,17.76281,58493
1871,noodle-rubrik,2,0.00342,10392,17.76623,58493
1872,noraesae,2,0.00342,10394,17.76965,58493
1873,normander,2,0.00342,10396,17.77307,58493
1874,Ntzafrir,2,0.00342,10398,17.77649,58493
1875,nvx,2,0.00342,10400,17.77991,58493
1876,obilliard,2,0.00342,10402,17.78332,58493
1877,obokaiwele,2,0.00342,10404,17.78674,58493
1878,obsoleter,2,0.00342,10406,17.79016,58493
1879,oengel,2,0.00342,10408,17.79358,58493
1880,Ohmen,2,0.00342,10410,17.79700,58493
1881,okashino,2,0.00342,10412,17.80042,58493
1882,Oleg2tor,2,0.00342,10414,17.80384,58493
1883,orasik,2,0.00342,10416,17.80726,58493
1884,orfah,2,0.00342,10418,17.81068,58493
1885,orlangure,2,0.00342,10420,17.81410,58493
1886,ormico,2,0.00342,10422,17.81752,58493
1887,osiegmar,2,0.00342,10424,17.82094,58493
1888,oytuntez,2,0.00342,10426,17.82436,58493
1889,pankajagrawal16,2,0.00342,10428,17.82777,58493
1890,parkhyeonghwa,2,0.00342,10430,17.83119,58493
1891,patrickleboutillier,2,0.00342,10432,17.83461,58493
1892,pbartoszek,2,0.00342,10434,17.83803,58493
1893,pbialasiewicz,2,0.00342,10436,17.84145,58493
1894,pckhoi,2,0.00342,10438,17.84487,58493
1895,pedromazala,2,0.00342,10440,17.84829,58493
1896,pgrm,2,0.00342,10442,17.85171,58493
1897,pguz,2,0.00342,10444,17.85513,58493
1898,piotrkochan,2,0.00342,10446,17.85855,58493
1899,pkeuter,2,0.00342,10448,17.86197,58493
1900,Place1,2,0.00342,10450,17.86539,58493
1901,plicease,2,0.00342,10452,17.86880,58493
1902,pms1969,2,0.00342,10454,17.87222,58493
1903,pointbre,2,0.00342,10456,17.87564,58493
1904,porterja31,2,0.00342,10458,17.87906,58493
1905,prabinsubedi,2,0.00342,10460,17.88248,58493
1906,prtk-ngm,2,0.00342,10462,17.88590,58493
1907,pseudobeer,2,0.00342,10464,17.88932,58493
1908,pxcurtis,2,0.00342,10466,17.89274,58493
1909,qingchuwudi,2,0.00342,10468,17.89616,58493
1910,qnapnickchang,2,0.00342,10470,17.89958,58493
1911,quiver,2,0.00342,10472,17.90300,58493
1912,qwiggy,2,0.00342,10474,17.90642,58493
1913,raf-d,2,0.00342,10476,17.90984,58493
1914,rahulprasad31121988,2,0.00342,10478,17.91325,58493
1915,rajputvishwas,2,0.00342,10480,17.91667,58493
1916,rashmichandrashekar,2,0.00342,10482,17.92009,58493
1917,ravvereddy,2,0.00342,10484,17.92351,58493
1918,rb-johnmurphy,2,0.00342,10486,17.92693,58493
1919,rch850,2,0.00342,10488,17.93035,58493
1920,rcsavage,2,0.00342,10490,17.93377,58493
1921,rdcastro,2,0.00342,10492,17.93719,58493
1922,RedactedProfile,2,0.00342,10494,17.94061,58493
1923,ReDim42,2,0.00342,10496,17.94403,58493
1924,reedflinch,2,0.00342,10498,17.94745,58493
1925,ReenaAcharya,2,0.00342,10500,17.95087,58493
1926,Reifier,2,0.00342,10502,17.95429,58493
1927,reimarstier,2,0.00342,10504,17.95770,58493
1928,Reiner030,2,0.00342,10506,17.96112,58493
1929,rektide,2,0.00342,10508,17.96454,58493
1930,restyler,2,0.00342,10510,17.96796,58493
1931,rgarcia,2,0.00342,10512,17.97138,58493
1932,rhefner1,2,0.00342,10514,17.97480,58493
1933,rhonnava,2,0.00342,10516,17.97822,58493
1934,rhroach,2,0.00342,10518,17.98164,58493
1935,rigsby-chi,2,0.00342,10520,17.98506,58493
1936,rijoparakkal,2,0.00342,10522,17.98848,58493
1937,rishisharmamt,2,0.00342,10524,17.99190,58493
1938,rjemanuele,2,0.00342,10526,17.99532,58493
1939,rjshrjndrn,2,0.00342,10528,17.99873,58493
1940,rmcclaincf,2,0.00342,10530,18.00215,58493
1941,robert-7,2,0.00342,10532,18.00557,58493
1942,robertlamarre,2,0.00342,10534,18.00899,58493
1943,robertomiranda,2,0.00342,10536,18.01241,58493
1944,roche-d,2,0.00342,10538,18.01583,58493
1945,roicostas,2,0.00342,10540,18.01925,58493
1946,rolindroy,2,0.00342,10542,18.02267,58493
1947,romanvbabenko,2,0.00342,10544,18.02609,58493
1948,rpelissi,2,0.00342,10546,18.02951,58493
1949,rqc,2,0.00342,10548,18.03293,58493
1950,rsingh2411,2,0.00342,10550,18.03635,58493
1951,rtusys,2,0.00342,10552,18.03977,58493
1952,rverma-nikiai,2,0.00342,10554,18.04318,58493
1953,ryanc4,2,0.00342,10556,18.04660,58493
1954,ryhamz,2,0.00342,10558,18.05002,58493
1955,S569,2,0.00342,10560,18.05344,58493
1956,sagis-tikal,2,0.00342,10562,18.05686,58493
1957,sallespro,2,0.00342,10564,18.06028,58493
1958,sanjuicgithub,2,0.00342,10566,18.06370,58493
1959,sankujain,2,0.00342,10568,18.06712,58493
1960,sanmingzi,2,0.00342,10570,18.07054,58493
1961,sapg,2,0.00342,10572,18.07396,58493
1962,sashich,2,0.00342,10574,18.07738,58493
1963,satharasidineah,2,0.00342,10576,18.08080,58493
1964,satousan,2,0.00342,10578,18.08422,58493
1965,saturday-shi,2,0.00342,10580,18.08763,58493
1966,satyatumati,2,0.00342,10582,18.09105,58493
1967,schasse,2,0.00342,10584,18.09447,58493
1968,sebastianmacarescu,2,0.00342,10586,18.09789,58493
1969,sebbacon,2,0.00342,10588,18.10131,58493
1970,seelam,2,0.00342,10590,18.10473,58493
1971,segfault,2,0.00342,10592,18.10815,58493
1972,serafettin,2,0.00342,10594,18.11157,58493
1973,serain,2,0.00342,10596,18.11499,58493
1974,sergeyfedotov,2,0.00342,10598,18.11841,58493
1975,SergiyYarinovskiy,2,0.00342,10600,18.12183,58493
1976,seufagner,2,0.00342,10602,18.12525,58493
1977,ShankarSumanth,2,0.00342,10604,18.12866,58493
1978,She1d0n,2,0.00342,10606,18.13208,58493
1979,shihch,2,0.00342,10608,18.13550,58493
1980,shineforever,2,0.00342,10610,18.13892,58493
1981,ShivakumarSwamy,2,0.00342,10612,18.14234,58493
1982,shivamdixit,2,0.00342,10614,18.14576,58493
1983,shkhisti,2,0.00342,10616,18.14918,58493
1984,shogo82148,2,0.00342,10618,18.15260,58493
1985,Shota-Tajiri,2,0.00342,10620,18.15602,58493
1986,sidcarter,2,0.00342,10622,18.15944,58493
1987,simonxmh,2,0.00342,10624,18.16286,58493
1988,sio2k,2,0.00342,10626,18.16628,58493
1989,siroken3,2,0.00342,10628,18.16970,58493
1990,skdasarin00b,2,0.00342,10630,18.17311,58493
1991,SkeLLLa,2,0.00342,10632,18.17653,58493
1992,sleongkoan,2,0.00342,10634,18.17995,58493
1993,sliuu,2,0.00342,10636,18.18337,58493
1994,s-mansouri,2,0.00342,10638,18.18679,58493
1995,smirgel,2,0.00342,10640,18.19021,58493
1996,smith-30,2,0.00342,10642,18.19363,58493
1997,sohaibmaroof,2,0.00342,10644,18.19705,58493
1998,solacens,2,0.00342,10646,18.20047,58493
1999,solatch,2,0.00342,10648,18.20389,58493
2000,someword,2,0.00342,10650,18.20731,58493
2001,sovioletta,2,0.00342,10652,18.21073,58493
2002,sparkle,2,0.00342,10654,18.21415,58493
2003,spkesan,2,0.00342,10656,18.21756,58493
2004,sradco,2,0.00342,10658,18.22098,58493
2005,sriramflydata,2,0.00342,10660,18.22440,58493
2006,sriv1211,2,0.00342,10662,18.22782,58493
2007,stalkerg,2,0.00342,10664,18.23124,58493
2008,stanaka,2,0.00342,10666,18.23466,58493
2009,StanikLukasz,2,0.00342,10668,18.23808,58493
2010,starkers,2,0.00342,10670,18.24150,58493
2011,stefk,2,0.00342,10672,18.24492,58493
2012,stronny,2,0.00342,10674,18.24834,58493
2013,studio3104,2,0.00342,10676,18.25176,58493
2014,suanziliu,2,0.00342,10678,18.25518,58493
2015,sumeethtewar,2,0.00342,10680,18.25860,58493
2016,superkjp,2,0.00342,10682,18.26201,58493
2017,supermock,2,0.00342,10684,18.26543,58493
2018,svengau,2,0.00342,10686,18.26885,58493
2019,svenkin,2,0.00342,10688,18.27227,58493
2020,SylvainDe,2,0.00342,10690,18.27569,58493
2021,sylvainkalache,2,0.00342,10692,18.27911,58493
2022,szepeviktor,2,0.00342,10694,18.28253,58493
2023,tacahilo,2,0.00342,10696,18.28595,58493
2024,takuan-osho,2,0.00342,10698,18.28937,58493
2025,taneli76,2,0.00342,10700,18.29279,58493
2026,TanTan-TT,2,0.00342,10702,18.29621,58493
2027,TarekAS,2,0.00342,10704,18.29963,58493
2028,tcnksm,2,0.00342,10706,18.30304,58493
2029,tdtds,2,0.00342,10708,18.30646,58493
2030,teamcitytest3,2,0.00342,10710,18.30988,58493
2031,tejaswi1234,2,0.00342,10712,18.31330,58493
2032,thbishop,2,0.00342,10714,18.31672,58493
2033,theasp,2,0.00342,10716,18.32014,58493
2034,TheCoderGuyVlad,2,0.00342,10718,18.32356,58493
2035,thekorn,2,0.00342,10720,18.32698,58493
2036,themadprofessor,2,0.00342,10722,18.33040,58493
2037,ThibautGery,2,0.00342,10724,18.33382,58493
2038,ThorstenKunz,2,0.00342,10726,18.33724,58493
2039,timesking,2,0.00342,10728,18.34066,58493
2040,Timoses,2,0.00342,10730,18.34408,58493
2041,timuckun,2,0.00342,10732,18.34749,58493
2042,tkporter,2,0.00342,10734,18.35091,58493
2043,tmdoit,2,0.00342,10736,18.35433,58493
2044,toconnor,2,0.00342,10738,18.35775,58493
2045,toddams,2,0.00342,10740,18.36117,58493
2046,TomaszKlosinski,2,0.00342,10742,18.36459,58493
2047,tomiloza,2,0.00342,10744,18.36801,58493
2048,TomMizrachi,2,0.00342,10746,18.37143,58493
2049,ton-katsu,2,0.00342,10748,18.37485,58493
2050,toshikidoi,2,0.00342,10750,18.37827,58493
2051,tranchitella,2,0.00342,10752,18.38169,58493
2052,trevorndodds,2,0.00342,10754,18.38511,58493
2053,Tri0L,2,0.00342,10756,18.38853,58493
2054,tritruong,2,0.00342,10758,18.39194,58493
2055,Tsidkenu,2,0.00342,10760,18.39536,58493
2056,tthayer,2,0.00342,10762,18.39878,58493
2057,tuchodi,2,0.00342,10764,18.40220,58493
2058,tuxtek,2,0.00342,10766,18.40562,58493
2059,tuxtof,2,0.00342,10768,18.40904,58493
2060,typ431127,2,0.00342,10770,18.41246,58493
2061,uhaciogullari,2,0.00342,10772,18.41588,58493
2062,UkrainianProgrammer,2,0.00342,10774,18.41930,58493
2063,usk,2,0.00342,10776,18.42272,58493
2064,utshav2008,2,0.00342,10778,18.42614,58493
2065,uyu423,2,0.00342,10780,18.42956,58493
2066,valkolaci,2,0.00342,10782,18.43297,58493
2067,VarunSrinivasa,2,0.00342,10784,18.43639,58493
2068,varun-tdt,2,0.00342,10786,18.43981,58493
2069,vascoosx,2,0.00342,10788,18.44323,58493
2070,vezir,2,0.00342,10790,18.44665,58493
2071,vidhy,2,0.00342,10792,18.45007,58493
2072,vikashsingh005,2,0.00342,10794,18.45349,58493
2073,viljaste,2,0.00342,10796,18.45691,58493
2074,vinayakm340,2,0.00342,10798,18.46033,58493
2075,vinbie,2,0.00342,10800,18.46375,58493
2076,vincent927,2,0.00342,10802,18.46717,58493
2077,VincentCouzij,2,0.00342,10804,18.47059,58493
2078,visla,2,0.00342,10806,18.47401,58493
2079,viveksinghggits,2,0.00342,10808,18.47742,58493
2080,voltige,2,0.00342,10810,18.48084,58493
2081,voxxit,2,0.00342,10812,18.48426,58493
2082,vsdoradla,2,0.00342,10814,18.48768,58493
2083,vyscond,2,0.00342,10816,18.49110,58493
2084,w821881341,2,0.00342,10818,18.49452,58493
2085,walktall,2,0.00342,10820,18.49794,58493
2086,wanghaisheng,2,0.00342,10822,18.50136,58493
2087,warrenackerman,2,0.00342,10824,18.50478,58493
2088,watnotte,2,0.00342,10826,18.50820,58493
2089,willemt,2,0.00342,10828,18.51162,58493
2090,willmao,2,0.00342,10830,18.51504,58493
2091,wimnat,2,0.00342,10832,18.51846,58493
2092,winstonwp,2,0.00342,10834,18.52187,58493
2093,wolfthegray,2,0.00342,10836,18.52529,58493
2094,worrel,2,0.00342,10838,18.52871,58493
2095,wpengcheng,2,0.00342,10840,18.53213,58493
2096,wuchencm,2,0.00342,10842,18.53555,58493
2097,wujiandong,2,0.00342,10844,18.53897,58493
2098,wukq,2,0.00342,10846,18.54239,58493
2099,wxy325,2,0.00342,10848,18.54581,58493
2100,x-fauzan-x,2,0.00342,10850,18.54923,58493
2101,xluffy,2,0.00342,10852,18.55265,58493
2102,xuanyuanaosheng,2,0.00342,10854,18.55607,58493
2103,xu-xiang,2,0.00342,10856,18.55949,58493
2104,xx-zhang,2,0.00342,10858,18.56290,58493
2105,yeruvass,2,0.00342,10860,18.56632,58493
2106,yichingwu,2,0.00342,10862,18.56974,58493
2107,yienge,2,0.00342,10864,18.57316,58493
2108,ykitac,2,0.00342,10866,18.57658,58493
2109,ymchun,2,0.00342,10868,18.58000,58493
2110,YohaanYoon,2,0.00342,10870,18.58342,58493
2111,yudai09,2,0.00342,10872,18.58684,58493
2112,yuha0,2,0.00342,10874,18.59026,58493
2113,yusufgungor,2,0.00342,10876,18.59368,58493
2114,yuxing1994,2,0.00342,10878,18.59710,58493
2115,zaa,2,0.00342,10880,18.60052,58493
2116,zacharynevin,2,0.00342,10882,18.60394,58493
2117,zackwine,2,0.00342,10884,18.60735,58493
2118,zanoubia,2,0.00342,10886,18.61077,58493
2119,zedtux,2,0.00342,10888,18.61419,58493
2120,zeph,2,0.00342,10890,18.61761,58493
2121,zhaohangbo,2,0.00342,10892,18.62103,58493
2122,zhaominmail,2,0.00342,10894,18.62445,58493
2123,zhelyan,2,0.00342,10896,18.62787,58493
2124,zkcarterlau,2,0.00342,10898,18.63129,58493
2125,znz,2,0.00342,10900,18.63471,58493
2126,ZP-AlwaysWin,2,0.00342,10902,18.63813,58493
2127,zpavlig,2,0.00342,10904,18.64155,58493
2128,zrochler,2,0.00342,10906,18.64497,58493
2129,0x17de,1,0.00171,10907,18.64668,58493
2130,1mentat,1,0.00171,10908,18.64839,58493
2131,4680185,1,0.00171,10909,18.65009,58493
2132,899,1,0.00171,10910,18.65180,58493
2133,a6kme,1,0.00171,10911,18.65351,58493
2134,aahmed-se,1,0.00171,10912,18.65522,58493
2135,aarunkushwahaa,1,0.00171,10913,18.65693,58493
2136,aarvee11,1,0.00171,10914,18.65864,58493
2137,aatkinson-canopy,1,0.00171,10915,18.66035,58493
2138,AbdulHaseebHussain,1,0.00171,10916,18.66206,58493
2139,abernardino,1,0.00171,10917,18.66377,58493
2140,abhishek063,1,0.00171,10918,18.66548,58493
2141,abhishekwy,1,0.00171,10919,18.66719,58493
2142,abhiTamrakar,1,0.00171,10920,18.66890,58493
2143,abijitn,1,0.00171,10921,18.67061,58493
2144,abrakhim,1,0.00171,10922,18.67232,58493
2145,acty-yoshida,1,0.00171,10923,18.67403,58493
2146,adamjerickson,1,0.00171,10924,18.67574,58493
2147,adeesent,1,0.00171,10925,18.67745,58493
2148,ademars94,1,0.00171,10926,18.67916,58493
2149,aderuwe,1,0.00171,10927,18.68087,58493
2150,adichiru,1,0.00171,10928,18.68258,58493
2151,adonishi,1,0.00171,10929,18.68429,58493
2152,adriancdperu,1,0.00171,10930,18.68600,58493
2153,adrianguenter,1,0.00171,10931,18.68771,58493
2154,adrianog,1,0.00171,10932,18.68942,58493
2155,adw1n,1,0.00171,10933,18.69113,58493
2156,aeibrahim,1,0.00171,10934,18.69284,58493
2157,afeld,1,0.00171,10935,18.69454,58493
2158,afking,1,0.00171,10936,18.69625,58493
2159,agarwalshivam456,1,0.00171,10937,18.69796,58493
2160,agasbzj,1,0.00171,10938,18.69967,58493
2161,aggarwalShivani,1,0.00171,10939,18.70138,58493
2162,agrozyme,1,0.00171,10940,18.70309,58493
2163,agsimeonov,1,0.00171,10941,18.70480,58493
2164,ahacking,1,0.00171,10942,18.70651,58493
2165,aheimowitz,1,0.00171,10943,18.70822,58493
2166,aibou,1,0.00171,10944,18.70993,58493
2167,aiueogawa,1,0.00171,10945,18.71164,58493
2168,AixNPanes,1,0.00171,10946,18.71335,58493
2169,akgunjal,1,0.00171,10947,18.71506,58493
2170,akhilkumarpdd,1,0.00171,10948,18.71677,58493
2171,aki017,1,0.00171,10949,18.71848,58493
2172,akirakiron,1,0.00171,10950,18.72019,58493
2173,akkie,1,0.00171,10951,18.72190,58493
2174,akngs,1,0.00171,10952,18.72361,58493
2175,Akshay-Iyangar,1,0.00171,10953,18.72532,58493
2176,akunaatrium,1,0.00171,10954,18.72703,58493
2177,alamzeeshan,1,0.00171,10955,18.72874,58493
2178,alanh0vx,1,0.00171,10956,18.73045,58493
2179,Alars-ALIT,1,0.00171,10957,18.73216,58493
2180,AlecIsaacson,1,0.00171,10958,18.73387,58493
2181,aleks-mariusz,1,0.00171,10959,18.73558,58493
2182,alexanderGalushka,1,0.00171,10960,18.73728,58493
2183,alexcurtin,1,0.00171,10961,18.73899,58493
2184,AlexGaspar,1,0.00171,10962,18.74070,58493
2185,alex-kovshovik,1,0.00171,10963,18.74241,58493
2186,alexlehm,1,0.00171,10964,18.74412,58493
2187,AlexProfi,1,0.00171,10965,18.74583,58493
2188,AlexRRR,1,0.00171,10966,18.74754,58493
2189,alexxed,1,0.00171,10967,18.74925,58493
2190,ALFNeT,1,0.00171,10968,18.75096,58493
2191,alihalabyah,1,0.00171,10969,18.75267,58493
2192,allamiro1,1,0.00171,10970,18.75438,58493
2193,allenbang,1,0.00171,10971,18.75609,58493
2194,Allesgluck,1,0.00171,10972,18.75780,58493
2195,alogoc,1,0.00171,10973,18.75951,58493
2196,alvinhom,1,0.00171,10974,18.76122,58493
2197,amgohan,1,0.00171,10975,18.76293,58493
2198,amit-uc,1,0.00171,10976,18.76464,58493
2199,analytically,1,0.00171,10977,18.76635,58493
2200,andlaz,1,0.00171,10978,18.76806,58493
2201,andreacasini,1,0.00171,10979,18.76977,58493
2202,andreek,1,0.00171,10980,18.77148,58493
2203,andrei-galkin,1,0.00171,10981,18.77319,58493
2204,AndresPineros,1,0.00171,10982,18.77490,58493
2205,AndrewBoklashko,1,0.00171,10983,18.77661,58493
2206,andrewnazarov,1,0.00171,10984,18.77832,58493
2207,AndrewX192,1,0.00171,10985,18.78002,58493
2208,andyliddle,1,0.00171,10986,18.78173,58493
2209,andywow,1,0.00171,10987,18.78344,58493
2210,andyy5,1,0.00171,10988,18.78515,58493
2211,aneagoe,1,0.00171,10989,18.78686,58493
2212,AngryGami,1,0.00171,10990,18.78857,58493
2213,aniamin,1,0.00171,10991,18.79028,58493
2214,AnishAnil,1,0.00171,10992,18.79199,58493
2215,aniskhan001,1,0.00171,10993,18.79370,58493
2216,ankkumar-progress,1,0.00171,10994,18.79541,58493
2217,Ankushaccc,1,0.00171,10995,18.79712,58493
2218,annymsMthd,1,0.00171,10996,18.79883,58493
2219,anoopsmai,1,0.00171,10997,18.80054,58493
2220,anoopvm,1,0.00171,10998,18.80225,58493
2221,antho31,1,0.00171,10999,18.80396,58493
2222,aotenko,1,0.00171,11000,18.80567,58493
2223,apacoco9861,1,0.00171,11001,18.80738,58493
2224,apchee,1,0.00171,11002,18.80909,58493
2225,aperigault,1,0.00171,11003,18.81080,58493
2226,AphexFX,1,0.00171,11004,18.81251,58493
2227,aplulu,1,0.00171,11005,18.81422,58493
2228,aptranj,1,0.00171,11006,18.81593,58493
2229,aranair,1,0.00171,11007,18.81764,58493
2230,arangyupgrade,1,0.00171,11008,18.81935,58493
2231,arascanakin,1,0.00171,11009,18.82106,58493
2232,arbenibeni,1,0.00171,11010,18.82277,58493
2233,archie,1,0.00171,11011,18.82447,58493
2234,arcsector,1,0.00171,11012,18.82618,58493
2235,arienchen,1,0.00171,11013,18.82789,58493
2236,arittner,1,0.00171,11014,18.82960,58493
2237,arjun-urs,1,0.00171,11015,18.83131,58493
2238,arnitolog,1,0.00171,11016,18.83302,58493
2239,arrow003,1,0.00171,11017,18.83473,58493
2240,artash,1,0.00171,11018,18.83644,58493
2241,artbeglaryan,1,0.00171,11019,18.83815,58493
2242,ArthurasJ,1,0.00171,11020,18.83986,58493
2243,ArturZurawski,1,0.00171,11021,18.84157,58493
2244,arunapavan,1,0.00171,11022,18.84328,58493
2245,ArunDahiya1,1,0.00171,11023,18.84499,58493
2246,aruruka,1,0.00171,11024,18.84670,58493
2247,arvind-naidu,1,0.00171,11025,18.84841,58493
2248,asbish,1,0.00171,11026,18.85012,58493
2249,aschofie,1,0.00171,11027,18.85183,58493
2250,asdfgasfhsn,1,0.00171,11028,18.85354,58493
2251,ash0080,1,0.00171,11029,18.85525,58493
2252,ashmckenzie,1,0.00171,11030,18.85696,58493
2253,ashokkkannan,1,0.00171,11031,18.85867,58493
2254,ashramsey,1,0.00171,11032,18.86038,58493
2255,asumawang,1,0.00171,11033,18.86209,58493
2256,asvinours,1,0.00171,11034,18.86380,58493
2257,athoune,1,0.00171,11035,18.86551,58493
2258,athurg,1,0.00171,11036,18.86721,58493
2259,atikhonov-avito,1,0.00171,11037,18.86892,58493
2260,atm1992,1,0.00171,11038,18.87063,58493
2261,aturri,1,0.00171,11039,18.87234,58493
2262,averri,1,0.00171,11040,18.87405,58493
2263,ayElwany,1,0.00171,11041,18.87576,58493
2264,az3,1,0.00171,11042,18.87747,58493
2265,azhi,1,0.00171,11043,18.87918,58493
2266,azhurbilo,1,0.00171,11044,18.88089,58493
2267,baaree,1,0.00171,11045,18.88260,58493
2268,baldomeromero,1,0.00171,11046,18.88431,58493
2269,bathizte,1,0.00171,11047,18.88602,58493
2270,bbcnt,1,0.00171,11048,18.88773,58493
2271,bbc-tomfitzhenry,1,0.00171,11049,18.88944,58493
2272,bcottinghamae,1,0.00171,11050,18.89115,58493
2273,bdnf,1,0.00171,11051,18.89286,58493
2274,bdqnghi,1,0.00171,11052,18.89457,58493
2275,belaytzev,1,0.00171,11053,18.89628,58493
2276,beng-beng,1,0.00171,11054,18.89799,58493
2277,benjaminhuo,1,0.00171,11055,18.89970,58493
2278,ben-lei,1,0.00171,11056,18.90141,58493
2279,benoitc,1,0.00171,11057,18.90312,58493
2280,beornf,1,0.00171,11058,18.90483,58493
2281,bergerx,1,0.00171,11059,18.90654,58493
2282,Berndinox,1,0.00171,11060,18.90825,58493
2283,bf4,1,0.00171,11061,18.90996,58493
2284,bguerout,1,0.00171,11062,18.91166,58493
2285,BhartiAgrawalNvidia,1,0.00171,11063,18.91337,58493
2286,bhaskar-chenchu,1,0.00171,11064,18.91508,58493
2287,Bhaskars,1,0.00171,11065,18.91679,58493
2288,bhattchaitanya,1,0.00171,11066,18.91850,58493
2289,bhavishyagopesh,1,0.00171,11067,18.92021,58493
2290,bhavyabhatj,1,0.00171,11068,18.92192,58493
2291,bhvishal9,1,0.00171,11069,18.92363,58493
2292,Bidhanbst,1,0.00171,11070,18.92534,58493
2293,bijaya1,1,0.00171,11071,18.92705,58493
2294,bikkinamahesh369,1,0.00171,11072,18.92876,58493
2295,binarylogic,1,0.00171,11073,18.93047,58493
2296,binarymechanic,1,0.00171,11074,18.93218,58493
2297,bitc,1,0.00171,11075,18.93389,58493
2298,bit-wrangler,1,0.00171,11076,18.93560,58493
2299,BjergsenZhu,1,0.00171,11077,18.93731,58493
2300,bkayranci,1,0.00171,11078,18.93902,58493
2301,bl000b,1,0.00171,11079,18.94073,58493
2302,Blackbam,1,0.00171,11080,18.94244,58493
2303,blackholegalaxy,1,0.00171,11081,18.94415,58493
2304,bliemli,1,0.00171,11082,18.94586,58493
2305,blogwatcher-gi,1,0.00171,11083,18.94757,58493
2306,bmalynovytch,1,0.00171,11084,18.94928,58493
2307,Bobi-zhou,1,0.00171,11085,18.95099,58493
2308,bodsch,1,0.00171,11086,18.95270,58493
2309,boenr1,1,0.00171,11087,18.95440,58493
2310,bogdanRada,1,0.00171,11088,18.95611,58493
2311,bonczj,1,0.00171,11089,18.95782,58493
2312,boodera,1,0.00171,11090,18.95953,58493
2313,boumitran,1,0.00171,11091,18.96124,58493
2314,BoundInfinity,1,0.00171,11092,18.96295,58493
2315,bozhou94,1,0.00171,11093,18.96466,58493
2316,bozydar,1,0.00171,11094,18.96637,58493
2317,bpsizemore,1,0.00171,11095,18.96808,58493
2318,bradwilson,1,0.00171,11096,18.96979,58493
2319,bratislavml,1,0.00171,11097,18.97150,58493
2320,breeze7086,1,0.00171,11098,18.97321,58493
2321,brendanly,1,0.00171,11099,18.97492,58493
2322,brettrann,1,0.00171,11100,18.97663,58493
2323,brifordwylie,1,0.00171,11101,18.97834,58493
2324,brightzheng100,1,0.00171,11102,18.98005,58493
2325,brokencube,1,0.00171,11103,18.98176,58493
2326,browny,1,0.00171,11104,18.98347,58493
2327,brunsgaard,1,0.00171,11105,18.98518,58493
2328,bryan831,1,0.00171,11106,18.98689,58493
2329,bryanyork,1,0.00171,11107,18.98860,58493
2330,bschwartz757,1,0.00171,11108,18.99031,58493
2331,btucker,1,0.00171,11109,18.99202,58493
2332,buarmin,1,0.00171,11110,18.99373,58493
2333,buch11,1,0.00171,11111,18.99544,58493
2334,buchmui,1,0.00171,11112,18.99714,58493
2335,burandobata,1,0.00171,11113,18.99885,58493
2336,bwolfehcm,1,0.00171,11114,19.00056,58493
2337,bygui86,1,0.00171,11115,19.00227,58493
2338,cainelli,1,0.00171,11116,19.00398,58493
2339,carlesar,1,0.00171,11117,19.00569,58493
2340,carlosmkb,1,0.00171,11118,19.00740,58493
2341,caseyvu,1,0.00171,11119,19.00911,58493
2342,cazorla19,1,0.00171,11120,19.01082,58493
2343,cblument,1,0.00171,11121,19.01253,58493
2344,cchaussat,1,0.00171,11122,19.01424,58493
2345,ccheek21,1,0.00171,11123,19.01595,58493
2346,cCloudSky,1,0.00171,11124,19.01766,58493
2347,ccs018,1,0.00171,11125,19.01937,58493
2348,cdj03,1,0.00171,11126,19.02108,58493
2349,cejast,1,0.00171,11127,19.02279,58493
2350,chadlwm,1,0.00171,11128,19.02450,58493
2351,chaospixel,1,0.00171,11129,19.02621,58493
2352,charlecoms,1,0.00171,11130,19.02792,58493
2353,charliezang,1,0.00171,11131,19.02963,58493
2354,chaseYLC,1,0.00171,11132,19.03134,58493
2355,chenjpu,1,0.00171,11133,19.03305,58493
2356,chesterlai,1,0.00171,11134,19.03476,58493
2357,chicken231,1,0.00171,11135,19.03647,58493
2358,chigichan24,1,0.00171,11136,19.03818,58493
2359,chilibreaker,1,0.00171,11137,19.03989,58493
2360,chilinhnet,1,0.00171,11138,19.04159,58493
2361,Chinaxiang,1,0.00171,11139,19.04330,58493
2362,ChiperSoft,1,0.00171,11140,19.04501,58493
2363,ChitraKumarS,1,0.00171,11141,19.04672,58493
2364,chitsaou,1,0.00171,11142,19.04843,58493
2365,chocoby,1,0.00171,11143,19.05014,58493
2366,chrisdebug,1,0.00171,11144,19.05185,58493
2367,chrisleavoy,1,0.00171,11145,19.05356,58493
2368,ChristiaanWestgeest,1,0.00171,11146,19.05527,58493
2369,chroche,1,0.00171,11147,19.05698,58493
2370,cjdmax,1,0.00171,11148,19.05869,58493
2371,claralui,1,0.00171,11149,19.06040,58493
2372,clauzewitz,1,0.00171,11150,19.06211,58493
2373,cleankod,1,0.00171,11151,19.06382,58493
2374,clsung,1,0.00171,11152,19.06553,58493
2375,cmachgodaddy,1,0.00171,11153,19.06724,58493
2376,cmygeHm,1,0.00171,11154,19.06895,58493
2377,cnorthwood,1,0.00171,11155,19.07066,58493
2378,codeninja55,1,0.00171,11156,19.07237,58493
2379,coders-kitchen,1,0.00171,11157,19.07408,58493
2380,codesqueak,1,0.00171,11158,19.07579,58493
2381,cognitiaclaeves,1,0.00171,11159,19.07750,58493
2382,colegatron,1,0.00171,11160,19.07921,58493
2383,colin-nolan,1,0.00171,11161,19.08092,58493
2384,collin-bachi-sp,1,0.00171,11162,19.08263,58493
2385,ConaghFM,1,0.00171,11163,19.08433,58493
2386,copumpkin,1,0.00171,11164,19.08604,58493
2387,coreteam-co,1,0.00171,11165,19.08775,58493
2388,corford,1,0.00171,11166,19.08946,58493
2389,corvinusy,1,0.00171,11167,19.09117,58493
2390,Cosmo,1,0.00171,11168,19.09288,58493
2391,costa,1,0.00171,11169,19.09459,58493
2392,CoufalJa,1,0.00171,11170,19.09630,58493
2393,countingtoten,1,0.00171,11171,19.09801,58493
2394,cpxPratik,1,0.00171,11172,19.09972,58493
2395,crain,1,0.00171,11173,19.10143,58493
2396,CrazyZfp,1,0.00171,11174,19.10314,58493
2397,cricketfan5,1,0.00171,11175,19.10485,58493
2398,Crystark,1,0.00171,11176,19.10656,58493
2399,cschug,1,0.00171,11177,19.10827,58493
2400,csimani,1,0.00171,11178,19.10998,58493
2401,ctippur,1,0.00171,11179,19.11169,58493
2402,cuiliang5,1,0.00171,11180,19.11340,58493
2403,cwbuege,1,0.00171,11181,19.11511,58493
2404,cyyeong,1,0.00171,11182,19.11682,58493
2405,d4ntheman,1,0.00171,11183,19.11853,58493
2406,dabr-grapeup,1,0.00171,11184,19.12024,58493
2407,dafegit,1,0.00171,11185,19.12195,58493
2408,daguilarv,1,0.00171,11186,19.12366,58493
2409,daikeren,1,0.00171,11187,19.12537,58493
2410,daliclass,1,0.00171,11188,19.12708,58493
2411,danapplegate,1,0.00171,11189,19.12878,58493
2412,danielefranceschi,1,0.00171,11190,19.13049,58493
2413,DanielJRutledge,1,0.00171,11191,19.13220,58493
2414,danilorsilva,1,0.00171,11192,19.13391,58493
2415,danopia,1,0.00171,11193,19.13562,58493
2416,Daoq,1,0.00171,11194,19.13733,58493
2417,datianshi21,1,0.00171,11195,19.13904,58493
2418,Datise,1,0.00171,11196,19.14075,58493
2419,dave7373,1,0.00171,11197,19.14246,58493
2420,davidchua,1,0.00171,11198,19.14417,58493
2421,davide-romanini,1,0.00171,11199,19.14588,58493
2422,davidhybner,1,0.00171,11200,19.14759,58493
2423,davidwartell,1,0.00171,11201,19.14930,58493
2424,davix,1,0.00171,11202,19.15101,58493
2425,dbarriguete,1,0.00171,11203,19.15272,58493
2426,dchimeno,1,0.00171,11204,19.15443,58493
2427,DDAAREN,1,0.00171,11205,19.15614,58493
2428,Deaddy,1,0.00171,11206,19.15785,58493
2429,deepakmittal,1,0.00171,11207,19.15956,58493
2430,deepaksharma17,1,0.00171,11208,19.16127,58493
2431,dehemart,1,0.00171,11209,19.16298,58493
2432,Denis101,1,0.00171,11210,19.16469,58493
2433,denizarman,1,0.00171,11211,19.16640,58493
2434,denmarkin,1,0.00171,11212,19.16811,58493
2435,DennyZhang,1,0.00171,11213,19.16982,58493
2436,denser,1,0.00171,11214,19.17152,58493
2437,DeploymentKing,1,0.00171,11215,19.17323,58493
2438,dev-bandai,1,0.00171,11216,19.17494,58493
2439,devils-ey3,1,0.00171,11217,19.17665,58493
2440,dfateyev,1,0.00171,11218,19.17836,58493
2441,dgalichet,1,0.00171,11219,19.18007,58493
2442,dgonzalezruiz,1,0.00171,11220,19.18178,58493
2443,diannaowa,1,0.00171,11221,19.18349,58493
2444,didhd,1,0.00171,11222,19.18520,58493
2445,DigitalRogues,1,0.00171,11223,19.18691,58493
2446,dionjwa,1,0.00171,11224,19.18862,58493
2447,directionless,1,0.00171,11225,19.19033,58493
2448,djotanov,1,0.00171,11226,19.19204,58493
2449,dleyanlin,1,0.00171,11227,19.19375,58493
2450,dmarkey,1,0.00171,11228,19.19546,58493
2451,dohoangkhiem,1,0.00171,11229,19.19717,58493
2452,Dolape1983,1,0.00171,11230,19.19888,58493
2453,dontspamterry,1,0.00171,11231,19.20059,58493
2454,dontub,1,0.00171,11232,19.20230,58493
2455,doron-td-agent,1,0.00171,11233,19.20401,58493
2456,doublening,1,0.00171,11234,19.20572,58493
2457,dougbeauchene,1,0.00171,11235,19.20743,58493
2458,dpeterka,1,0.00171,11236,19.20914,58493
2459,dpgeekzero,1,0.00171,11237,19.21085,58493
2460,dracmic,1,0.00171,11238,19.21256,58493
2461,DrMavenRebe,1,0.00171,11239,19.21426,58493
2462,dry4ng,1,0.00171,11240,19.21597,58493
2463,dsociative,1,0.00171,11241,19.21768,58493
2464,dsoria,1,0.00171,11242,19.21939,58493
2465,dsouzajude,1,0.00171,11243,19.22110,58493
2466,dspruell,1,0.00171,11244,19.22281,58493
2467,duboisph,1,0.00171,11245,19.22452,58493
2468,dunnock,1,0.00171,11246,19.22623,58493
2469,dvlato,1,0.00171,11247,19.22794,58493
2470,dvsekhvalnov,1,0.00171,11248,19.22965,58493
2471,dwalintukan,1,0.00171,11249,19.23136,58493
2472,dxas90,1,0.00171,11250,19.23307,58493
2473,dylan-barduzzi,1,0.00171,11251,19.23478,58493
2474,dyRavi,1,0.00171,11252,19.23649,58493
2475,dytmh,1,0.00171,11253,19.23820,58493
2476,eagleoflqj,1,0.00171,11254,19.23991,58493
2477,eamonnmcevoy,1,0.00171,11255,19.24162,58493
2478,earthdiaosi,1,0.00171,11256,19.24333,58493
2479,eashman,1,0.00171,11257,19.24504,58493
2480,ebastos,1,0.00171,11258,19.24675,58493
2481,edward2a,1,0.00171,11259,19.24846,58493
2482,EdwinExtendas,1,0.00171,11260,19.25017,58493
2483,eeshaisha,1,0.00171,11261,19.25188,58493
2484,ehalpern,1,0.00171,11262,19.25359,58493
2485,Eiryyy,1,0.00171,11263,19.25530,58493
2486,ekanai,1,0.00171,11264,19.25701,58493
2487,ekimekim,1,0.00171,11265,19.25871,58493
2488,eladtamary,1,0.00171,11266,19.26042,58493
2489,EldarSagirov,1,0.00171,11267,19.26213,58493
2490,eliasnorrby,1,0.00171,11268,19.26384,58493
2491,ellipse42,1,0.00171,11269,19.26555,58493
2492,elvarb,1,0.00171,11270,19.26726,58493
2493,emretiryaki,1,0.00171,11271,19.26897,58493
2494,emrocha,1,0.00171,11272,19.27068,58493
2495,en-siba,1,0.00171,11273,19.27239,58493
2496,eosstvw,1,0.00171,11274,19.27410,58493
2497,ereOn,1,0.00171,11275,19.27581,58493
2498,EricVS,1,0.00171,11276,19.27752,58493
2499,etegan,1,0.00171,11277,19.27923,58493
2500,ethankan,1,0.00171,11278,19.28094,58493
2501,eunsikpark,1,0.00171,11279,19.28265,58493
2502,EvertonSA,1,0.00171,11280,19.28436,58493
2503,Ewocker,1,0.00171,11281,19.28607,58493
2504,fabiofalci,1,0.00171,11282,19.28778,58493
2505,fabrice-etanchaud,1,0.00171,11283,19.28949,58493
2506,facastagnini,1,0.00171,11284,19.29120,58493
2507,fadingdust,1,0.00171,11285,19.29291,58493
2508,fangli,1,0.00171,11286,19.29462,58493
2509,fantajeon,1,0.00171,11287,19.29633,58493
2510,federicopuntoni,1,0.00171,11288,19.29804,58493
2511,FeiYao,1,0.00171,11289,19.29975,58493
2512,fenxiong,1,0.00171,11290,19.30145,58493
2513,Fettah,1,0.00171,11291,19.30316,58493
2514,ffcczz,1,0.00171,11292,19.30487,58493
2515,fitz0017,1,0.00171,11293,19.30658,58493
2516,fkgre,1,0.00171,11294,19.30829,58493
2517,florentvaldelievre,1,0.00171,11295,19.31000,58493
2518,floriankammermann,1,0.00171,11296,19.31171,58493
2519,flowstate,1,0.00171,11297,19.31342,58493
2520,fly2tomato,1,0.00171,11298,19.31513,58493
2521,fog1985,1,0.00171,11299,19.31684,58493
2522,fopina,1,0.00171,11300,19.31855,58493
2523,fouts-bnet,1,0.00171,11301,19.32026,58493
2524,franck-schmidlin,1,0.00171,11302,19.32197,58493
2525,francoislagier,1,0.00171,11303,19.32368,58493
2526,fredzqm,1,0.00171,11304,19.32539,58493
2527,freelancerlucas,1,0.00171,11305,19.32710,58493
2528,freeyoung,1,0.00171,11306,19.32881,58493
2529,fr-swap,1,0.00171,11307,19.33052,58493
2530,fukangwen,1,0.00171,11308,19.33223,58493
2531,futureCreator,1,0.00171,11309,19.33394,58493
2532,fuusuke,1,0.00171,11310,19.33565,58493
2533,fw42,1,0.00171,11311,19.33736,58493
2534,fwhite-wsm,1,0.00171,11312,19.33907,58493
2535,fxpester,1,0.00171,11313,19.34078,58493
2536,fxposter,1,0.00171,11314,19.34249,58493
2537,gabriel-vicente,1,0.00171,11315,19.34420,58493
2538,gadelkareem,1,0.00171,11316,19.34590,58493
2539,galindro,1,0.00171,11317,19.34761,58493
2540,gallardop,1,0.00171,11318,19.34932,58493
2541,Gambler13,1,0.00171,11319,19.35103,58493
2542,ganga1980,1,0.00171,11320,19.35274,58493
2543,gaohao,1,0.00171,11321,19.35445,58493
2544,garbetjie,1,0.00171,11322,19.35616,58493
2545,garild,1,0.00171,11323,19.35787,58493
2546,gavinmcnair,1,0.00171,11324,19.35958,58493
2547,gbates101,1,0.00171,11325,19.36129,58493
2548,gcavalcante8808,1,0.00171,11326,19.36300,58493
2549,gcxRun,1,0.00171,11327,19.36471,58493
2550,genseb13011,1,0.00171,11328,19.36642,58493
2551,getSurreal,1,0.00171,11329,19.36813,58493
2552,gfdsa,1,0.00171,11330,19.36984,58493
2553,ghostymun,1,0.00171,11331,19.37155,58493
2554,giovanichaves,1,0.00171,11332,19.37326,58493
2555,Gleb-ho,1,0.00171,11333,19.37497,58493
2556,go2murali,1,0.00171,11334,19.37668,58493
2557,gogovan-vincentngai,1,0.00171,11335,19.37839,58493
2558,GolanSabo,1,0.00171,11336,19.38010,58493
2559,GoodDingo,1,0.00171,11337,19.38181,58493
2560,goodfoo,1,0.00171,11338,19.38352,58493
2561,google238,1,0.00171,11339,19.38523,58493
2562,GOUYONGCHAO,1,0.00171,11340,19.38694,58493
2563,gracedo,1,0.00171,11341,19.38864,58493
2564,grantstephens,1,0.00171,11342,19.39035,58493
2565,grenzr,1,0.00171,11343,19.39206,58493
2566,Greyvend,1,0.00171,11344,19.39377,58493
2567,grimmxsleeper,1,0.00171,11345,19.39548,58493
2568,gschaden,1,0.00171,11346,19.39719,58493
2569,gstib,1,0.00171,11347,19.39890,58493
2570,GuidoHaase,1,0.00171,11348,19.40061,58493
2571,gyustorm,1,0.00171,11349,19.40232,58493
2572,haakoneriksen,1,0.00171,11350,19.40403,58493
2573,habibiefaried,1,0.00171,11351,19.40574,58493
2574,hahafamilia,1,0.00171,11352,19.40745,58493
2575,haije,1,0.00171,11353,19.40916,58493
2576,Hajiri-Moez,1,0.00171,11354,19.41087,58493
2577,HakanL,1,0.00171,11355,19.41258,58493
2578,halostatue,1,0.00171,11356,19.41429,58493
2579,hamelsveld,1,0.00171,11357,19.41600,58493
2580,hanabokuro,1,0.00171,11358,19.41771,58493
2581,hanai-tohru,1,0.00171,11359,19.41942,58493
2582,handysama,1,0.00171,11360,19.42113,58493
2583,hanjinding,1,0.00171,11361,19.42284,58493
2584,hanoch,1,0.00171,11362,19.42455,58493
2585,haosu,1,0.00171,11363,19.42626,58493
2586,happysalada,1,0.00171,11364,19.42797,58493
2587,happyyangyuan,1,0.00171,11365,19.42968,58493
2588,hari819,1,0.00171,11366,19.43138,58493
2589,harigist,1,0.00171,11367,19.43309,58493
2590,haritw,1,0.00171,11368,19.43480,58493
2591,harmw,1,0.00171,11369,19.43651,58493
2592,haroboro,1,0.00171,11370,19.43822,58493
2593,harry-wood,1,0.00171,11371,19.43993,58493
2594,hasseio,1,0.00171,11372,19.44164,58493
2595,hawknewton,1,0.00171,11373,19.44335,58493
2596,hayesr,1,0.00171,11374,19.44506,58493
2597,hcbraun,1,0.00171,11375,19.44677,58493
2598,hctech,1,0.00171,11376,19.44848,58493
2599,hectorhuertas,1,0.00171,11377,19.45019,58493
2600,hellojukay,1,0.00171,11378,19.45190,58493
2601,Helmut-Onna,1,0.00171,11379,19.45361,58493
2602,hev,1,0.00171,11380,19.45532,58493
2603,hexinatgithub,1,0.00171,11381,19.45703,58493
2604,hexwit,1,0.00171,11382,19.45874,58493
2605,hhubris,1,0.00171,11383,19.46045,58493
2606,hillbun,1,0.00171,11384,19.46216,58493
2607,hiroru,1,0.00171,11385,19.46387,58493
2608,hiroyukim,1,0.00171,11386,19.46558,58493
2609,hjdr4,1,0.00171,11387,19.46729,58493
2610,hmatsuoka,1,0.00171,11388,19.46900,58493
2611,hmc1986,1,0.00171,11389,19.47071,58493
2612,hoedic44,1,0.00171,11390,19.47242,58493
2613,hogmuzzle,1,0.00171,11391,19.47413,58493
2614,holyhope,1,0.00171,11392,19.47583,58493
2615,hornetmadness,1,0.00171,11393,19.47754,58493
2616,hridyeshpant,1,0.00171,11394,19.47925,58493
2617,hsachdevah,1,0.00171,11395,19.48096,58493
2618,hsinhoyeh,1,0.00171,11396,19.48267,58493
2619,hugeleaf,1,0.00171,11397,19.48438,58493
2620,hurtauda,1,0.00171,11398,19.48609,58493
2621,hwasp,1,0.00171,11399,19.48780,58493
2622,hychen,1,0.00171,11400,19.48951,58493
2623,hyginous29,1,0.00171,11401,19.49122,58493
2624,hyperledger1,1,0.00171,11402,19.49293,58493
2625,iahmad-khan,1,0.00171,11403,19.49464,58493
2626,iampiyush,1,0.00171,11404,19.49635,58493
2627,ibalashov,1,0.00171,11405,19.49806,58493
2628,idanto,1,0.00171,11406,19.49977,58493
2629,ifeldshteyn,1,0.00171,11407,19.50148,58493
2630,ignusws,1,0.00171,11408,19.50319,58493
2631,igorgatis,1,0.00171,11409,19.50490,58493
2632,igorkchyts,1,0.00171,11410,19.50661,58493
2633,igorrudyk,1,0.00171,11411,19.50832,58493
2634,ikarin,1,0.00171,11412,19.51003,58493
2635,imperio-wxm,1,0.00171,11413,19.51174,58493
2636,impicklejon,1,0.00171,11414,19.51345,58493
2637,imriss,1,0.00171,11415,19.51516,58493
2638,indigoid,1,0.00171,11416,19.51687,58493
2639,infoMatt,1,0.00171,11417,19.51857,58493
2640,info-samir,1,0.00171,11418,19.52028,58493
2641,initcron-abhijit,1,0.00171,11419,19.52199,58493
2642,inkitm,1,0.00171,11420,19.52370,58493
2643,InspurKelly,1,0.00171,11421,19.52541,58493
2644,intenseFrog,1,0.00171,11422,19.52712,58493
2645,invin12,1,0.00171,11423,19.52883,58493
2646,iravishah,1,0.00171,11424,19.53054,58493
2647,isaacegglestone,1,0.00171,11425,19.53225,58493
2648,ishantanu,1,0.00171,11426,19.53396,58493
2649,isurusiri,1,0.00171,11427,19.53567,58493
2650,Itfly,1,0.00171,11428,19.53738,58493
2651,itlabvn,1,0.00171,11429,19.53909,58493
2652,iusergii,1,0.00171,11430,19.54080,58493
2653,ivanfoo,1,0.00171,11431,19.54251,58493
2654,jacobuk,1,0.00171,11432,19.54422,58493
2655,jadencodes,1,0.00171,11433,19.54593,58493
2656,jaffrey007,1,0.00171,11434,19.54764,58493
2657,JaisalSingh,1,0.00171,11435,19.54935,58493
2658,JakubCoufal,1,0.00171,11436,19.55106,58493
2659,jameserrico,1,0.00171,11437,19.55277,58493
2660,januszry,1,0.00171,11438,19.55448,58493
2661,japzio,1,0.00171,11439,19.55619,58493
2662,jaredready,1,0.00171,11440,19.55790,58493
2663,jarmaker,1,0.00171,11441,19.55961,58493
2664,JAtula,1,0.00171,11442,19.56132,58493
2665,javapapo,1,0.00171,11443,19.56302,58493
2666,javrllerenas,1,0.00171,11444,19.56473,58493
2667,jaxonpickett,1,0.00171,11445,19.56644,58493
2668,Jaykah,1,0.00171,11446,19.56815,58493
2669,jcassee,1,0.00171,11447,19.56986,58493
2670,jcdauchy,1,0.00171,11448,19.57157,58493
2671,jcdauchy-moodys,1,0.00171,11449,19.57328,58493
2672,jclosure,1,0.00171,11450,19.57499,58493
2673,jdambly-ns,1,0.00171,11451,19.57670,58493
2674,j-davies,1,0.00171,11452,19.57841,58493
2675,jd-carroll,1,0.00171,11453,19.58012,58493
2676,jdeprin,1,0.00171,11454,19.58183,58493
2677,JDKardia,1,0.00171,11455,19.58354,58493
2678,jdrueckert,1,0.00171,11456,19.58525,58493
2679,jeanlouisferey,1,0.00171,11457,19.58696,58493
2680,jebl01,1,0.00171,11458,19.58867,58493
2681,jeffaco,1,0.00171,11459,19.59038,58493
2682,jeffdesc,1,0.00171,11460,19.59209,58493
2683,jeffutter,1,0.00171,11461,19.59380,58493
2684,jefimm,1,0.00171,11462,19.59551,58493
2685,jelmokri,1,0.00171,11463,19.59722,58493
2686,JerkyTreats,1,0.00171,11464,19.59893,58493
2687,jessemcallister,1,0.00171,11465,19.60064,58493
2688,Jeyanthinath,1,0.00171,11466,19.60235,58493
2689,jfillman,1,0.00171,11467,19.60406,58493
2690,JGiola,1,0.00171,11468,19.60576,58493
2691,jhinklew,1,0.00171,11469,19.60747,58493
2692,jhonatanmorais,1,0.00171,11470,19.60918,58493
2693,Ji0ngHan,1,0.00171,11471,19.61089,58493
2694,jiamo,1,0.00171,11472,19.61260,58493
2695,jiaxuanzhou,1,0.00171,11473,19.61431,58493
2696,jimwal,1,0.00171,11474,19.61602,58493
2697,JindongChen,1,0.00171,11475,19.61773,58493
2698,jingsm,1,0.00171,11476,19.61944,58493
2699,jinhyukchang,1,0.00171,11477,19.62115,58493
2700,jlloh,1,0.00171,11478,19.62286,58493
2701,jlorich,1,0.00171,11479,19.62457,58493
2702,jmalouf69,1,0.00171,11480,19.62628,58493
2703,jmarijan,1,0.00171,11481,19.62799,58493
2704,jnathanh,1,0.00171,11482,19.62970,58493
2705,JnMik,1,0.00171,11483,19.63141,58493
2706,joby-thomas,1,0.00171,11484,19.63312,58493
2707,joestrouth1,1,0.00171,11485,19.63483,58493
2708,johlo,1,0.00171,11486,19.63654,58493
2709,johnpaulett,1,0.00171,11487,19.63825,58493
2710,johnseekins,1,0.00171,11488,19.63996,58493
2711,jolly7481,1,0.00171,11489,19.64167,58493
2712,Jonathan-mura,1,0.00171,11490,19.64338,58493
2713,jonhandlermac,1,0.00171,11491,19.64509,58493
2714,jonnyyu,1,0.00171,11492,19.64680,58493
2715,joriws,1,0.00171,11493,19.64850,58493
2716,joseliber,1,0.00171,11494,19.65021,58493
2717,j-o-s-h,1,0.00171,11495,19.65192,58493
2718,joshcwa,1,0.00171,11496,19.65363,58493
2719,joshgarnett,1,0.00171,11497,19.65534,58493
2720,jpaskhay,1,0.00171,11498,19.65705,58493
2721,jpbelanger-mtl,1,0.00171,11499,19.65876,58493
2722,jpgonzalez1985,1,0.00171,11500,19.66047,58493
2723,JPM84,1,0.00171,11501,19.66218,58493
2724,jpugliesi,1,0.00171,11502,19.66389,58493
2725,jriggins,1,0.00171,11503,19.66560,58493
2726,jroberts07,1,0.00171,11504,19.66731,58493
2727,JSchwerberg,1,0.00171,11505,19.66902,58493
2728,jsermeno,1,0.00171,11506,19.67073,58493
2729,judika03,1,0.00171,11507,19.67244,58493
2730,juho9000,1,0.00171,11508,19.67415,58493
2731,Ju-Li-An,1,0.00171,11509,19.67586,58493
2732,juliantaylor,1,0.00171,11510,19.67757,58493
2733,JungsuHan,1,0.00171,11511,19.67928,58493
2734,JunyaOkumura,1,0.00171,11512,19.68099,58493
2735,junyoungkim,1,0.00171,11513,19.68270,58493
2736,justanding,1,0.00171,11514,19.68441,58493
2737,justinh24,1,0.00171,11515,19.68612,58493
2738,justinpnichols,1,0.00171,11516,19.68783,58493
2739,JvalantPatel-MS,1,0.00171,11517,19.68954,58493
2740,jwitrick,1,0.00171,11518,19.69125,58493
2741,jwlogemann,1,0.00171,11519,19.69295,58493
2742,jyipks,1,0.00171,11520,19.69466,58493
2743,jyotiruhil,1,0.00171,11521,19.69637,58493
2744,kabali12345,1,0.00171,11522,19.69808,58493
2745,kailashyogeshwar85,1,0.00171,11523,19.69979,58493
2746,kajahno,1,0.00171,11524,19.70150,58493
2747,kakakakakku,1,0.00171,11525,19.70321,58493
2748,Kakakakakku,1,0.00171,11526,19.70492,58493
2749,kakmt,1,0.00171,11527,19.70663,58493
2750,Kaliamos,1,0.00171,11528,19.70834,58493
2751,kamirendawkins,1,0.00171,11529,19.71005,58493
2752,kamyuentse,1,0.00171,11530,19.71176,58493
2753,karloluiten,1,0.00171,11531,19.71347,58493
2754,KarstenSchnitter,1,0.00171,11532,19.71518,58493
2755,kasunt84,1,0.00171,11533,19.71689,58493
2756,kaweit,1,0.00171,11534,19.71860,58493
2757,kazeburo,1,0.00171,11535,19.72031,58493
2758,kdihalas,1,0.00171,11536,19.72202,58493
2759,keepburning,1,0.00171,11537,19.72373,58493
2760,keigohtr,1,0.00171,11538,19.72544,58493
2761,KeiichiHirobe,1,0.00171,11539,19.72715,58493
2762,keir-rex,1,0.00171,11540,19.72886,58493
2763,kekoav,1,0.00171,11541,19.73057,58493
2764,kelson-martins,1,0.00171,11542,19.73228,58493
2765,Ken4scholars,1,0.00171,11543,19.73399,58493
2766,kenju,1,0.00171,11544,19.73569,58493
2767,kennedyalexander,1,0.00171,11545,19.73740,58493
2768,Kenny-House,1,0.00171,11546,19.73911,58493
2769,ker2x,1,0.00171,11547,19.74082,58493
2770,keshavab,1,0.00171,11548,19.74253,58493
2771,kevcodez,1,0.00171,11549,19.74424,58493
2772,kgf,1,0.00171,11550,19.74595,58493
2773,khalilamdouni,1,0.00171,11551,19.74766,58493
2774,khotkevych,1,0.00171,11552,19.74937,58493
2775,kid101,1,0.00171,11553,19.75108,58493
2776,kiwiz,1,0.00171,11554,19.75279,58493
2777,kkawamura,1,0.00171,11555,19.75450,58493
2778,kkujawinski,1,0.00171,11556,19.75621,58493
2779,kladiv,1,0.00171,11557,19.75792,58493
2780,kmevissen,1,0.00171,11558,19.75963,58493
2781,kmorey,1,0.00171,11559,19.76134,58493
2782,know-no,1,0.00171,11560,19.76305,58493
2783,kokosabu,1,0.00171,11561,19.76476,58493
2784,komal-SkyNET,1,0.00171,11562,19.76647,58493
2785,koman-maciej,1,0.00171,11563,19.76818,58493
2786,kompiuter,1,0.00171,11564,19.76989,58493
2787,konradmichael,1,0.00171,11565,19.77160,58493
2788,kooboo-binbin,1,0.00171,11566,19.77331,58493
2789,koolhead17,1,0.00171,11567,19.77502,58493
2790,koreantramp,1,0.00171,11568,19.77673,58493
2791,kousik93,1,0.00171,11569,19.77844,58493
2792,kpbll,1,0.00171,11570,19.78014,58493
2793,krafts,1,0.00171,11571,19.78185,58493
2794,Krishna1408,1,0.00171,11572,19.78356,58493
2795,KristianLyng,1,0.00171,11573,19.78527,58493
2796,kristofferahl,1,0.00171,11574,19.78698,58493
2797,kriston13,1,0.00171,11575,19.78869,58493
2798,krudskoy,1,0.00171,11576,19.79040,58493
2799,KrysKruk,1,0.00171,11577,19.79211,58493
2800,ksss,1,0.00171,11578,19.79382,58493
2801,Kumaravel2904,1,0.00171,11579,19.79553,58493
2802,kurosakisora,1,0.00171,11580,19.79724,58493
2803,kushagra391,1,0.00171,11581,19.79895,58493
2804,kvitali,1,0.00171,11582,19.80066,58493
2805,kvolkovich-sc,1,0.00171,11583,19.80237,58493
2806,kvr12294,1,0.00171,11584,19.80408,58493
2807,kvranjith,1,0.00171,11585,19.80579,58493
2808,kycfeel,1,0.00171,11586,19.80750,58493
2809,kylebevans,1,0.00171,11587,19.80921,58493
2810,lachlanmunro,1,0.00171,11588,19.81092,58493
2811,lam-juice,1,0.00171,11589,19.81263,58493
2812,landryb,1,0.00171,11590,19.81434,58493
2813,laurentiu92,1,0.00171,11591,19.81605,58493
2814,lavoiedn,1,0.00171,11592,19.81776,58493
2815,leobudima,1,0.00171,11593,19.81947,58493
2816,letsgolesco,1,0.00171,11594,19.82118,58493
2817,levlas,1,0.00171,11595,19.82288,58493
2818,lexa500,1,0.00171,11596,19.82459,58493
2819,liaoyupeng,1,0.00171,11597,19.82630,58493
2820,lifeofguenter,1,0.00171,11598,19.82801,58493
2821,likunbyl,1,0.00171,11599,19.82972,58493
2822,lindsjan,1,0.00171,11600,19.83143,58493
2823,linuxandunix,1,0.00171,11601,19.83314,58493
2824,littlesandra88,1,0.00171,11602,19.83485,58493
2825,liuyong2000,1,0.00171,11603,19.83656,58493
2826,livid,1,0.00171,11604,19.83827,58493
2827,living42,1,0.00171,11605,19.83998,58493
2828,ljfuyuan,1,0.00171,11606,19.84169,58493
2829,lk432,1,0.00171,11607,19.84340,58493
2830,lkjangir,1,0.00171,11608,19.84511,58493
2831,llchen223,1,0.00171,11609,19.84682,58493
2832,llimon,1,0.00171,11610,19.84853,58493
2833,l-lotz,1,0.00171,11611,19.85024,58493
2834,llrrbaba,1,0.00171,11612,19.85195,58493
2835,LmYjQ,1,0.00171,11613,19.85366,58493
2836,loganbfisher,1,0.00171,11614,19.85537,58493
2837,loic35,1,0.00171,11615,19.85708,58493
2838,lokiwins,1,0.00171,11616,19.85879,58493
2839,lostz,1,0.00171,11617,19.86050,58493
2840,Lowess,1,0.00171,11618,19.86221,58493
2841,lowstz,1,0.00171,11619,19.86392,58493
2842,lpetre,1,0.00171,11620,19.86562,58493
2843,lpic10,1,0.00171,11621,19.86733,58493
2844,lpugoy,1,0.00171,11622,19.86904,58493
2845,lrg-ev0,1,0.00171,11623,19.87075,58493
2846,lubing1101,1,0.00171,11624,19.87246,58493
2847,lucabotti,1,0.00171,11625,19.87417,58493
2848,lucas1993ch,1,0.00171,11626,19.87588,58493
2849,lucasmpb,1,0.00171,11627,19.87759,58493
2850,luciflus,1,0.00171,11628,19.87930,58493
2851,ludwick,1,0.00171,11629,19.88101,58493
2852,luisbrandao,1,0.00171,11630,19.88272,58493
2853,luthienberen,1,0.00171,11631,19.88443,58493
2854,luukd,1,0.00171,11632,19.88614,58493
2855,LuukSt,1,0.00171,11633,19.88785,58493
2856,luv2code,1,0.00171,11634,19.88956,58493
2857,lvc,1,0.00171,11635,19.89127,58493
2858,lwh,1,0.00171,11636,19.89298,58493
2859,lxfontes,1,0.00171,11637,19.89469,58493
2860,lxhunter,1,0.00171,11638,19.89640,58493
2861,lynxaegon,1,0.00171,11639,19.89811,58493
2862,m1h43l,1,0.00171,11640,19.89982,58493
2863,m1keil,1,0.00171,11641,19.90153,58493
2864,M22an,1,0.00171,11642,19.90324,58493
2865,maadtechie,1,0.00171,11643,19.90495,58493
2866,machytkafitanalytics,1,0.00171,11644,19.90666,58493
2867,Ma-Dan,1,0.00171,11645,19.90837,58493
2868,Maellooou,1,0.00171,11646,19.91007,58493
2869,maheshb415,1,0.00171,11647,19.91178,58493
2870,majian159,1,0.00171,11648,19.91349,58493
2871,makeloffve,1,0.00171,11649,19.91520,58493
2872,MakeshKathirvel,1,0.00171,11650,19.91691,58493
2873,malavikad072,1,0.00171,11651,19.91862,58493
2874,malikid,1,0.00171,11652,19.92033,58493
2875,manjunathramesh,1,0.00171,11653,19.92204,58493
2876,manojpardeshi,1,0.00171,11654,19.92375,58493
2877,manojshetty28,1,0.00171,11655,19.92546,58493
2878,manvinderr21,1,0.00171,11656,19.92717,58493
2879,mapk0y,1,0.00171,11657,19.92888,58493
2880,marcelo23,1,0.00171,11658,19.93059,58493
2881,marciorf,1,0.00171,11659,19.93230,58493
2882,marcsue,1,0.00171,11660,19.93401,58493
2883,marcwickenden,1,0.00171,11661,19.93572,58493
2884,mareban,1,0.00171,11662,19.93743,58493
2885,mariotee,1,0.00171,11663,19.93914,58493
2886,mariuscoto,1,0.00171,11664,19.94085,58493
2887,marmos91,1,0.00171,11665,19.94256,58493
2888,marrrvin,1,0.00171,11666,19.94427,58493
2889,martinbaillie,1,0.00171,11667,19.94598,58493
2890,martiyanov,1,0.00171,11668,19.94769,58493
2891,marulm,1,0.00171,11669,19.94940,58493
2892,MarwanBayadsi,1,0.00171,11670,19.95111,58493
2893,mastermiaoge,1,0.00171,11671,19.95281,58493
2894,matayto,1,0.00171,11672,19.95452,58493
2895,matikij,1,0.00171,11673,19.95623,58493
2896,matt14483,1,0.00171,11674,19.95794,58493
2897,mattb18,1,0.00171,11675,19.95965,58493
2898,Matt-Dee,1,0.00171,11676,19.96136,58493
2899,Mattes83,1,0.00171,11677,19.96307,58493
2900,matt-simons,1,0.00171,11678,19.96478,58493
2901,mattyb,1,0.00171,11679,19.96649,58493
2902,MaxDiOrio,1,0.00171,11680,19.96820,58493
2903,maximdx,1,0.00171,11681,19.96991,58493
2904,maxromanovsky,1,0.00171,11682,19.97162,58493
2905,mcanaves,1,0.00171,11683,19.97333,58493
2906,McPetersonGH,1,0.00171,11684,19.97504,58493
2907,mcrapet,1,0.00171,11685,19.97675,58493
2908,MCRayRay,1,0.00171,11686,19.97846,58493
2909,mdazam1942,1,0.00171,11687,19.98017,58493
2910,mdnix,1,0.00171,11688,19.98188,58493
2911,mdost,1,0.00171,11689,19.98359,58493
2912,medanasslim,1,0.00171,11690,19.98530,58493
2913,meduri99,1,0.00171,11691,19.98701,58493
2914,meirwah,1,0.00171,11692,19.98872,58493
2915,mentalblock,1,0.00171,11693,19.99043,58493
2916,messiahUA,1,0.00171,11694,19.99214,58493
2917,metalfork,1,0.00171,11695,19.99385,58493
2918,mheppner,1,0.00171,11696,19.99556,58493
2919,MichaelBerryman,1,0.00171,11697,19.99726,58493
2920,MichaelKunze,1,0.00171,11698,19.99897,58493
2921,MichaelMitchellM,1,0.00171,11699,20.00068,58493
2922,michalrabinowitch,1,0.00171,11700,20.00239,58493
2923,michalriha1,1,0.00171,11701,20.00410,58493
2924,michele,1,0.00171,11702,20.00581,58493
2925,michnmi,1,0.00171,11703,20.00752,58493
2926,michtek,1,0.00171,11704,20.00923,58493
2927,MickaelBZH,1,0.00171,11705,20.01094,58493
2928,midihenry,1,0.00171,11706,20.01265,58493
2929,mihailgmihaylov,1,0.00171,11707,20.01436,58493
2930,MikeEdgar,1,0.00171,11708,20.01607,58493
2931,mikejuliettetango,1,0.00171,11709,20.01778,58493
2932,MikePlayle,1,0.00171,11710,20.01949,58493
2933,miketsts,1,0.00171,11711,20.02120,58493
2934,mikisseth,1,0.00171,11712,20.02291,58493
2935,milunko,1,0.00171,11713,20.02462,58493
2936,mimachniak,1,0.00171,11714,20.02633,58493
2937,mirantisjp,1,0.00171,11715,20.02804,58493
2938,Mist3ry,1,0.00171,11716,20.02975,58493
2939,miverson,1,0.00171,11717,20.03146,58493
2940,mkazlouski,1,0.00171,11718,20.03317,58493
2941,mkishi,1,0.00171,11719,20.03488,58493
2942,mkoerperriag,1,0.00171,11720,20.03659,58493
2943,MKo-xx,1,0.00171,11721,20.03830,58493
2944,mmacfadden,1,0.00171,11722,20.04000,58493
2945,mma-pivotal,1,0.00171,11723,20.04171,58493
2946,mmariani,1,0.00171,11724,20.04342,58493
2947,mmaslowskicc,1,0.00171,11725,20.04513,58493
2948,mnivedithaa,1,0.00171,11726,20.04684,58493
2949,mochizuki-masao,1,0.00171,11727,20.04855,58493
2950,moebiuseye,1,0.00171,11728,20.05026,58493
2951,moeterich,1,0.00171,11729,20.05197,58493
2952,mokemokechicken,1,0.00171,11730,20.05368,58493
2953,moliqingwa,1,0.00171,11731,20.05539,58493
2954,moloch90,1,0.00171,11732,20.05710,58493
2955,monkeypiggy,1,0.00171,11733,20.05881,58493
2956,moon0326,1,0.00171,11734,20.06052,58493
2957,mordaha,1,0.00171,11735,20.06223,58493
2958,morero,1,0.00171,11736,20.06394,58493
2959,morganwu277,1,0.00171,11737,20.06565,58493
2960,MorleyDev,1,0.00171,11738,20.06736,58493
2961,mosfet1kg,1,0.00171,11739,20.06907,58493
2962,moul,1,0.00171,11740,20.07078,58493
2963,mparienti,1,0.00171,11741,20.07249,58493
2964,mpluhar,1,0.00171,11742,20.07420,58493
2965,mpohl56,1,0.00171,11743,20.07591,58493
2966,mprzygrodzki,1,0.00171,11744,20.07762,58493
2967,Mr0x58,1,0.00171,11745,20.07933,58493
2968,Mr5hanMan,1,0.00171,11746,20.08104,58493
2969,mrazvan92,1,0.00171,11747,20.08274,58493
2970,m-revetria,1,0.00171,11748,20.08445,58493
2971,mritunjaykumar,1,0.00171,11749,20.08616,58493
2972,mr-karan,1,0.00171,11750,20.08787,58493
2973,msacchiPPRO,1,0.00171,11751,20.08958,58493
2974,mspangdal,1,0.00171,11752,20.09129,58493
2975,mthebridge,1,0.00171,11753,20.09300,58493
2976,mtovino-nefeli,1,0.00171,11754,20.09471,58493
2977,mudrii,1,0.00171,11755,20.09642,58493
2978,muffins,1,0.00171,11756,20.09813,58493
2979,mukgupta,1,0.00171,11757,20.09984,58493
2980,munishpalmakhija,1,0.00171,11758,20.10155,58493
2981,mvlbarcelos,1,0.00171,11759,20.10326,58493
2982,mwasserschaff,1,0.00171,11760,20.10497,58493
2983,mwaylonis,1,0.00171,11761,20.10668,58493
2984,mwpeterson,1,0.00171,11762,20.10839,58493
2985,myfreeweb,1,0.00171,11763,20.11010,58493
2986,n0m4d50u1,1,0.00171,11764,20.11181,58493
2987,n0ts,1,0.00171,11765,20.11352,58493
2988,Nabouk,1,0.00171,11766,20.11523,58493
2989,naegelin,1,0.00171,11767,20.11694,58493
2990,nainanurag,1,0.00171,11768,20.11865,58493
2991,najamsk,1,0.00171,11769,20.12036,58493
2992,namgunghyeon,1,0.00171,11770,20.12207,58493
2993,namrata-ibm,1,0.00171,11771,20.12378,58493
2994,nanaones,1,0.00171,11772,20.12549,58493
2995,nancykyo,1,0.00171,11773,20.12719,58493
2996,nanmu42,1,0.00171,11774,20.12890,58493
2997,naoki-iwami,1,0.00171,11775,20.13061,58493
2998,naomichi-y,1,0.00171,11776,20.13232,58493
2999,naphta,1,0.00171,11777,20.13403,58493
3000,NARKOZ,1,0.00171,11778,20.13574,58493
3001,nathan-oakes,1,0.00171,11779,20.13745,58493
3002,nathwill,1,0.00171,11780,20.13916,58493
3003,nauckunas,1,0.00171,11781,20.14087,58493
3004,ndenkowycz,1,0.00171,11782,20.14258,58493
3005,neerajap3,1,0.00171,11783,20.14429,58493
3006,neilsrg,1,0.00171,11784,20.14600,58493
3007,nEosAg007,1,0.00171,11785,20.14771,58493
3008,newbie78,1,0.00171,11786,20.14942,58493
3009,newrushbolt,1,0.00171,11787,20.15113,58493
3010,niallbrown,1,0.00171,11788,20.15284,58493
3011,NicholasKurian,1,0.00171,11789,20.15455,58493
3012,nickmcdowall,1,0.00171,11790,20.15626,58493
3013,NickMortimer,1,0.00171,11791,20.15797,58493
3014,nick-peskett-bbc,1,0.00171,11792,20.15968,58493
3015,nicolas-mosch,1,0.00171,11793,20.16139,58493
3016,Niggler,1,0.00171,11794,20.16310,58493
3017,nikoladj13,1,0.00171,11795,20.16481,58493
3018,Nikunj-Sharma,1,0.00171,11796,20.16652,58493
3019,nilsonpontello,1,0.00171,11797,20.16823,58493
3020,NiranjjanHari,1,0.00171,11798,20.16993,58493
3021,nish5uec,1,0.00171,11799,20.17164,58493
3022,nitin302,1,0.00171,11800,20.17335,58493
3023,nizarayari,1,0.00171,11801,20.17506,58493
3024,njnuwjq,1,0.00171,11802,20.17677,58493
3025,nkravi,1,0.00171,11803,20.17848,58493
3026,nnoto,1,0.00171,11804,20.18019,58493
3027,notmaxx,1,0.00171,11805,20.18190,58493
3028,notonlyfoweb,1,0.00171,11806,20.18361,58493
3029,npockrus-bnet,1,0.00171,11807,20.18532,58493
3030,nraddy,1,0.00171,11808,20.18703,58493
3031,ntdetect,1,0.00171,11809,20.18874,58493
3032,NTTAKR,1,0.00171,11810,20.19045,58493
3033,nukepuppy,1,0.00171,11811,20.19216,58493
3034,nupurbansal8,1,0.00171,11812,20.19387,58493
3035,nupur-neogy,1,0.00171,11813,20.19558,58493
3036,nvanheuverzwijn,1,0.00171,11814,20.19729,58493
3037,nvoskuilen,1,0.00171,11815,20.19900,58493
3038,nvrmnd,1,0.00171,11816,20.20071,58493
3039,nyetwurk,1,0.00171,11817,20.20242,58493
3040,nyilmaz,1,0.00171,11818,20.20413,58493
3041,n-yusuke,1,0.00171,11819,20.20584,58493
3042,oanogin,1,0.00171,11820,20.20755,58493
3043,oazabir,1,0.00171,11821,20.20926,58493
3044,occho,1,0.00171,11822,20.21097,58493
3045,odespesse,1,0.00171,11823,20.21268,58493
3046,odoku,1,0.00171,11824,20.21438,58493
3047,oemdaro,1,0.00171,11825,20.21609,58493
3048,ohadlahav,1,0.00171,11826,20.21780,58493
3049,ohdearaugustin,1,0.00171,11827,20.21951,58493
3050,okdas,1,0.00171,11828,20.22122,58493
3051,omaransari-home24,1,0.00171,11829,20.22293,58493
3052,omerh,1,0.00171,11830,20.22464,58493
3053,omitrowski,1,0.00171,11831,20.22635,58493
3054,onetinov,1,0.00171,11832,20.22806,58493
3055,onjectiondevops,1,0.00171,11833,20.22977,58493
3056,onlinebizsoft,1,0.00171,11834,20.23148,58493
3057,onyxet,1,0.00171,11835,20.23319,58493
3058,orgads,1,0.00171,11836,20.23490,58493
3059,Oscar3170,1,0.00171,11837,20.23661,58493
3060,oswcab,1,0.00171,11838,20.23832,58493
3061,oudemen,1,0.00171,11839,20.24003,58493
3062,Oyabi,1,0.00171,11840,20.24174,58493
3063,ozonni,1,0.00171,11841,20.24345,58493
3064,P15223971,1,0.00171,11842,20.24516,58493
3065,p53,1,0.00171,11843,20.24687,58493
3066,paassdc,1,0.00171,11844,20.24858,58493
3067,PacoDu,1,0.00171,11845,20.25029,58493
3068,pactera-cart-zhangtao,1,0.00171,11846,20.25200,58493
3069,paerlundgren,1,0.00171,11847,20.25371,58493
3070,paleksic,1,0.00171,11848,20.25542,58493
3071,panaetov,1,0.00171,11849,20.25712,58493
3072,pandeyrahulgwl,1,0.00171,11850,20.25883,58493
3073,pantocrator27,1,0.00171,11851,20.26054,58493
3074,paoll,1,0.00171,11852,20.26225,58493
3075,pappnase99,1,0.00171,11853,20.26396,58493
3076,paragradke,1,0.00171,11854,20.26567,58493
3077,parker20121,1,0.00171,11855,20.26738,58493
3078,parkjaeman,1,0.00171,11856,20.26909,58493
3079,P-A-R-U-S,1,0.00171,11857,20.27080,58493
3080,patsevanton,1,0.00171,11858,20.27251,58493
3081,paugay,1,0.00171,11859,20.27422,58493
3082,Paulche,1,0.00171,11860,20.27593,58493
3083,paulorsbrito,1,0.00171,11861,20.27764,58493
3084,pavel-pimenov,1,0.00171,11862,20.27935,58493
3085,pbenefice,1,0.00171,11863,20.28106,58493
3086,pbhosale87,1,0.00171,11864,20.28277,58493
3087,pedropovw,1,0.00171,11865,20.28448,58493
3088,peixiaoqing,1,0.00171,11866,20.28619,58493
3089,penghuiy,1,0.00171,11867,20.28790,58493
3090,perederyaev,1,0.00171,11868,20.28961,58493
3091,permyakovsv,1,0.00171,11869,20.29132,58493
3092,peterholak,1,0.00171,11870,20.29303,58493
3093,peterromfeldhk,1,0.00171,11871,20.29474,58493
3094,peter-slovak,1,0.00171,11872,20.29645,58493
3095,petersu1974,1,0.00171,11873,20.29816,58493
3096,pfriel-bcs,1,0.00171,11874,20.29986,58493
3097,pgold30,1,0.00171,11875,20.30157,58493
3098,phhutter,1,0.00171,11876,20.30328,58493
3099,philippebn,1,0.00171,11877,20.30499,58493
3100,phillipmadlan,1,0.00171,11878,20.30670,58493
3101,philm,1,0.00171,11879,20.30841,58493
3102,philtweir,1,0.00171,11880,20.31012,58493
3103,PhML,1,0.00171,11881,20.31183,58493
3104,ph-One,1,0.00171,11882,20.31354,58493
3105,phuongnd08,1,0.00171,11883,20.31525,58493
3106,pianohacker,1,0.00171,11884,20.31696,58493
3107,PierrickI3,1,0.00171,11885,20.31867,58493
3108,pik,1,0.00171,11886,20.32038,58493
3109,pinge,1,0.00171,11887,20.32209,58493
3110,pjnovas,1,0.00171,11888,20.32380,58493
3111,pkillnine,1,0.00171,11889,20.32551,58493
3112,ploef,1,0.00171,11890,20.32722,58493
3113,plorent,1,0.00171,11891,20.32893,58493
3114,Pluies,1,0.00171,11892,20.33064,58493
3115,pmatev,1,0.00171,11893,20.33235,58493
3116,pnavkumar7,1,0.00171,11894,20.33406,58493
3117,poinntt,1,0.00171,11895,20.33577,58493
3118,poison,1,0.00171,11896,20.33748,58493
3119,polm,1,0.00171,11897,20.33919,58493
3120,PortaltechGithub,1,0.00171,11898,20.34090,58493
3121,postmastery,1,0.00171,11899,20.34261,58493
3122,potapum,1,0.00171,11900,20.34431,58493
3123,ppeterson-evotek,1,0.00171,11901,20.34602,58493
3124,ppizzo,1,0.00171,11902,20.34773,58493
3125,prakashmishra1598,1,0.00171,11903,20.34944,58493
3126,prasenforu,1,0.00171,11904,20.35115,58493
3127,prashant5375,1,0.00171,11905,20.35286,58493
3128,PraveenkumarDonga,1,0.00171,11906,20.35457,58493
3129,predragstosic,1,0.00171,11907,20.35628,58493
3130,prestonvanloon,1,0.00171,11908,20.35799,58493
3131,Priyanrekha,1,0.00171,11909,20.35970,58493
3132,procyclinsur,1,0.00171,11910,20.36141,58493
3133,ProFfeSsoRr,1,0.00171,11911,20.36312,58493
3134,proger,1,0.00171,11912,20.36483,58493
3135,proligde,1,0.00171,11913,20.36654,58493
3136,protoss-player,1,0.00171,11914,20.36825,58493
3137,pshanoop,1,0.00171,11915,20.36996,58493
3138,pt300,1,0.00171,11916,20.37167,58493
3139,punneng,1,0.00171,11917,20.37338,58493
3140,purva1192,1,0.00171,11918,20.37509,58493
3141,pvdvreede,1,0.00171,11919,20.37680,58493
3142,pydo,1,0.00171,11920,20.37851,58493
3143,q42jaap,1,0.00171,11921,20.38022,58493
3144,qasmi,1,0.00171,11922,20.38193,58493
3145,QiaolingTang,1,0.00171,11923,20.38364,58493
3146,qshine,1,0.00171,11924,20.38535,58493
3147,qurname2,1,0.00171,11925,20.38705,58493
3148,r00t9,1,0.00171,11926,20.38876,58493
3149,r3lik,1,0.00171,11927,20.39047,58493
3150,rachirib,1,0.00171,11928,20.39218,58493
3151,rafalitox2,1,0.00171,11929,20.39389,58493
3152,raftAtGit,1,0.00171,11930,20.39560,58493
3153,Raghu-rajanna,1,0.00171,11931,20.39731,58493
3154,Rahkeesh,1,0.00171,11932,20.39902,58493
3155,rahravee,1,0.00171,11933,20.40073,58493
3156,rainard,1,0.00171,11934,20.40244,58493
3157,rainoko,1,0.00171,11935,20.40415,58493
3158,rajarajanpsj,1,0.00171,11936,20.40586,58493
3159,rajiff,1,0.00171,11937,20.40757,58493
3160,rajkumargithub,1,0.00171,11938,20.40928,58493
3161,rajulm,1,0.00171,11939,20.41099,58493
3162,rakshith-ponnappa,1,0.00171,11940,20.41270,58493
3163,ram2valar,1,0.00171,11941,20.41441,58493
3164,Ramasudhastv,1,0.00171,11942,20.41612,58493
3165,rami013,1,0.00171,11943,20.41783,58493
3166,ramprasadpatnaik,1,0.00171,11944,20.41954,58493
3167,randomor,1,0.00171,11945,20.42125,58493
3168,ranjeetkgupta,1,0.00171,11946,20.42296,58493
3169,raviprakashshahi,1,0.00171,11947,20.42467,58493
3170,rb1980,1,0.00171,11948,20.42638,58493
3171,rbkasat,1,0.00171,11949,20.42809,58493
3172,rbtr,1,0.00171,11950,20.42980,58493
3173,rda-dev,1,0.00171,11951,20.43150,58493
3174,rdpa,1,0.00171,11952,20.43321,58493
3175,rdr411,1,0.00171,11953,20.43492,58493
3176,rdxsuper,1,0.00171,11954,20.43663,58493
3177,reachgopal,1,0.00171,11955,20.43834,58493
3178,rebeccacaroline,1,0.00171,11956,20.44005,58493
3179,rennhak,1,0.00171,11957,20.44176,58493
3180,renzheng1987,1,0.00171,11958,20.44347,58493
3181,reymont,1,0.00171,11959,20.44518,58493
3182,rgjkugiya,1,0.00171,11960,20.44689,58493
3183,rhtenhove,1,0.00171,11961,20.44860,58493
3184,rhuddleston,1,0.00171,11962,20.45031,58493
3185,rhysmccaig,1,0.00171,11963,20.45202,58493
3186,richardsondx,1,0.00171,11964,20.45373,58493
3187,rickw,1,0.00171,11965,20.45544,58493
3188,rifqifatih,1,0.00171,11966,20.45715,58493
3189,RIKIL,1,0.00171,11967,20.45886,58493
3190,rimantoro,1,0.00171,11968,20.46057,58493
3191,ringhiera,1,0.00171,11969,20.46228,58493
3192,riquito,1,0.00171,11970,20.46399,58493
3193,ritasker,1,0.00171,11971,20.46570,58493
3194,Ritwik28,1,0.00171,11972,20.46741,58493
3195,rivetmichael,1,0.00171,11973,20.46912,58493
3196,rksatyam,1,0.00171,11974,20.47083,58493
3197,rkx-bloodshed,1,0.00171,11975,20.47254,58493
3198,rljie,1,0.00171,11976,20.47424,58493
3199,rmbreak,1,0.00171,11977,20.47595,58493
3200,roasties,1,0.00171,11978,20.47766,58493
3201,robbinscp,1,0.00171,11979,20.47937,58493
3202,robeatoz,1,0.00171,11980,20.48108,58493
3203,robertrbruno,1,0.00171,11981,20.48279,58493
3204,robertwol,1,0.00171,11982,20.48450,58493
3205,robinkb,1,0.00171,11983,20.48621,58493
3206,RobinNil,1,0.00171,11984,20.48792,58493
3207,robrsprd,1,0.00171,11985,20.48963,58493
3208,robweiss,1,0.00171,11986,20.49134,58493
3209,rodmaykel,1,0.00171,11987,20.49305,58493
3210,roeera,1,0.00171,11988,20.49476,58493
3211,rogervila,1,0.00171,11989,20.49647,58493
3212,rohitgithub26,1,0.00171,11990,20.49818,58493
3213,RohitK89,1,0.00171,11991,20.49989,58493
3214,romoy,1,0.00171,11992,20.50160,58493
3215,ronak-agarwal,1,0.00171,11993,20.50331,58493
3216,rossaffandy,1,0.00171,11994,20.50502,58493
3217,rossbeehler,1,0.00171,11995,20.50673,58493
3218,rotmond,1,0.00171,11996,20.50844,58493
3219,rparsonsbb,1,0.00171,11997,20.51015,58493
3220,rpn588,1,0.00171,11998,20.51186,58493
3221,rsommer,1,0.00171,11999,20.51357,58493
3222,rummble,1,0.00171,12000,20.51528,58493
3223,rvojcik,1,0.00171,12001,20.51698,58493
3224,ryan-dyer-sp,1,0.00171,12002,20.51869,58493
3225,ryank01,1,0.00171,12003,20.52040,58493
3226,ryo0301,1,0.00171,12004,20.52211,58493
3227,saahn,1,0.00171,12005,20.52382,58493
3228,sadhasivam,1,0.00171,12006,20.52553,58493
3229,sadpirit,1,0.00171,12007,20.52724,58493
3230,safiyat,1,0.00171,12008,20.52895,58493
3231,sagarkal,1,0.00171,12009,20.53066,58493
3232,sagarmujumale,1,0.00171,12010,20.53237,58493
3233,saharajdeep,1,0.00171,12011,20.53408,58493
3234,sahilsareen,1,0.00171,12012,20.53579,58493
3235,saint1991,1,0.00171,12013,20.53750,58493
3236,Saint1991,1,0.00171,12014,20.53921,58493
3237,salsa-dev,1,0.00171,12015,20.54092,58493
3238,saltenhub,1,0.00171,12016,20.54263,58493
3239,samgurtman,1,0.00171,12017,20.54434,58493
3240,samirspatel,1,0.00171,12018,20.54605,58493
3241,samlavery,1,0.00171,12019,20.54776,58493
3242,sanbornm,1,0.00171,12020,20.54947,58493
3243,sandeepbhojwani,1,0.00171,12021,20.55118,58493
3244,sandeepmreddy,1,0.00171,12022,20.55289,58493
3245,sandrobonazzola,1,0.00171,12023,20.55460,58493
3246,sanguinoj,1,0.00171,12024,20.55631,58493
3247,sanjitsaluja,1,0.00171,12025,20.55802,58493
3248,Santinell,1,0.00171,12026,20.55973,58493
3249,sanyer,1,0.00171,12027,20.56143,58493
3250,saviogl,1,0.00171,12028,20.56314,58493
3251,Say2,1,0.00171,12029,20.56485,58493
3252,schmooster,1,0.00171,12030,20.56656,58493
3253,schndr,1,0.00171,12031,20.56827,58493
3254,Schnitzel,1,0.00171,12032,20.56998,58493
3255,SchoIsles,1,0.00171,12033,20.57169,58493
3256,scottdhowell3,1,0.00171,12034,20.57340,58493
3257,scrowbar,1,0.00171,12035,20.57511,58493
3258,scsibug,1,0.00171,12036,20.57682,58493
3259,sd2020bs,1,0.00171,12037,20.57853,58493
3260,seancurran157,1,0.00171,12038,20.58024,58493
3261,seanmars,1,0.00171,12039,20.58195,58493
3262,seanmcguiganjcd,1,0.00171,12040,20.58366,58493
3263,Secathor,1,0.00171,12041,20.58537,58493
3264,secure0,1,0.00171,12042,20.58708,58493
3265,selfieblue,1,0.00171,12043,20.58879,58493
3266,Semmix,1,0.00171,12044,20.59050,58493
3267,sepich,1,0.00171,12045,20.59221,58493
3268,Seraf,1,0.00171,12046,20.59392,58493
3269,seratch,1,0.00171,12047,20.59563,58493
3270,serbaut,1,0.00171,12048,20.59734,58493
3271,sergeyg-earnin,1,0.00171,12049,20.59905,58493
3272,serialoverflow,1,0.00171,12050,20.60076,58493
3273,sesame,1,0.00171,12051,20.60247,58493
3274,seungyongshim,1,0.00171,12052,20.60417,58493
3275,SFHfeihong,1,0.00171,12053,20.60588,58493
3276,sfrique,1,0.00171,12054,20.60759,58493
3277,shahamit2,1,0.00171,12055,20.60930,58493
3278,sharmarajat24,1,0.00171,12056,20.61101,58493
3279,shawndream,1,0.00171,12057,20.61272,58493
3280,Shayner85,1,0.00171,12058,20.61443,58493
3281,shearer12345,1,0.00171,12059,20.61614,58493
3282,Sherler,1,0.00171,12060,20.61785,58493
3283,shiftux,1,0.00171,12061,20.61956,58493
3284,shinbero,1,0.00171,12062,20.62127,58493
3285,shinji-m,1,0.00171,12063,20.62298,58493
3286,ShironB,1,0.00171,12064,20.62469,58493
3287,shishi,1,0.00171,12065,20.62640,58493
3288,shmykyta,1,0.00171,12066,20.62811,58493
3289,show168,1,0.00171,12067,20.62982,58493
3290,shrirangphadke,1,0.00171,12068,20.63153,58493
3291,ShunHsiangYou,1,0.00171,12069,20.63324,58493
3292,shuttie,1,0.00171,12070,20.63495,58493
3293,sicriops,1,0.00171,12071,20.63666,58493
3294,sidps,1,0.00171,12072,20.63837,58493
3295,sidSingla,1,0.00171,12073,20.64008,58493
3296,silverbadge,1,0.00171,12074,20.64179,58493
3297,simonedimarzio,1,0.00171,12075,20.64350,58493
3298,sivabalans,1,0.00171,12076,20.64521,58493
3299,sivabizruntime,1,0.00171,12077,20.64692,58493
3300,sjentzsch,1,0.00171,12078,20.64862,58493
3301,skaji,1,0.00171,12079,20.65033,58493
3302,skbly7,1,0.00171,12080,20.65204,58493
3303,skny5,1,0.00171,12081,20.65375,58493
3304,sl4dy,1,0.00171,12082,20.65546,58493
3305,sleptor,1,0.00171,12083,20.65717,58493
3306,slobodyanyuk,1,0.00171,12084,20.65888,58493
3307,smallsong,1,0.00171,12085,20.66059,58493
3308,SManral,1,0.00171,12086,20.66230,58493
3309,smartlizzard,1,0.00171,12087,20.66401,58493
3310,smicha,1,0.00171,12088,20.66572,58493
3311,sNathan13,1,0.00171,12089,20.66743,58493
3312,sndyuk,1,0.00171,12090,20.66914,58493
3313,snedi,1,0.00171,12091,20.67085,58493
3314,snowhork,1,0.00171,12092,20.67256,58493
3315,sodabrew,1,0.00171,12093,20.67427,58493
3316,sonalkr132,1,0.00171,12094,20.67598,58493
3317,sossickd,1,0.00171,12095,20.67769,58493
3318,SowmyaNayan,1,0.00171,12096,20.67940,58493
3319,sparr,1,0.00171,12097,20.68111,58493
3320,splushii,1,0.00171,12098,20.68282,58493
3321,sporkmonger,1,0.00171,12099,20.68453,58493
3322,SpringMT,1,0.00171,12100,20.68624,58493
3323,sreedharbukya,1,0.00171,12101,20.68795,58493
3324,srirachapills,1,0.00171,12102,20.68966,58493
3325,srivanibhompally,1,0.00171,12103,20.69136,58493
3326,sspreitzer,1,0.00171,12104,20.69307,58493
3327,st3xupery,1,0.00171,12105,20.69478,58493
3328,stanisavs,1,0.00171,12106,20.69649,58493
3329,stanleyxc,1,0.00171,12107,20.69820,58493
3330,stefano-pogliani,1,0.00171,12108,20.69991,58493
3331,sterchelen,1,0.00171,12109,20.70162,58493
3332,stevelr,1,0.00171,12110,20.70333,58493
3333,stevenarvar,1,0.00171,12111,20.70504,58493
3334,StratusChris,1,0.00171,12112,20.70675,58493
3335,strictnerd,1,0.00171,12113,20.70846,58493
3336,strikingraghu,1,0.00171,12114,20.71017,58493
3337,suau,1,0.00171,12115,20.71188,58493
3338,subinmt,1,0.00171,12116,20.71359,58493
3339,suckowbiz,1,0.00171,12117,20.71530,58493
3340,sudhanshu-dev,1,0.00171,12118,20.71701,58493
3341,sudharsh,1,0.00171,12119,20.71872,58493
3342,sumeshpremraj,1,0.00171,12120,20.72043,58493
3343,Suresh7,1,0.00171,12121,20.72214,58493
3344,svenhenry,1,0.00171,12122,20.72385,58493
3345,swatanabeidcf,1,0.00171,12123,20.72556,58493
3346,sww0825521xy,1,0.00171,12124,20.72727,58493
3347,sysadmind,1,0.00171,12125,20.72898,58493
3348,Sytten,1,0.00171,12126,20.73069,58493
3349,syukur91,1,0.00171,12127,20.73240,58493
3350,T0MASD,1,0.00171,12128,20.73410,58493
3351,taer,1,0.00171,12129,20.73581,58493
3352,tahajahangir,1,0.00171,12130,20.73752,58493
3353,taka0125,1,0.00171,12131,20.73923,58493
3354,takashibagura,1,0.00171,12132,20.74094,58493
3355,takayahilton,1,0.00171,12133,20.74265,58493
3356,takeshy,1,0.00171,12134,20.74436,58493
3357,takumin,1,0.00171,12135,20.74607,58493
3358,talhelfgott-cx,1,0.00171,12136,20.74778,58493
3359,tamsel,1,0.00171,12137,20.74949,58493
3360,tamtam180,1,0.00171,12138,20.75120,58493
3361,tanel-andreson,1,0.00171,12139,20.75291,58493
3362,tangerstein,1,0.00171,12140,20.75462,58493
3363,taormania,1,0.00171,12141,20.75633,58493
3364,Tatsuya-Yazaki,1,0.00171,12142,20.75804,58493
3365,Tavio,1,0.00171,12143,20.75975,58493
3366,taylorshaulis,1,0.00171,12144,20.76146,58493
3367,tecbird,1,0.00171,12145,20.76317,58493
3368,tedkol,1,0.00171,12146,20.76488,58493
3369,TeslaCtroitel,1,0.00171,12147,20.76659,58493
3370,texasbobs,1,0.00171,12148,20.76830,58493
3371,thadamski,1,0.00171,12149,20.77001,58493
3372,thearifismail,1,0.00171,12150,20.77172,58493
3373,theindra,1,0.00171,12151,20.77343,58493
3374,thenovacreator,1,0.00171,12152,20.77514,58493
3375,theothermike,1,0.00171,12153,20.77685,58493
3376,Thericho,1,0.00171,12154,20.77855,58493
3377,thiago,1,0.00171,12155,20.78026,58493
3378,thiendd,1,0.00171,12156,20.78197,58493
3379,ThomWright,1,0.00171,12157,20.78368,58493
3380,thorro,1,0.00171,12158,20.78539,58493
3381,TiagoJMartins,1,0.00171,12159,20.78710,58493
3382,tiendungitd,1,0.00171,12160,20.78881,58493
3383,tilan7663,1,0.00171,12161,20.79052,58493
3384,timblackwell,1,0.00171,12162,20.79223,58493
3385,timka,1,0.00171,12163,20.79394,58493
3386,timosellin,1,0.00171,12164,20.79565,58493
3387,tinproject,1,0.00171,12165,20.79736,58493
3388,tjinjin,1,0.00171,12166,20.79907,58493
3389,tjstansell,1,0.00171,12167,20.80078,58493
3390,tmontney,1,0.00171,12168,20.80249,58493
3391,tmshn,1,0.00171,12169,20.80420,58493
3392,tmurakam,1,0.00171,12170,20.80591,58493
3393,tnaoto,1,0.00171,12171,20.80762,58493
3394,toddlers,1,0.00171,12172,20.80933,58493
3395,tombart,1,0.00171,12173,20.81104,58493
3396,Tom-Fawcett,1,0.00171,12174,20.81275,58493
3397,toniov,1,0.00171,12175,20.81446,58493
3398,TonyHuiHUI,1,0.00171,12176,20.81617,58493
3399,toughrogrammer,1,0.00171,12177,20.81788,58493
3400,tracers2222,1,0.00171,12178,20.81959,58493
3401,travis5491811,1,0.00171,12179,20.82129,58493
3402,triethuynh92,1,0.00171,12180,20.82300,58493
3403,trungduyvu,1,0.00171,12181,20.82471,58493
3404,tsailiming,1,0.00171,12182,20.82642,58493
3405,tsingakbar,1,0.00171,12183,20.82813,58493
3406,tskardal,1,0.00171,12184,20.82984,58493
3407,ttqin,1,0.00171,12185,20.83155,58493
3408,tuananh170489,1,0.00171,12186,20.83326,58493
3409,tuasowro,1,0.00171,12187,20.83497,58493
3410,tuiaswath,1,0.00171,12188,20.83668,58493
3411,turnon,1,0.00171,12189,20.83839,58493
3412,tvvignesh,1,0.00171,12190,20.84010,58493
3413,twang2218,1,0.00171,12191,20.84181,58493
3414,tweettypography,1,0.00171,12192,20.84352,58493
3415,twili9ht,1,0.00171,12193,20.84523,58493
3416,two8g,1,0.00171,12194,20.84694,58493
3417,Tyrael,1,0.00171,12195,20.84865,58493
3418,UladzimirSemiankou,1,0.00171,12196,20.85036,58493
3419,umathivagit,1,0.00171,12197,20.85207,58493
3420,umutkocasarac,1,0.00171,12198,20.85378,58493
3421,uohzxela,1,0.00171,12199,20.85549,58493
3422,usergoodvery,1,0.00171,12200,20.85720,58493
3423,uskudnik,1,0.00171,12201,20.85891,58493
3424,utkudarilmaz,1,0.00171,12202,20.86062,58493
3425,VAdamec,1,0.00171,12203,20.86233,58493
3426,vaivars,1,0.00171,12204,20.86404,58493
3427,valeba,1,0.00171,12205,20.86574,58493
3428,valentin2105,1,0.00171,12206,20.86745,58493
3429,vanomashey,1,0.00171,12207,20.86916,58493
3430,Vanshika093,1,0.00171,12208,20.87087,58493
3431,Vardhaman-Surana,1,0.00171,12209,20.87258,58493
3432,varghgeorge,1,0.00171,12210,20.87429,58493
3433,varusan,1,0.00171,12211,20.87600,58493
3434,vasilij-icabbi,1,0.00171,12212,20.87771,58493
3435,Veiasai,1,0.00171,12213,20.87942,58493
3436,VenkatNarayanaYarava,1,0.00171,12214,20.88113,58493
3437,VennilaJ,1,0.00171,12215,20.88284,58493
3438,verbunk,1,0.00171,12216,20.88455,58493
3439,vfreitas-cit,1,0.00171,12217,20.88626,58493
3440,vhdevera,1,0.00171,12218,20.88797,58493
3441,Vhodnoylogin,1,0.00171,12219,20.88968,58493
3442,vijeeshk,1,0.00171,12220,20.89139,58493
3443,Viking-Bird,1,0.00171,12221,20.89310,58493
3444,Viktor86,1,0.00171,12222,20.89481,58493
3445,vilar-rivendel,1,0.00171,12223,20.89652,58493
3446,vineethloka,1,0.00171,12224,20.89823,58493
3447,vinkdong,1,0.00171,12225,20.89994,58493
3448,viquar22,1,0.00171,12226,20.90165,58493
3449,vishalgupta1988,1,0.00171,12227,20.90336,58493
3450,vishnuvg1984,1,0.00171,12228,20.90507,58493
3451,vitalvas,1,0.00171,12229,20.90678,58493
3452,viveksamaga,1,0.00171,12230,20.90848,58493
3453,viveksatasiya,1,0.00171,12231,20.91019,58493
3454,vkareh,1,0.00171,12232,20.91190,58493
3455,VladaPetrovic,1,0.00171,12233,20.91361,58493
3456,vladget,1,0.00171,12234,20.91532,58493
3457,vmahe35,1,0.00171,12235,20.91703,58493
3458,vmanikes,1,0.00171,12236,20.91874,58493
3459,vmironenko,1,0.00171,12237,20.92045,58493
3460,vnnw,1,0.00171,12238,20.92216,58493
3461,vosdev,1,0.00171,12239,20.92387,58493
3462,vrivellino,1,0.00171,12240,20.92558,58493
3463,vsxen,1,0.00171,12241,20.92729,58493
3464,vthornheart-bng,1,0.00171,12242,20.92900,58493
3465,vvm-broadsoft,1,0.00171,12243,20.93071,58493
3466,wawadukan,1,0.00171,12244,20.93242,58493
3467,wejick,1,0.00171,12245,20.93413,58493
3468,Wesdesignz,1,0.00171,12246,20.93584,58493
3469,wgtmpeters,1,0.00171,12247,20.93755,58493
3470,WhatDream,1,0.00171,12248,20.93926,58493
3471,whitelynx,1,0.00171,12249,20.94097,58493
3472,whoard,1,0.00171,12250,20.94268,58493
3473,wilesna25,1,0.00171,12251,20.94439,58493
3474,willylee,1,0.00171,12252,20.94610,58493
3475,windgan,1,0.00171,12253,20.94781,58493
3476,windmgc,1,0.00171,12254,20.94952,58493
3477,wiza,1,0.00171,12255,20.95122,58493
3478,wolfgangihloff,1,0.00171,12256,20.95293,58493
3479,WOoWBOo,1,0.00171,12257,20.95464,58493
3480,wrossmann,1,0.00171,12258,20.95635,58493
3481,wsimmonds,1,0.00171,12259,20.95806,58493
3482,wulfgar93,1,0.00171,12260,20.95977,58493
3483,WUMUXIAN,1,0.00171,12261,20.96148,58493
3484,wzrdtales,1,0.00171,12262,20.96319,58493
3485,x09,1,0.00171,12263,20.96490,58493
3486,xadcoh,1,0.00171,12264,20.96661,58493
3487,xellsys,1,0.00171,12265,20.96832,58493
3488,xia0pin9,1,0.00171,12266,20.97003,58493
3489,XiaoGe2030,1,0.00171,12267,20.97174,58493
3490,xiaozhouzhou,1,0.00171,12268,20.97345,58493
3491,xinghui-hou,1,0.00171,12269,20.97516,58493
3492,xinghusc,1,0.00171,12270,20.97687,58493
3493,xjmnz,1,0.00171,12271,20.97858,58493
3494,xjtian,1,0.00171,12272,20.98029,58493
3495,xoroz,1,0.00171,12273,20.98200,58493
3496,xpflying,1,0.00171,12274,20.98371,58493
3497,xud6,1,0.00171,12275,20.98542,58493
3498,xuejipeng,1,0.00171,12276,20.98713,58493
3499,xujihui1985,1,0.00171,12277,20.98884,58493
3500,yakexi07,1,0.00171,12278,20.99055,58493
3501,yama-3,1,0.00171,12279,20.99226,58493
3502,yancya,1,0.00171,12280,20.99397,58493
3503,yangsong1993,1,0.00171,12281,20.99567,58493
3504,yangzb09,1,0.00171,12282,20.99738,58493
3505,ydawant,1,0.00171,12283,20.99909,58493
3506,yelavalli,1,0.00171,12284,21.00080,58493
3507,yfried,1,0.00171,12285,21.00251,58493
3508,yishaihl,1,0.00171,12286,21.00422,58493
3509,yishenggudou,1,0.00171,12287,21.00593,58493
3510,ykfq,1,0.00171,12288,21.00764,58493
3511,ykolomiets,1,0.00171,12289,21.00935,58493
3512,ylopatin-earnin,1,0.00171,12290,21.01106,58493
3513,ymartincds,1,0.00171,12291,21.01277,58493
3514,yosisa,1,0.00171,12292,21.01448,58493
3515,ypjin,1,0.00171,12293,21.01619,58493
3516,ysubach,1,0.00171,12294,21.01790,58493
3517,ytkang,1,0.00171,12295,21.01961,58493
3518,yuan-make,1,0.00171,12296,21.02132,58493
3519,yuanzy1994,1,0.00171,12297,21.02303,58493
3520,YueHonghui,1,0.00171,12298,21.02474,58493
3521,yuezijian,1,0.00171,12299,21.02645,58493
3522,yujinkay,1,0.00171,12300,21.02816,58493
3523,yuri-1987,1,0.00171,12301,21.02987,58493
3524,yusong-shen,1,0.00171,12302,21.03158,58493
3525,yuvraj2987,1,0.00171,12303,21.03329,58493
3526,yybear,1,0.00171,12304,21.03500,58493
3527,zac-nixon,1,0.00171,12305,21.03671,58493
3528,zakariahoussa,1,0.00171,12306,21.03841,58493
3529,Zenlil,1,0.00171,12307,21.04012,58493
3530,Zephery,1,0.00171,12308,21.04183,58493
3531,zerkms,1,0.00171,12309,21.04354,58493
3532,zersh01,1,0.00171,12310,21.04525,58493
3533,zfoxdev,1,0.00171,12311,21.04696,58493
3534,zhanghjster,1,0.00171,12312,21.04867,58493
3535,ZhangSIming-blyq,1,0.00171,12313,21.05038,58493
3536,zhijiangwang,1,0.00171,12314,21.05209,58493
3537,zhxiaom5,1,0.00171,12315,21.05380,58493
3538,ziaudin,1,0.00171,12316,21.05551,58493
3539,zironycho,1,0.00171,12317,21.05722,58493
3540,zkf9971,1,0.00171,12318,21.05893,58493
3541,zkrhm,1,0.00171,12319,21.06064,58493
3542,zmichael,1,0.00171,12320,21.06235,58493
3543,zoell,1,0.00171,12321,21.06406,58493
3544,zpDeveloper,1,0.00171,12322,21.06577,58493
3545,zuk,1,0.00171,12323,21.06748,58493
3546,zycbobby,1,0.00171,12324,21.06919,58493
3547,zzswang,1,0.00171,12325,21.07090,58493
