rank_number,actor,contributions,percent,cumulative_sum,cumulative_percent,all_contributions
1,stephentoub,67030,3.83691,67030,3.83691,1746978
2,mhevery,34601,1.98062,101631,5.81753,1746978
3,levitte,29808,1.70626,131439,7.52379,1746978
4,gaearon,22634,1.29561,154073,8.81940,1746978
5,vicb,21434,1.22692,175507,10.04632,1746978
6,IgorMinar,20944,1.19887,196451,11.24519,1746978
7,gkalpak,20104,1.15079,216555,12.39598,1746978
8,danmosemsft,19917,1.14008,236472,13.53606,1746978
9,petebacondarwin,17081,0.97775,253553,14.51381,1746978
10,mattcaswell,16430,0.94048,269983,15.45429,1746978
11,tagliala,15978,0.91461,285961,16.36890,1746978
12,mdo,15914,0.91094,301875,17.27984,1746978
13,pkozlowski-opensource,15158,0.86767,317033,18.14751,1746978
14,richsalz,15004,0.85885,332037,19.00636,1746978
15,jdalton,13963,0.79927,346000,19.80563,1746978
16,dougwilson,13013,0.74489,359013,20.55052,1746978
17,XhmikosR,13002,0.74426,372015,21.29477,1746978
18,cowtowncoder,12421,0.71100,384436,22.00577,1746978
19,AndrewKushnir,11463,0.65616,395899,22.66193,1746978
20,karelz,11243,0.64357,407142,23.30550,1746978
21,weshaggard,10816,0.61913,417958,23.92463,1746978
22,matsko,10625,0.60819,428583,24.53282,1746978
23,CharliePoole,10517,0.60201,439100,25.13483,1746978
24,bartonjs,10357,0.59285,449457,25.72769,1746978
25,davidsh,10294,0.58925,459751,26.31693,1746978
26,cvrebert,9777,0.55965,469528,26.87658,1746978
27,kara,9723,0.55656,479251,27.43314,1746978
28,Narretz,9602,0.54963,488853,27.98278,1746978
29,alxhub,8987,0.51443,497840,28.49721,1746978
30,alexeagle,8819,0.50481,506659,29.00203,1746978
31,ericstj,8540,0.48884,515199,29.49087,1746978
32,tbosch,8382,0.47980,523581,29.97067,1746978
33,jkotas,8288,0.47442,531869,30.44509,1746978
34,ViktorHofer,8079,0.46246,539948,30.90754,1746978
35,timdorr,7768,0.44465,547716,31.35220,1746978
36,ahsonkhan,7746,0.44339,555462,31.79559,1746978
37,safern,7060,0.40413,562522,32.19972,1746978
38,Johann-S,6510,0.37264,569032,32.57236,1746978
39,jnm2,6420,0.36749,575452,32.93985,1746978
40,lrytz,6366,0.36440,581818,33.30425,1746978
41,zpao,6077,0.34786,587895,33.65211,1746978
42,jasonaden,6010,0.34402,593905,33.99614,1746978
43,spicyj,5944,0.34024,599849,34.33638,1746978
44,retronym,5845,0.33458,605694,34.67096,1746978
45,tarekgh,5832,0.33383,611526,35.00479,1746978
46,adriaanm,5607,0.32095,617133,35.32575,1746978
47,mellinoe,5563,0.31844,622696,35.64418,1746978
48,rprouse,5447,0.31180,628143,35.95598,1746978
49,bvaughn,5183,0.29668,633326,36.25266,1746978
50,xzyfer,5113,0.29268,638439,36.54534,1746978
51,Lukasa,5045,0.28878,643484,36.83412,1746978
52,patrickhlauke,4906,0.28083,648390,37.11495,1746978
53,JeremyKuhne,4845,0.27734,653235,37.39229,1746978
54,joperezr,4835,0.27676,658070,37.66905,1746978
55,chuckjaz,4663,0.26692,662733,37.93597,1746978
56,vsavkin,4634,0.26526,667367,38.20123,1746978
57,sebmarkbage,4508,0.25805,671875,38.45927,1746978
58,epoberezkin,4493,0.25719,676368,38.71646,1746978
59,SethTisue,4415,0.25272,680783,38.96918,1746978
60,JamesNK,4271,0.24448,685054,39.21366,1746978
61,ianhays,4174,0.23893,689228,39.45259,1746978
62,mgol,4035,0.23097,693263,39.68356,1746978
63,zloirock,3827,0.21906,697090,39.90262,1746978
64,Priya91,3819,0.21861,700909,40.12123,1746978
65,acdlite,3764,0.21546,704673,40.33668,1746978
66,christopherthielen,3716,0.21271,708389,40.54939,1746978
67,krwq,3702,0.21191,712091,40.76130,1746978
68,geoffkizer,3686,0.21099,715777,40.97230,1746978
69,bgrainger,3603,0.20624,719380,41.17854,1746978
70,CIPop,3455,0.19777,722835,41.37631,1746978
71,bcoe,3305,0.18918,726140,41.56549,1746978
72,wfurt,3156,0.18065,729296,41.74615,1746978
73,JiaLiPassion,3117,0.17842,732413,41.92457,1746978
74,steveharter,3090,0.17688,735503,42.10145,1746978
75,benaadams,3070,0.17573,738573,42.27718,1746978
76,knalli,3054,0.17482,741627,42.45199,1746978
77,MartijnCuppens,2968,0.16989,744595,42.62189,1746978
78,aweary,2954,0.16909,747549,42.79098,1746978
79,ellismg,2873,0.16446,750422,42.95544,1746978
80,ariya,2855,0.16343,753277,43.11886,1746978
81,saurabh500,2846,0.16291,756123,43.28177,1746978
82,tannergooding,2836,0.16234,758959,43.44411,1746978
83,timmywil,2820,0.16142,761779,43.60553,1746978
84,cpovirk,2784,0.15936,764563,43.76489,1746978
85,dmethvin,2765,0.15827,767328,43.92316,1746978
86,sindresorhus,2653,0.15186,769981,44.07503,1746978
87,mj1856,2647,0.15152,772628,44.22654,1746978
88,aearly,2641,0.15118,775269,44.37772,1746978
89,VSadov,2510,0.14368,777779,44.52140,1746978
90,patrickkettner,2500,0.14310,780279,44.66450,1746978
91,Anipik,2475,0.14167,782754,44.80617,1746978
92,nhunzaker,2469,0.14133,785223,44.94750,1746978
93,brandonroberts,2417,0.13835,787640,45.08586,1746978
94,mmitche,2391,0.13686,790031,45.22272,1746978
95,nguerrera,2351,0.13458,792382,45.35730,1746978
96,maxokorokov,2322,0.13292,794704,45.49021,1746978
97,petkaantonov,2283,0.13068,796987,45.62090,1746978
98,shmao,2267,0.12977,799254,45.75066,1746978
99,kaduk,2251,0.12885,801505,45.87951,1746978
100,ocombe,2233,0.12782,803738,46.00733,1746978
101,jeffbcross,2219,0.12702,805957,46.13435,1746978
102,vikerman,2196,0.12570,808153,46.26006,1746978
103,markerikson,2195,0.12565,810348,46.38570,1746978
104,lgalfaso,2193,0.12553,812541,46.51123,1746978
105,megawac,2135,0.12221,814676,46.63344,1746978
106,wtgodbe,2128,0.12181,816804,46.75525,1746978
107,ljharb,2118,0.12124,818922,46.87649,1746978
108,slontis,2083,0.11923,821005,46.99573,1746978
109,davidfowl,2072,0.11860,823077,47.11433,1746978
110,benjamingr,2064,0.11815,825141,47.23248,1746978
111,scottgonzalez,2034,0.11643,827175,47.34891,1746978
112,mzgol,1955,0.11191,829130,47.46082,1746978
113,crisbeto,1942,0.11116,831072,47.57198,1746978
114,sigmavirus24,1899,0.10870,832971,47.68068,1746978
115,eerhardt,1872,0.10716,834843,47.78784,1746978
116,isaacs,1869,0.10698,836712,47.89482,1746978
117,indexzero,1854,0.10613,838566,48.00095,1746978
118,tmds,1851,0.10595,840417,48.10690,1746978
119,markelog,1836,0.10510,842253,48.21200,1746978
120,joshfree,1816,0.10395,844069,48.31595,1746978
121,gibson042,1815,0.10389,845884,48.41984,1746978
122,mjackson,1695,0.09702,847579,48.51687,1746978
123,DataTables,1685,0.09645,849264,48.61332,1746978
124,tmshort,1680,0.09617,850944,48.70949,1746978
125,cgdecker,1663,0.09519,852607,48.80468,1746978
126,szeiger,1639,0.09382,854246,48.89850,1746978
127,yjbanov,1635,0.09359,855881,48.99209,1746978
128,am11,1608,0.09204,857489,49.08413,1746978
129,rkirov,1601,0.09164,859090,49.17578,1746978
130,terrajobst,1585,0.09073,860675,49.26650,1746978
131,kapunahelewong,1584,0.09067,862259,49.35718,1746978
132,rspilker,1560,0.08930,863819,49.44647,1746978
133,trueadm,1527,0.08741,865346,49.53388,1746978
134,juliemr,1505,0.08615,866851,49.62003,1746978
135,JoostK,1483,0.08489,868334,49.70492,1746978
136,mprobst,1476,0.08449,869810,49.78941,1746978
137,hansl,1458,0.08346,871268,49.87287,1746978
138,shadowspawn,1446,0.08277,872714,49.95564,1746978
139,pjanotti,1442,0.08254,874156,50.03818,1746978
140,filipesilva,1436,0.08220,875592,50.12038,1746978
141,MattGal,1426,0.08163,877018,50.20201,1746978
142,KrzysztofCwalina,1414,0.08094,878432,50.28295,1746978
143,atscott,1412,0.08083,879844,50.36377,1746978
144,marwahaha,1405,0.08042,881249,50.44420,1746978
145,nschonni,1386,0.07934,882635,50.52353,1746978
146,tmat,1376,0.07876,884011,50.60230,1746978
147,jelbourn,1370,0.07842,885381,50.68072,1746978
148,kegluneq,1343,0.07688,886724,50.75759,1746978
149,kennethreitz,1332,0.07625,888056,50.83384,1746978
150,alan-agius4,1315,0.07527,889371,50.90911,1746978
151,caitp,1307,0.07481,890678,50.98393,1746978
152,jbedard,1293,0.07401,891971,51.05794,1746978
153,kkirsche,1262,0.07224,893233,51.13018,1746978
154,sophiebits,1256,0.07190,894489,51.20208,1746978
155,maryamariyan,1247,0.07138,895736,51.27346,1746978
156,jbogarthyde,1246,0.07132,896982,51.34478,1746978
157,GrabYourPitchforks,1235,0.07069,898217,51.41547,1746978
158,chcosta,1209,0.06921,899426,51.48468,1746978
159,maggiepint,1208,0.06915,900634,51.55383,1746978
160,jzaefferer,1201,0.06875,901835,51.62257,1746978
161,corivera,1184,0.06777,903019,51.69035,1746978
162,Qix-,1149,0.06577,904168,51.75612,1746978
163,ekasper,1146,0.06560,905314,51.82172,1746978
164,rzwitserloot,1119,0.06405,906433,51.88577,1746978
165,hueniverse,1116,0.06388,907549,51.94965,1746978
166,bartdesmet,1113,0.06371,908662,52.01336,1746978
167,rmkerr,1108,0.06342,909770,52.07679,1746978
168,AlexGhiondea,1101,0.06302,910871,52.13981,1746978
169,kouvel,1094,0.06262,911965,52.20243,1746978
170,ceki,1081,0.06188,913046,52.26431,1746978
171,jquense,1078,0.06171,914124,52.32602,1746978
172,ericeil,1054,0.06033,915178,52.38635,1746978
173,gdi2290,1040,0.05953,916218,52.44588,1746978
174,flarnie,1037,0.05936,917255,52.50524,1746978
175,romen,1032,0.05907,918287,52.56431,1746978
176,vancem,1029,0.05890,919316,52.62322,1746978
177,calvinmetcalf,1022,0.05850,920338,52.68172,1746978
178,dagood,1017,0.05821,921355,52.73993,1746978
179,broofa,986,0.05644,922341,52.79637,1746978
180,mde,986,0.05644,923327,52.85281,1746978
181,nateabele,970,0.05552,924297,52.90834,1746978
182,garydgregory,948,0.05427,925245,52.96260,1746978
183,mcollina,934,0.05346,926179,53.01607,1746978
184,bardiharborow,919,0.05261,927098,53.06867,1746978
185,pgavlin,917,0.05249,928015,53.12116,1746978
186,dwijnand,906,0.05186,928921,53.17302,1746978
187,Aweary,905,0.05180,929826,53.22483,1746978
188,Foxandxss,898,0.05140,930724,53.27623,1746978
189,gkhanna79,893,0.05112,931617,53.32735,1746978
190,rejas,893,0.05112,932510,53.37846,1746978
191,andresgalante,890,0.05095,933400,53.42941,1746978
192,filipnavara,889,0.05089,934289,53.48030,1746978
193,robmadole,886,0.05072,935175,53.53101,1746978
194,mikkelbu,884,0.05060,936059,53.58161,1746978
195,huanwu,865,0.04951,936924,53.63113,1746978
196,maxbeatty,864,0.04946,937788,53.68058,1746978
197,vijaykota,863,0.04940,938651,53.72998,1746978
198,davidben,862,0.04934,939513,53.77933,1746978
199,wesleycho,862,0.04934,940375,53.82867,1746978
200,kyliau,840,0.04808,941215,53.87675,1746978
201,analog-nico,839,0.04803,942054,53.92478,1746978
202,jonschlinkert,828,0.04740,942882,53.97217,1746978
203,necolas,826,0.04728,943708,54.01946,1746978
204,janvorli,814,0.04659,944522,54.06605,1746978
205,gregmagolan,812,0.04648,945334,54.11253,1746978
206,scalablecory,806,0.04614,946140,54.15867,1746978
207,PascalSchumacher,798,0.04568,946938,54.20435,1746978
208,DDvO,784,0.04488,947722,54.24922,1746978
209,naomiblack,773,0.04425,948495,54.29347,1746978
210,davegandy,770,0.04408,949265,54.33755,1746978
211,chenkie,762,0.04362,950027,54.38117,1746978
212,pakrym,748,0.04282,950775,54.42398,1746978
213,ronshapiro,742,0.04247,951517,54.46646,1746978
214,jridgewell,741,0.04242,952258,54.50887,1746978
215,benouat,740,0.04236,952998,54.55123,1746978
216,pallavit,736,0.04213,953734,54.59336,1746978
217,wesleytodd,734,0.04202,954468,54.63538,1746978
218,morganbr,728,0.04167,955196,54.67705,1746978
219,alexperovich,721,0.04127,955917,54.71832,1746978
220,lowasser,719,0.04116,956636,54.75948,1746978
221,akoeplinger,712,0.04076,957348,54.80023,1746978
222,t8m,704,0.04030,958052,54.84053,1746978
223,jonathantneal,703,0.04024,958755,54.88077,1746978
224,ziluvatar,702,0.04018,959457,54.92095,1746978
225,JakeWharton,701,0.04013,960158,54.96108,1746978
226,kluever,690,0.03950,960848,55.00058,1746978
227,julienrf,663,0.03795,961511,55.03853,1746978
228,kapilash,659,0.03772,962170,55.07625,1746978
229,diesalbla,653,0.03738,962823,55.11363,1746978
230,mconnew,650,0.03721,963473,55.15084,1746978
231,vjeux,644,0.03686,964117,55.18770,1746978
232,phated,630,0.03606,964747,55.22376,1746978
233,ryanflorence,621,0.03555,965368,55.25931,1746978
234,marijnh,614,0.03515,965982,55.29446,1746978
235,buyaa-n,594,0.03400,966576,55.32846,1746978
236,TimothyGu,588,0.03366,967164,55.36212,1746978
237,qmfrederik,580,0.03320,967744,55.39532,1746978
238,michaelficarra,577,0.03303,968321,55.42835,1746978
239,akre54,573,0.03280,968894,55.46114,1746978
240,Petermarcu,570,0.03263,969464,55.49377,1746978
241,sdmaclea,568,0.03251,970032,55.52629,1746978
242,sameb,557,0.03188,970589,55.55817,1746978
243,Tratcher,555,0.03177,971144,55.58994,1746978
244,khdang,546,0.03125,971690,55.62119,1746978
245,Arkni,545,0.03120,972235,55.65239,1746978
246,eiriktsarpalis,544,0.03114,972779,55.68353,1746978
247,layomia,544,0.03114,973323,55.71467,1746978
248,dwmw2,537,0.03074,973860,55.74541,1746978
249,brianrob,536,0.03068,974396,55.77609,1746978
250,TrySound,535,0.03062,974931,55.80671,1746978
251,swankjesse,530,0.03034,975461,55.83705,1746978
252,tijoytom,522,0.02988,975983,55.86693,1746978
253,sharwell,521,0.02982,976504,55.89675,1746978
254,AArnott,516,0.02954,977020,55.92629,1746978
255,kevinb9n,511,0.02925,977531,55.95554,1746978
256,jashkenas,510,0.02919,978041,55.98473,1746978
257,captbaritone,502,0.02874,978543,56.01347,1746978
258,frederikprijck,492,0.02816,979035,56.04163,1746978
259,ryanseddon,485,0.02776,979520,56.06940,1746978
260,geleems,483,0.02765,980003,56.09704,1746978
261,caleblloyd,478,0.02736,980481,56.12440,1746978
262,britter,475,0.02719,980956,56.15159,1746978
263,ok2c,474,0.02713,981430,56.17873,1746978
264,jfromaniello,473,0.02708,981903,56.20580,1746978
265,nexdrew,471,0.02696,982374,56.23276,1746978
266,karajas,469,0.02685,982843,56.25961,1746978
267,p-steuer,469,0.02685,983312,56.28646,1746978
268,ashsearle,467,0.02673,983779,56.31319,1746978
269,lmolkova,456,0.02610,984235,56.33929,1746978
270,MichalStrehovsky,456,0.02610,984691,56.36539,1746978
271,talbs,455,0.02604,985146,56.39144,1746978
272,lacker,450,0.02576,985596,56.41720,1746978
273,chkal,441,0.02524,986037,56.44244,1746978
274,dcousens,440,0.02519,986477,56.46763,1746978
275,feross,432,0.02473,986909,56.49235,1746978
276,blakeembrey,429,0.02456,987338,56.51691,1746978
277,NE-SmallTown,427,0.02444,987765,56.54135,1746978
278,vszakats,426,0.02438,988191,56.56574,1746978
279,cston,420,0.02404,988611,56.58978,1746978
280,bendrucker,415,0.02376,989026,56.61353,1746978
281,mikeal,410,0.02347,989436,56.63700,1746978
282,OmarTawfik,406,0.02324,989842,56.66024,1746978
283,ayazhafiz,400,0.02290,990242,56.68314,1746978
284,koba04,397,0.02272,990639,56.70587,1746978
285,xuwei-k,393,0.02250,991032,56.72836,1746978
286,josephperrott,392,0.02244,991424,56.75080,1746978
287,hargasinski,390,0.02232,991814,56.77312,1746978
288,vanesyan,389,0.02227,992203,56.79539,1746978
289,coliff,373,0.02135,992576,56.81674,1746978
290,shrutigarg,373,0.02135,992949,56.83809,1746978
291,maririos,368,0.02106,993317,56.85916,1746978
292,jhendrixMSFT,362,0.02072,993679,56.87988,1746978
293,ashtuchkin,361,0.02066,994040,56.90054,1746978
294,thorn0,361,0.02066,994401,56.92121,1746978
295,AaronRobinsonMSFT,359,0.02055,994760,56.94176,1746978
296,jaredhanson,348,0.01992,995108,56.96168,1746978
297,spericas,341,0.01952,995449,56.98120,1746978
298,FredKSchott,331,0.01895,995780,57.00015,1746978
299,kinow,329,0.01883,996109,57.01898,1746978
300,kentcdodds,325,0.01860,996434,57.03758,1746978
301,emilyemorehouse,312,0.01786,996746,57.05544,1746978
302,smarter,312,0.01786,997058,57.07330,1746978
303,luqunl,310,0.01774,997368,57.09105,1746978
304,maxrimue,310,0.01774,997678,57.10879,1746978
305,fiigii,307,0.01757,997985,57.12636,1746978
306,jakemac53,305,0.01746,998290,57.14382,1746978
307,mgechev,301,0.01723,998591,57.16105,1746978
308,OverZealous,300,0.01717,998891,57.17822,1746978
309,zhiyelee,295,0.01689,999186,57.19511,1746978
310,RJPercival,293,0.01677,999479,57.21188,1746978
311,VladUreche,292,0.01671,999771,57.22860,1746978
312,adamsitnik,287,0.01643,1000058,57.24503,1746978
313,mathiasbynens,283,0.01620,1000341,57.26122,1746978
314,cpojer,280,0.01603,1000621,57.27725,1746978
315,stevemao,276,0.01580,1000897,57.29305,1746978
316,gunnarmorling,273,0.01563,1001170,57.30868,1746978
317,tintoy,273,0.01563,1001443,57.32431,1746978
318,SimenB,271,0.01551,1001714,57.33982,1746978
319,venkat-raman251,271,0.01551,1001985,57.35533,1746978
320,jaredpar,268,0.01534,1002253,57.37067,1746978
321,fnagel,266,0.01523,1002519,57.38590,1746978
322,kkurni,262,0.01500,1002781,57.40089,1746978
323,gsmet,259,0.01483,1003040,57.41572,1746978
324,JedWatson,259,0.01483,1003299,57.43055,1746978
325,Andarist,258,0.01477,1003557,57.44531,1746978
326,juliangruber,257,0.01471,1003814,57.46003,1746978
327,davkean,256,0.01465,1004070,57.47468,1746978
328,SamVerschueren,255,0.01460,1004325,57.48928,1746978
329,arb,254,0.01454,1004579,57.50382,1746978
330,icfantv,254,0.01454,1004833,57.51835,1746978
331,mikem8361,251,0.01437,1005084,57.53272,1746978
332,richlander,251,0.01437,1005335,57.54709,1746978
333,rajansingh10,249,0.01425,1005584,57.56134,1746978
334,tomato42,244,0.01397,1005828,57.57531,1746978
335,andrewseguin,242,0.01385,1006070,57.58916,1746978
336,pieroxy,241,0.01380,1006311,57.60296,1746978
337,nlf,238,0.01362,1006549,57.61658,1746978
338,sebbASF,234,0.01339,1006783,57.62998,1746978
339,jrtom,233,0.01334,1007016,57.64331,1746978
340,Marsup,224,0.01282,1007240,57.65614,1746978
341,mmalerba,224,0.01282,1007464,57.66896,1746978
342,reconbot,224,0.01282,1007688,57.68178,1746978
343,omajid,222,0.01271,1007910,57.69449,1746978
344,chirayuk,220,0.01259,1008130,57.70708,1746978
345,ramarag,219,0.01254,1008349,57.71962,1746978
346,twsouthwick,219,0.01254,1008568,57.73215,1746978
347,battaglr,211,0.01208,1008779,57.74423,1746978
348,kasiabulat,211,0.01208,1008990,57.75631,1746978
349,mgravell,210,0.01202,1009200,57.76833,1746978
350,rahku,206,0.01179,1009406,57.78012,1746978
351,fbasso,205,0.01173,1009611,57.79186,1746978
352,realityking,205,0.01173,1009816,57.80359,1746978
353,arekinath,204,0.01168,1010020,57.81527,1746978
354,Diego-Perez-Botero,203,0.01162,1010223,57.82689,1746978
355,rjamet,203,0.01162,1010426,57.83851,1746978
356,mafintosh,201,0.01151,1010627,57.85001,1746978
357,ellenaua,199,0.01139,1010826,57.86140,1746978
358,jkoritzinsky,198,0.01133,1011024,57.87274,1746978
359,bep,197,0.01128,1011221,57.88401,1746978
360,ronaldtse,196,0.01122,1011417,57.89523,1746978
361,hqueue,195,0.01116,1011612,57.90640,1746978
362,AndyAyersMS,194,0.01110,1011806,57.91750,1746978
363,DanielRuf,194,0.01110,1012000,57.92861,1746978
364,DrewScoggins,194,0.01110,1012194,57.93971,1746978
365,Eilon,193,0.01105,1012387,57.95076,1746978
366,graingert,192,0.01099,1012579,57.96175,1746978
367,nickuraltsev,190,0.01088,1012769,57.97262,1746978
368,SGuyGe,188,0.01076,1012957,57.98339,1746978
369,SomeKittens,188,0.01076,1013145,57.99415,1746978
370,mattlewis92,185,0.01059,1013330,58.00474,1746978
371,Lausselloic,183,0.01048,1013513,58.01521,1746978
372,netdpb,178,0.01019,1013691,58.02540,1746978
373,seanstrom,178,0.01019,1013869,58.03559,1746978
374,stash,177,0.01013,1014046,58.04572,1746978
375,satazor,176,0.01007,1014222,58.05580,1746978
376,blowdart,175,0.01002,1014397,58.06581,1746978
377,Daniel15,174,0.00996,1014571,58.07577,1746978
378,dsgouda,173,0.00990,1014744,58.08568,1746978
379,robertmesserle,171,0.00979,1014915,58.09547,1746978
380,davglass,168,0.00962,1015083,58.10508,1746978
381,jorive,168,0.00962,1015251,58.11470,1746978
382,tinayuangao,167,0.00956,1015418,58.12426,1746978
383,felixfbecker,166,0.00950,1015584,58.13376,1746978
384,jimcarley,166,0.00950,1015750,58.14326,1746978
385,naamunds,165,0.00944,1015915,58.15271,1746978
386,MitMaro,164,0.00939,1016079,58.16209,1746978
387,peterblazejewicz,164,0.00939,1016243,58.17148,1746978
388,SedarG,164,0.00939,1016407,58.18087,1746978
389,baulig,163,0.00933,1016570,58.19020,1746978
390,kevva,162,0.00927,1016732,58.19947,1746978
391,motdotla,162,0.00927,1016894,58.20875,1746978
392,noahfalk,161,0.00922,1017055,58.21796,1746978
393,loganfsmyth,158,0.00904,1017213,58.22701,1746978
394,smile21prc,158,0.00904,1017371,58.23605,1746978
395,dimo414,157,0.00899,1017528,58.24504,1746978
396,supergibbs,157,0.00899,1017685,58.25402,1746978
397,cartermp,156,0.00893,1017841,58.26295,1746978
398,divdavem,155,0.00887,1017996,58.27183,1746978
399,simo5,153,0.00876,1018149,58.28059,1746978
400,que-etc,152,0.00870,1018301,58.28929,1746978
401,adiaaida,145,0.00830,1018446,58.29759,1746978
402,JohnPostlethwait,144,0.00824,1018590,58.30583,1746978
403,adrianheine,143,0.00819,1018733,58.31401,1746978
404,hramos,143,0.00819,1018876,58.32220,1746978
405,leo,143,0.00819,1019019,58.33039,1746978
406,andschwa,141,0.00807,1019160,58.33846,1746978
407,devongovett,141,0.00807,1019301,58.34653,1746978
408,Bezier89,140,0.00801,1019441,58.35454,1746978
409,Khaledgarbaya,139,0.00796,1019580,58.36250,1746978
410,ChALkeR,138,0.00790,1019718,58.37040,1746978
411,dragos,138,0.00790,1019856,58.37830,1746978
412,mairaw,138,0.00790,1019994,58.38620,1746978
413,glebm,137,0.00784,1020131,58.39404,1746978
414,Marusyk,137,0.00784,1020268,58.40188,1746978
415,AntonLapounov,136,0.00778,1020404,58.40967,1746978
416,davidmakepeace,136,0.00778,1020540,58.41745,1746978
417,gkossakowski,136,0.00778,1020676,58.42523,1746978
418,tatsuhiro-t,135,0.00773,1020811,58.43296,1746978
419,butterflyhug,134,0.00767,1020945,58.44063,1746978
420,clemmy,134,0.00767,1021079,58.44830,1746978
421,mureinik,132,0.00756,1021211,58.45586,1746978
422,tunniclm,132,0.00756,1021343,58.46342,1746978
423,Akretsch,131,0.00750,1021474,58.47091,1746978
424,joecritch,131,0.00750,1021605,58.47841,1746978
425,sebastienros,131,0.00750,1021736,58.48591,1746978
426,hseok-oh,130,0.00744,1021866,58.49335,1746978
427,rvagg,130,0.00744,1021996,58.50079,1746978
428,defunctzombie,129,0.00738,1022125,58.50818,1746978
429,Krinkle,129,0.00738,1022254,58.51556,1746978
430,jansupol,128,0.00733,1022382,58.52289,1746978
431,StephenBonikowsky,127,0.00727,1022509,58.53016,1746978
432,raja-ashok,126,0.00721,1022635,58.53737,1746978
433,JohnTortugo,125,0.00716,1022760,58.54453,1746978
434,nglorioso,125,0.00716,1022885,58.55168,1746978
435,vitek-karas,124,0.00710,1023009,58.55878,1746978
436,mattbishop,121,0.00693,1023130,58.56571,1746978
437,stash-sfdc,121,0.00693,1023251,58.57263,1746978
438,alex,120,0.00687,1023371,58.57950,1746978
439,billyjanitsch,120,0.00687,1023491,58.58637,1746978
440,dicko2,115,0.00658,1023606,58.59295,1746978
441,josguil,115,0.00658,1023721,58.59954,1746978
442,jyoungyun,114,0.00653,1023835,58.60606,1746978
443,KKhurin,113,0.00647,1023948,58.61253,1746978
444,lukesandberg,113,0.00647,1024061,58.61900,1746978
445,jcagme,112,0.00641,1024173,58.62541,1746978
446,jon-oracle,112,0.00641,1024285,58.63182,1746978
447,crummel,109,0.00624,1024394,58.63806,1746978
448,kunalspathak,109,0.00624,1024503,58.64430,1746978
449,nicolo-ribaudo,109,0.00624,1024612,58.65054,1746978
450,tiran,109,0.00624,1024721,58.65678,1746978
451,YingP99,109,0.00624,1024830,58.66302,1746978
452,BruceForstall,108,0.00618,1024938,58.66920,1746978
453,hann013,107,0.00612,1025045,58.67532,1746978
454,Artazor,106,0.00607,1025151,58.68139,1746978
455,netomi,106,0.00607,1025257,58.68746,1746978
456,stevelinsell,106,0.00607,1025363,58.69353,1746978
457,cwe1ss,105,0.00601,1025468,58.69954,1746978
458,adityamandaleeka,104,0.00595,1025572,58.70549,1746978
459,chtompki,104,0.00595,1025676,58.71144,1746978
460,pvorb,104,0.00595,1025780,58.71740,1746978
461,leecow,103,0.00590,1025883,58.72329,1746978
462,jeffschwMSFT,102,0.00584,1025985,58.72913,1746978
463,kanongil,101,0.00578,1026086,58.73491,1746978
464,nslottow,101,0.00578,1026187,58.74069,1746978
465,BrennanConroy,100,0.00572,1026287,58.74642,1746978
466,JohnRGee,100,0.00572,1026387,58.75214,1746978
467,agocke,99,0.00567,1026486,58.75781,1746978
468,JustinBeckwith,99,0.00567,1026585,58.76348,1746978
469,davidwrighton,96,0.00550,1026681,58.76897,1746978
470,ruippeixotog,96,0.00550,1026777,58.77447,1746978
471,ChrisAlderson,95,0.00544,1026872,58.77990,1746978
472,evocateur,95,0.00544,1026967,58.78534,1746978
473,jsoref,95,0.00544,1027062,58.79078,1746978
474,dsplaisted,94,0.00538,1027156,58.79616,1746978
475,RReverser,94,0.00538,1027250,58.80154,1746978
476,TheSavior,94,0.00538,1027344,58.80692,1746978
477,gbalykov,93,0.00532,1027437,58.81225,1746978
478,mapleeit,93,0.00532,1027530,58.81757,1746978
479,felipewmartins,92,0.00527,1027622,58.82284,1746978
480,macjohnny,92,0.00527,1027714,58.82810,1746978
481,swgillespie,92,0.00527,1027806,58.83337,1746978
482,dcwuser,91,0.00521,1027897,58.83858,1746978
483,davepacheco,90,0.00515,1027987,58.84373,1746978
484,lajones,90,0.00515,1028077,58.84888,1746978
485,jcrugzz,89,0.00509,1028166,58.85398,1746978
486,pose,89,0.00509,1028255,58.85907,1746978
487,troygoode,89,0.00509,1028344,58.86416,1746978
488,chlowell,88,0.00504,1028432,58.86920,1746978
489,JimboWei,88,0.00504,1028520,58.87424,1746978
490,gregw,86,0.00492,1028606,58.87916,1746978
491,ahmadnassri,85,0.00487,1028691,58.88403,1746978
492,Atry,84,0.00481,1028775,58.88884,1746978
493,doowb,84,0.00481,1028859,58.89364,1746978
494,iamjasonp,84,0.00481,1028943,58.89845,1746978
495,andreialecu,83,0.00475,1029026,58.90320,1746978
496,evqna,82,0.00469,1029108,58.90790,1746978
497,roncain,82,0.00469,1029190,58.91259,1746978
498,benelliott,81,0.00464,1029271,58.91723,1746978
499,jcdickinson,81,0.00464,1029352,58.92186,1746978
500,jskeet,81,0.00464,1029433,58.92650,1746978
501,pharring,81,0.00464,1029514,58.93114,1746978
502,contra,79,0.00452,1029593,58.93566,1746978
503,bloodyowl,78,0.00446,1029671,58.94012,1746978
504,othiym23,78,0.00446,1029749,58.94459,1746978
505,PatrickJS,78,0.00446,1029827,58.94905,1746978
506,goderbauer,77,0.00441,1029904,58.95346,1746978
507,sam-github,77,0.00441,1029981,58.95787,1746978
508,Sridhar-MS,77,0.00441,1030058,58.96228,1746978
509,sywhang,77,0.00441,1030135,58.96668,1746978
510,monkindey,76,0.00435,1030211,58.97103,1746978
511,wateret,75,0.00429,1030286,58.97533,1746978
512,reaperhulk,74,0.00424,1030360,58.97956,1746978
513,robdodson,74,0.00424,1030434,58.98380,1746978
514,substack,74,0.00424,1030508,58.98804,1746978
515,awaterma,73,0.00418,1030581,58.99221,1746978
516,cheenamalhotra,73,0.00418,1030654,58.99639,1746978
517,chonton,73,0.00418,1030727,59.00057,1746978
518,josalem,73,0.00418,1030800,59.00475,1746978
519,leemgs,73,0.00418,1030873,59.00893,1746978
520,mjrousos,73,0.00418,1030946,59.01311,1746978
521,PeterDaveHello,73,0.00418,1031019,59.01729,1746978
522,swaroop-sridhar,72,0.00412,1031091,59.02141,1746978
523,gafter,70,0.00401,1031161,59.02541,1746978
524,pgovind,70,0.00401,1031231,59.02942,1746978
525,yoshuawuyts,69,0.00395,1031300,59.03337,1746978
526,agrandi,68,0.00389,1031368,59.03726,1746978
527,rainersigwald,68,0.00389,1031436,59.04116,1746978
528,gourlaysama,67,0.00384,1031503,59.04499,1746978
529,Lekensteyn,67,0.00384,1031570,59.04883,1746978
530,Simek,67,0.00384,1031637,59.05266,1746978
531,vladak,67,0.00384,1031704,59.05650,1746978
532,zertosh,67,0.00384,1031771,59.06033,1746978
533,Chrisboh,66,0.00378,1031837,59.06411,1746978
534,davidjb,66,0.00378,1031903,59.06789,1746978
535,Jozkee,66,0.00378,1031969,59.07167,1746978
536,markt-asf,66,0.00378,1032035,59.07544,1746978
537,notrab,66,0.00378,1032101,59.07922,1746978
538,qizhanMS,66,0.00378,1032167,59.08300,1746978
539,SteveL-MSFT,66,0.00378,1032233,59.08678,1746978
540,dariobraun,65,0.00372,1032298,59.09050,1746978
541,dstufft,65,0.00372,1032363,59.09422,1746978
542,leebyron,65,0.00372,1032428,59.09794,1746978
543,briansmith,64,0.00366,1032492,59.10160,1746978
544,ChadNedzlek,64,0.00366,1032556,59.10527,1746978
545,Haroenv,64,0.00366,1032620,59.10893,1746978
546,jamesgeorge007,64,0.00366,1032684,59.11259,1746978
547,AlfredoMS,63,0.00361,1032747,59.11620,1746978
548,kevinburke,63,0.00361,1032810,59.11981,1746978
549,olalonde,63,0.00361,1032873,59.12341,1746978
550,bjjones,62,0.00355,1032935,59.12696,1746978
551,haf,62,0.00355,1032997,59.13051,1746978
552,jbnicolai,62,0.00355,1033059,59.13406,1746978
553,michael-o,62,0.00355,1033121,59.13761,1746978
554,epeli,61,0.00349,1033182,59.14110,1746978
555,MichaelSimons,61,0.00349,1033243,59.14459,1746978
556,niksy,61,0.00349,1033304,59.14808,1746978
557,pprindeville,61,0.00349,1033365,59.15157,1746978
558,AlekseyTs,59,0.00338,1033424,59.15495,1746978
559,edevil,59,0.00338,1033483,59.15833,1746978
560,erozenfeld,58,0.00332,1033541,59.16165,1746978
561,astrahov,57,0.00326,1033598,59.16491,1746978
562,danez,57,0.00326,1033655,59.16817,1746978
563,stevenbrix,57,0.00326,1033712,59.17144,1746978
564,davmason,56,0.00321,1033768,59.17464,1746978
565,just-boris,56,0.00321,1033824,59.17785,1746978
566,SergeyKanzhelev,56,0.00321,1033880,59.18105,1746978
567,amilajack,55,0.00315,1033935,59.18420,1746978
568,gabrielschulhof,55,0.00315,1033990,59.18735,1746978
569,orta,55,0.00315,1034045,59.19050,1746978
570,pgilad,55,0.00315,1034100,59.19365,1746978
571,pra85,55,0.00315,1034155,59.19680,1746978
572,dsblv,54,0.00309,1034209,59.19989,1746978
573,krosenvold,54,0.00309,1034263,59.20298,1746978
574,mmikowski,54,0.00309,1034317,59.20607,1746978
575,ScottSWu,54,0.00309,1034371,59.20916,1746978
576,thomas-mcdonald,54,0.00309,1034425,59.21225,1746978
577,ciz,53,0.00303,1034478,59.21528,1746978
578,frozencemetery,53,0.00303,1034531,59.21832,1746978
579,mpeylo,53,0.00303,1034584,59.22135,1746978
580,riarenas,53,0.00303,1034637,59.22439,1746978
581,typicaljoe,53,0.00303,1034690,59.22742,1746978
582,aeijdenberg,52,0.00298,1034742,59.23040,1746978
583,bshannon,52,0.00298,1034794,59.23337,1746978
584,jayaram-intel,52,0.00298,1034846,59.23635,1746978
585,Lxiamail,52,0.00298,1034898,59.23933,1746978
586,mschoudry,52,0.00298,1034950,59.24230,1746978
587,tomocchino,52,0.00298,1035002,59.24528,1746978
588,tquerec,52,0.00298,1035054,59.24826,1746978
589,CodingFabian,51,0.00292,1035105,59.25118,1746978
590,dseefeld,51,0.00292,1035156,59.25409,1746978
591,imcarolwang,50,0.00286,1035206,59.25696,1746978
592,robrich,50,0.00286,1035256,59.25982,1746978
593,billwert,49,0.00280,1035305,59.26262,1746978
594,cushon,49,0.00280,1035354,59.26543,1746978
595,ravimeda,49,0.00280,1035403,59.26823,1746978
596,specio,49,0.00280,1035452,59.27104,1746978
597,daxian-dbw,48,0.00275,1035500,59.27379,1746978
598,stuartwdouglas,47,0.00269,1035547,59.27648,1746978
599,moozzyk,46,0.00263,1035593,59.27911,1746978
600,agl,45,0.00258,1035638,59.28169,1746978
601,KyleAMathews,45,0.00258,1035683,59.28426,1746978
602,lpereira,45,0.00258,1035728,59.28684,1746978
603,nbilling,45,0.00258,1035773,59.28941,1746978
604,asoldano,44,0.00252,1035817,59.29193,1746978
605,brahmnes,44,0.00252,1035861,59.29445,1746978
606,fritx,44,0.00252,1035905,59.29697,1746978
607,IlyaBiryukov,44,0.00252,1035949,59.29949,1746978
608,swseverance,44,0.00252,1035993,59.30201,1746978
609,tarikulsabbir,44,0.00252,1036037,59.30452,1746978
610,BridgeAR,43,0.00246,1036080,59.30699,1746978
611,cshung,43,0.00246,1036123,59.30945,1746978
612,echesakovMSFT,43,0.00246,1036166,59.31191,1746978
613,JounQin,43,0.00246,1036209,59.31437,1746978
614,LokeshN,43,0.00246,1036252,59.31683,1746978
615,martinheidegger,43,0.00246,1036295,59.31929,1746978
616,MattWhilden,43,0.00246,1036338,59.32175,1746978
617,waywardgeek,43,0.00246,1036381,59.32422,1746978
618,ahasall,42,0.00240,1036423,59.32662,1746978
619,amZotti,42,0.00240,1036465,59.32902,1746978
620,zbjornson,42,0.00240,1036507,59.33143,1746978
621,333fred,41,0.00235,1036548,59.33378,1746978
622,DnlHarvey,41,0.00235,1036589,59.33612,1746978
623,eamonnmcmanus,41,0.00235,1036630,59.33847,1746978
624,ofrobots,41,0.00235,1036671,59.34082,1746978
625,AmazingJaze,40,0.00229,1036711,59.34311,1746978
626,elharo,40,0.00229,1036751,59.34540,1746978
627,t-8ch,40,0.00229,1036791,59.34768,1746978
628,bmeurer,39,0.00223,1036830,59.34992,1746978
629,meteorcloudy,39,0.00223,1036869,59.35215,1746978
630,stevemoser,39,0.00223,1036908,59.35438,1746978
631,tgriesser,39,0.00223,1036947,59.35661,1746978
632,trevorlinton,39,0.00223,1036986,59.35885,1746978
633,chunseoklee,38,0.00218,1037024,59.36102,1746978
634,Dmitri-Botcharnikov,38,0.00218,1037062,59.36320,1746978
635,grimreaper,38,0.00218,1037100,59.36537,1746978
636,jashook,38,0.00218,1037138,59.36755,1746978
637,csvn,37,0.00212,1037175,59.36967,1746978
638,Huachao,37,0.00212,1037212,59.37178,1746978
639,nymanjens,37,0.00212,1037249,59.37390,1746978
640,dariajung,36,0.00206,1037285,59.37596,1746978
641,gregg-miskelly,36,0.00206,1037321,59.37802,1746978
642,ide,36,0.00206,1037357,59.38008,1746978
643,kgoldman,36,0.00206,1037393,59.38214,1746978
644,sfackler,36,0.00206,1037429,59.38421,1746978
645,TrevorKarjanis,36,0.00206,1037465,59.38627,1746978
646,calebmer,35,0.00200,1037500,59.38827,1746978
647,cgruber,35,0.00200,1037535,59.39027,1746978
648,ericelliott,35,0.00200,1037570,59.39228,1746978
649,jarrodyellets,35,0.00200,1037605,59.39428,1746978
650,kenneth-reitz,35,0.00200,1037640,59.39628,1746978
651,mrpre,35,0.00200,1037675,59.39829,1746978
652,dreddy-work,34,0.00195,1037709,59.40023,1746978
653,felixbuenemann,34,0.00195,1037743,59.40218,1746978
654,langpavel,34,0.00195,1037777,59.40413,1746978
655,mrmlnc,34,0.00195,1037811,59.40607,1746978
656,nertzy,34,0.00195,1037845,59.40802,1746978
657,rahulkotecha,34,0.00195,1037879,59.40996,1746978
658,reda-alaoui,34,0.00195,1037913,59.41191,1746978
659,shrah,34,0.00195,1037947,59.41386,1746978
660,sjsinju,34,0.00195,1037981,59.41580,1746978
661,vojtajina,34,0.00195,1038015,59.41775,1746978
662,vslinko,34,0.00195,1038049,59.41970,1746978
663,Eddman,33,0.00189,1038082,59.42158,1746978
664,fredsa,33,0.00189,1038115,59.42347,1746978
665,ghatwala,33,0.00189,1038148,59.42536,1746978
666,kachkaev,33,0.00189,1038181,59.42725,1746978
667,steelbrain,33,0.00189,1038214,59.42914,1746978
668,edmorley,32,0.00183,1038246,59.43097,1746978
669,lucenticus,32,0.00183,1038278,59.43280,1746978
670,ScrapCodes,31,0.00177,1038309,59.43458,1746978
671,cortopy,30,0.00172,1038339,59.43630,1746978
672,hoyMS,30,0.00172,1038369,59.43801,1746978
673,jakkdu,30,0.00172,1038399,59.43973,1746978
674,jtattermusch,30,0.00172,1038429,59.44145,1746978
675,LoicMahieu,30,0.00172,1038459,59.44316,1746978
676,mcandre,30,0.00172,1038489,59.44488,1746978
677,nikolas,30,0.00172,1038519,59.44660,1746978
678,A-And,29,0.00166,1038548,59.44826,1746978
679,erikerlandson,29,0.00166,1038577,59.44992,1746978
680,josephsavona,29,0.00166,1038606,59.45158,1746978
681,JunTaoLuo,29,0.00166,1038635,59.45324,1746978
682,koto,29,0.00166,1038664,59.45490,1746978
683,ricokahler,29,0.00166,1038693,59.45656,1746978
684,stone-li,29,0.00166,1038722,59.45822,1746978
685,YongseopKim,29,0.00166,1038751,59.45988,1746978
686,Freyert,28,0.00160,1038779,59.46148,1746978
687,krotscheck,28,0.00160,1038807,59.46308,1746978
688,monkey-mas,28,0.00160,1038835,59.46469,1746978
689,motiz88,28,0.00160,1038863,59.46629,1746978
690,rikles,28,0.00160,1038891,59.46789,1746978
691,ruiaraujo,28,0.00160,1038919,59.46950,1746978
692,sjanuary,28,0.00160,1038947,59.47110,1746978
693,thomasmey,28,0.00160,1038975,59.47270,1746978
694,v-yanbgu,28,0.00160,1039003,59.47430,1746978
695,adorokhine,27,0.00155,1039030,59.47585,1746978
696,dciccale,27,0.00155,1039057,59.47739,1746978
697,grooverdan,27,0.00155,1039084,59.47894,1746978
698,jeremycline,27,0.00155,1039111,59.48049,1746978
699,jonfortescue,27,0.00155,1039138,59.48203,1746978
700,LucasSloan,27,0.00155,1039165,59.48358,1746978
701,seanshpark,27,0.00155,1039192,59.48512,1746978
702,srawlins,27,0.00155,1039219,59.48667,1746978
703,TimLovellSmith,27,0.00155,1039246,59.48821,1746978
704,jvz,26,0.00149,1039272,59.48970,1746978
705,kolodny,26,0.00149,1039298,59.49119,1746978
706,Pothulapati,26,0.00149,1039324,59.49268,1746978
707,skfd,26,0.00149,1039350,59.49417,1746978
708,adob,25,0.00143,1039375,59.49560,1746978
709,dead-horse,25,0.00143,1039400,59.49703,1746978
710,dminkovsky,25,0.00143,1039425,59.49846,1746978
711,ebourg,25,0.00143,1039450,59.49989,1746978
712,gitter-badger,25,0.00143,1039475,59.50132,1746978
713,Globegitter,25,0.00143,1039500,59.50275,1746978
714,huntc,25,0.00143,1039525,59.50418,1746978
715,ilovett,25,0.00143,1039550,59.50561,1746978
716,JensRantil,25,0.00143,1039575,59.50705,1746978
717,jochenw,25,0.00143,1039600,59.50848,1746978
718,JohnVillalovos,25,0.00143,1039625,59.50991,1746978
719,leidegre,25,0.00143,1039650,59.51134,1746978
720,nickdesaulniers,25,0.00143,1039675,59.51277,1746978
721,ppham27,25,0.00143,1039700,59.51420,1746978
722,rgbkrk,25,0.00143,1039725,59.51563,1746978
723,tbroadley,25,0.00143,1039750,59.51706,1746978
724,terinjokes,25,0.00143,1039775,59.51849,1746978
725,AloisMahdal,24,0.00137,1039799,59.51987,1746978
726,cjihrig,24,0.00137,1039823,59.52124,1746978
727,ericsoderberghp,24,0.00137,1039847,59.52262,1746978
728,matthauck,24,0.00137,1039871,59.52399,1746978
729,mike-marcacci,24,0.00137,1039895,59.52536,1746978
730,rmannibucau,24,0.00137,1039919,59.52674,1746978
731,simonua,24,0.00137,1039943,59.52811,1746978
732,tcurdt,24,0.00137,1039967,59.52948,1746978
733,bimargulies,23,0.00132,1039990,59.53080,1746978
734,ExFlo,23,0.00132,1040013,59.53212,1746978
735,jozefizso,23,0.00132,1040036,59.53343,1746978
736,kevinsimper,23,0.00132,1040059,59.53475,1746978
737,KuraFire,23,0.00132,1040082,59.53607,1746978
738,supercodepoet,23,0.00132,1040105,59.53738,1746978
739,zorrorffm,23,0.00132,1040128,59.53870,1746978
740,borekb,22,0.00126,1040150,59.53996,1746978
741,chentsulin,22,0.00126,1040172,59.54122,1746978
742,dpursehouse,22,0.00126,1040194,59.54248,1746978
743,Gregoirevda,22,0.00126,1040216,59.54374,1746978
744,MaximRouiller,22,0.00126,1040238,59.54500,1746978
745,msmorgan,22,0.00126,1040260,59.54626,1746978
746,omeid,22,0.00126,1040282,59.54752,1746978
747,PavelKopyl,22,0.00126,1040304,59.54878,1746978
748,raboof,22,0.00126,1040326,59.55003,1746978
749,rwinch,22,0.00126,1040348,59.55129,1746978
750,sheerun,22,0.00126,1040370,59.55255,1746978
751,Vanuan,22,0.00126,1040392,59.55381,1746978
752,vlajos,22,0.00126,1040414,59.55507,1746978
753,watson,22,0.00126,1040436,59.55633,1746978
754,wincent,22,0.00126,1040458,59.55759,1746978
755,christianhuening,21,0.00120,1040479,59.55879,1746978
756,client9,21,0.00120,1040500,59.55999,1746978
757,damieng,21,0.00120,1040521,59.56120,1746978
758,escodel,21,0.00120,1040542,59.56240,1746978
759,gsans,21,0.00120,1040563,59.56360,1746978
760,IvanGoncharov,21,0.00120,1040584,59.56480,1746978
761,noscripter,21,0.00120,1040605,59.56600,1746978
762,startswithaj,21,0.00120,1040626,59.56721,1746978
763,tiziano88,21,0.00120,1040647,59.56841,1746978
764,zarenner,21,0.00120,1040668,59.56961,1746978
765,artem-smotrakov,20,0.00114,1040688,59.57076,1746978
766,brad4d,20,0.00114,1040708,59.57190,1746978
767,danielnorberg,20,0.00114,1040728,59.57305,1746978
768,dongjoon-hyun,20,0.00114,1040748,59.57419,1746978
769,EdwardBetts,20,0.00114,1040768,59.57534,1746978
770,feloy,20,0.00114,1040788,59.57648,1746978
771,Jokero,20,0.00114,1040808,59.57762,1746978
772,lersek,20,0.00114,1040828,59.57877,1746978
773,MLoughry,20,0.00114,1040848,59.57991,1746978
774,sschuberth,20,0.00114,1040868,59.58106,1746978
775,YourDeveloperFriend,20,0.00114,1040888,59.58220,1746978
776,bkniffler,19,0.00109,1040907,59.58329,1746978
777,ido-ran,19,0.00109,1040926,59.58438,1746978
778,isnotinvain,19,0.00109,1040945,59.58547,1746978
779,jwilk,19,0.00109,1040964,59.58655,1746978
780,marlon360,19,0.00109,1040983,59.58764,1746978
781,meenie,19,0.00109,1041002,59.58873,1746978
782,mixed,19,0.00109,1041021,59.58982,1746978
783,rmg,19,0.00109,1041040,59.59090,1746978
784,robphoenix,19,0.00109,1041059,59.59199,1746978
785,victorhurdugaci,19,0.00109,1041078,59.59308,1746978
786,Ana06,18,0.00103,1041096,59.59411,1746978
787,bruno-garcia,18,0.00103,1041114,59.59514,1746978
788,brycecr,18,0.00103,1041132,59.59617,1746978
789,cesarandreu,18,0.00103,1041150,59.59720,1746978
790,davido,18,0.00103,1041168,59.59823,1746978
791,egor-n,18,0.00103,1041186,59.59926,1746978
792,fh1ch,18,0.00103,1041204,59.60029,1746978
793,hzamani,18,0.00103,1041222,59.60132,1746978
794,ineuwirth,18,0.00103,1041240,59.60235,1746978
795,kstanger,18,0.00103,1041258,59.60338,1746978
796,nateq314,18,0.00103,1041276,59.60441,1746978
797,npmccallum,18,0.00103,1041294,59.60544,1746978
798,shimingsg,18,0.00103,1041312,59.60647,1746978
799,sunandabalu,18,0.00103,1041330,59.60751,1746978
800,avkonst,17,0.00097,1041347,59.60848,1746978
801,baer,17,0.00097,1041364,59.60945,1746978
802,deki,17,0.00097,1041381,59.61042,1746978
803,gabelevi,17,0.00097,1041398,59.61140,1746978
804,github-cygwin,17,0.00097,1041415,59.61237,1746978
805,gmile,17,0.00097,1041432,59.61334,1746978
806,jshoudy11,17,0.00097,1041449,59.61432,1746978
807,Kingwl,17,0.00097,1041466,59.61529,1746978
808,Kuroky360,17,0.00097,1041483,59.61626,1746978
809,slintes,17,0.00097,1041500,59.61724,1746978
810,snakefoot,17,0.00097,1041517,59.61821,1746978
811,wuweiweiwu,17,0.00097,1041534,59.61918,1746978
812,aheckmann,16,0.00092,1041550,59.62010,1746978
813,alpencolt,16,0.00092,1041566,59.62101,1746978
814,andyfleming,16,0.00092,1041582,59.62193,1746978
815,astorije,16,0.00092,1041598,59.62285,1746978
816,CoffeeFlux,16,0.00092,1041614,59.62376,1746978
817,CXuesong,16,0.00092,1041630,59.62468,1746978
818,davidmatson,16,0.00092,1041646,59.62559,1746978
819,erikvanderpoel,16,0.00092,1041662,59.62651,1746978
820,gnomeontherun,16,0.00092,1041678,59.62743,1746978
821,jadekler,16,0.00092,1041694,59.62834,1746978
822,KraigWalker,16,0.00092,1041710,59.62926,1746978
823,macrozone,16,0.00092,1041726,59.63017,1746978
824,matthewloring,16,0.00092,1041742,59.63109,1746978
825,mebigfatguy,16,0.00092,1041758,59.63200,1746978
826,MichielDeMey,16,0.00092,1041774,59.63292,1746978
827,pjfanning,16,0.00092,1041790,59.63384,1746978
828,stuartpb,16,0.00092,1041806,59.63475,1746978
829,tmortagne,16,0.00092,1041822,59.63567,1746978
830,Urigo,16,0.00092,1041838,59.63658,1746978
831,armujahid,15,0.00086,1041853,59.63744,1746978
832,cminyard,15,0.00086,1041868,59.63830,1746978
833,demohi,15,0.00086,1041883,59.63916,1746978
834,ecasilla,15,0.00086,1041898,59.64002,1746978
835,eljefedelrodeodeljefe,15,0.00086,1041913,59.64088,1746978
836,ericedens,15,0.00086,1041928,59.64174,1746978
837,jhaber,15,0.00086,1041943,59.64259,1746978
838,joshwand,15,0.00086,1041958,59.64345,1746978
839,ojhad,15,0.00086,1041973,59.64431,1746978
840,RameshwarapuSanthosh,15,0.00086,1041988,59.64517,1746978
841,ryysud,15,0.00086,1042003,59.64603,1746978
842,soulgalore,15,0.00086,1042018,59.64689,1746978
843,StarpTech,15,0.00086,1042033,59.64775,1746978
844,vbauer,15,0.00086,1042048,59.64860,1746978
845,adam-26,14,0.00080,1042062,59.64941,1746978
846,arianf,14,0.00080,1042076,59.65021,1746978
847,benmccann,14,0.00080,1042090,59.65101,1746978
848,cvle,14,0.00080,1042104,59.65181,1746978
849,delmyers,14,0.00080,1042118,59.65261,1746978
850,FGRibreau,14,0.00080,1042132,59.65341,1746978
851,gregturn,14,0.00080,1042146,59.65421,1746978
852,hmalphettes,14,0.00080,1042160,59.65502,1746978
853,Jakuje,14,0.00080,1042174,59.65582,1746978
854,jimma,14,0.00080,1042188,59.65662,1746978
855,johnjbarton,14,0.00080,1042202,59.65742,1746978
856,lyip1992,14,0.00080,1042216,59.65822,1746978
857,mbroz,14,0.00080,1042230,59.65902,1746978
858,nodkz,14,0.00080,1042244,59.65982,1746978
859,pavolloffay,14,0.00080,1042258,59.66063,1746978
860,randing89,14,0.00080,1042272,59.66143,1746978
861,ryanbrandenburg,14,0.00080,1042286,59.66223,1746978
862,simonferquel,14,0.00080,1042300,59.66303,1746978
863,srl295,14,0.00080,1042314,59.66383,1746978
864,tbodt,14,0.00080,1042328,59.66463,1746978
865,thomaspink,14,0.00080,1042342,59.66543,1746978
866,ulisesh,14,0.00080,1042356,59.66624,1746978
867,vaseker,14,0.00080,1042370,59.66704,1746978
868,vkvenkat,14,0.00080,1042384,59.66784,1746978
869,aswaterman,13,0.00074,1042397,59.66858,1746978
870,brendankenny,13,0.00074,1042410,59.66933,1746978
871,briananderson1222,13,0.00074,1042423,59.67007,1746978
872,BrunoQuaresma,13,0.00074,1042436,59.67081,1746978
873,jermowery,13,0.00074,1042449,59.67156,1746978
874,jin,13,0.00074,1042462,59.67230,1746978
875,kaelig,13,0.00074,1042475,59.67305,1746978
876,karinazhou,13,0.00074,1042488,59.67379,1746978
877,kofemann,13,0.00074,1042501,59.67454,1746978
878,lukecwik,13,0.00074,1042514,59.67528,1746978
879,marob,13,0.00074,1042527,59.67602,1746978
880,mbrukman,13,0.00074,1042540,59.67677,1746978
881,mhbseal,13,0.00074,1042553,59.67751,1746978
882,mitchellwills,13,0.00074,1042566,59.67826,1746978
883,nvartolomei,13,0.00074,1042579,59.67900,1746978
884,oshalygin,13,0.00074,1042592,59.67974,1746978
885,puradox,13,0.00074,1042605,59.68049,1746978
886,ralphbean,13,0.00074,1042618,59.68123,1746978
887,ravishivt,13,0.00074,1042631,59.68198,1746978
888,rdsubhas,13,0.00074,1042644,59.68272,1746978
889,remram44,13,0.00074,1042657,59.68346,1746978
890,rictic,13,0.00074,1042670,59.68421,1746978
891,robcresswell,13,0.00074,1042683,59.68495,1746978
892,spacepluk,13,0.00074,1042696,59.68570,1746978
893,ahmetb,12,0.00069,1042708,59.68638,1746978
894,alphonsekurian,12,0.00069,1042720,59.68707,1746978
895,anarcat,12,0.00069,1042732,59.68776,1746978
896,Awk34,12,0.00069,1042744,59.68844,1746978
897,b0ri5,12,0.00069,1042756,59.68913,1746978
898,cclauss,12,0.00069,1042768,59.68982,1746978
899,davidkarlsen,12,0.00069,1042780,59.69051,1746978
900,dcbrwn,12,0.00069,1042792,59.69119,1746978
901,devknoll,12,0.00069,1042804,59.69188,1746978
902,dorireuv,12,0.00069,1042816,59.69257,1746978
903,ericcurtin,12,0.00069,1042828,59.69325,1746978
904,fatcerberus,12,0.00069,1042840,59.69394,1746978
905,fourcube,12,0.00069,1042852,59.69463,1746978
906,hairyhenderson,12,0.00069,1042864,59.69531,1746978
907,jacobwgillespie,12,0.00069,1042876,59.69600,1746978
908,jakub-bochenski,12,0.00069,1042888,59.69669,1746978
909,jaredcnance,12,0.00069,1042900,59.69737,1746978
910,jeremejevs,12,0.00069,1042912,59.69806,1746978
911,jroper,12,0.00069,1042924,59.69875,1746978
912,karolz-ms,12,0.00069,1042936,59.69944,1746978
913,krmannix,12,0.00069,1042948,59.70012,1746978
914,MarSik,12,0.00069,1042960,59.70081,1746978
915,mertdeg2,12,0.00069,1042972,59.70150,1746978
916,peterhuene,12,0.00069,1042984,59.70218,1746978
917,plaes,12,0.00069,1042996,59.70287,1746978
918,richardweinberger,12,0.00069,1043008,59.70356,1746978
919,RinkAttendant6,12,0.00069,1043020,59.70424,1746978
920,sajeetharan,12,0.00069,1043032,59.70493,1746978
921,samwgoldman,12,0.00069,1043044,59.70562,1746978
922,shiftkey,12,0.00069,1043056,59.70630,1746978
923,silentroach,12,0.00069,1043068,59.70699,1746978
924,ygatesoupe,12,0.00069,1043080,59.70768,1746978
925,ZitaNemeckova,12,0.00069,1043092,59.70836,1746978
926,alexwlchan,11,0.00063,1043103,59.70899,1746978
927,alistair23,11,0.00063,1043114,59.70962,1746978
928,alokmenghrajani,11,0.00063,1043125,59.71025,1746978
929,amrocs,11,0.00063,1043136,59.71088,1746978
930,anpete,11,0.00063,1043147,59.71151,1746978
931,bolinfest,11,0.00063,1043158,59.71214,1746978
932,connor4312,11,0.00063,1043169,59.71277,1746978
933,dgreensp,11,0.00063,1043180,59.71340,1746978
934,fcamblor,11,0.00063,1043191,59.71403,1746978
935,felixonmars,11,0.00063,1043202,59.71466,1746978
936,gkdn,11,0.00063,1043213,59.71529,1746978
937,icholy,11,0.00063,1043224,59.71592,1746978
938,ipuustin,11,0.00063,1043235,59.71655,1746978
939,jfigus,11,0.00063,1043246,59.71718,1746978
940,jgangemi,11,0.00063,1043257,59.71781,1746978
941,jonasfj,11,0.00063,1043268,59.71844,1746978
942,joshuagl,11,0.00063,1043279,59.71907,1746978
943,moander,11,0.00063,1043290,59.71970,1746978
944,msmeissn,11,0.00063,1043301,59.72033,1746978
945,normj,11,0.00063,1043312,59.72096,1746978
946,Parent5446,11,0.00063,1043323,59.72159,1746978
947,paulmon,11,0.00063,1043334,59.72222,1746978
948,tealtail,11,0.00063,1043345,59.72285,1746978
949,aherbert,10,0.00057,1043355,59.72342,1746978
950,AlexZeitler,10,0.00057,1043365,59.72399,1746978
951,cemo,10,0.00057,1043375,59.72456,1746978
952,cnwhy,10,0.00057,1043385,59.72514,1746978
953,dlindenkreuz,10,0.00057,1043395,59.72571,1746978
954,dsyme,10,0.00057,1043405,59.72628,1746978
955,dyladan,10,0.00057,1043415,59.72685,1746978
956,fwbrasil,10,0.00057,1043425,59.72743,1746978
957,glasser,10,0.00057,1043435,59.72800,1746978
958,grant,10,0.00057,1043445,59.72857,1746978
959,jamesward,10,0.00057,1043455,59.72914,1746978
960,jay98014,10,0.00057,1043465,59.72972,1746978
961,joshperry,10,0.00057,1043475,59.73029,1746978
962,jurca,10,0.00057,1043485,59.73086,1746978
963,kassens,10,0.00057,1043495,59.73143,1746978
964,kaycebasques,10,0.00057,1043505,59.73201,1746978
965,kkm000,10,0.00057,1043515,59.73258,1746978
966,lvarayut,10,0.00057,1043525,59.73315,1746978
967,mariusschulz,10,0.00057,1043535,59.73372,1746978
968,mdonoughe,10,0.00057,1043545,59.73430,1746978
969,mikesamuel,10,0.00057,1043555,59.73487,1746978
970,pierre-b,10,0.00057,1043565,59.73544,1746978
971,r4j4h,10,0.00057,1043575,59.73601,1746978
972,rdodev,10,0.00057,1043585,59.73659,1746978
973,RobertKielty,10,0.00057,1043595,59.73716,1746978
974,ShivanKaul,10,0.00057,1043605,59.73773,1746978
975,sjackman,10,0.00057,1043615,59.73830,1746978
976,sumitbhagwani,10,0.00057,1043625,59.73887,1746978
977,vanessanschmitt,10,0.00057,1043635,59.73945,1746978
978,vladmos,10,0.00057,1043645,59.74002,1746978
979,Yeti-or,10,0.00057,1043655,59.74059,1746978
980,z3ntu,10,0.00057,1043665,59.74116,1746978
981,2rs2ts,9,0.00052,1043674,59.74168,1746978
982,abcfy2,9,0.00052,1043683,59.74219,1746978
983,ademuri,9,0.00052,1043692,59.74271,1746978
984,akupila,9,0.00052,1043701,59.74323,1746978
985,andrenarchy,9,0.00052,1043710,59.74374,1746978
986,bolu,9,0.00052,1043719,59.74426,1746978
987,carltonf,9,0.00052,1043728,59.74477,1746978
988,Cryrivers,9,0.00052,1043737,59.74529,1746978
989,davoam,9,0.00052,1043746,59.74580,1746978
990,flozano,9,0.00052,1043755,59.74632,1746978
991,HongGit,9,0.00052,1043764,59.74683,1746978
992,JackOfMostTrades,9,0.00052,1043773,59.74735,1746978
993,jasonkuhrt,9,0.00052,1043782,59.74786,1746978
994,johnlabarge,9,0.00052,1043791,59.74838,1746978
995,jzlxiaohei,9,0.00052,1043800,59.74889,1746978
996,kpaxqin,9,0.00052,1043809,59.74941,1746978
997,leimaohui,9,0.00052,1043818,59.74992,1746978
998,mairin,9,0.00052,1043827,59.75044,1746978
999,masterfung,9,0.00052,1043836,59.75095,1746978
1000,md5,9,0.00052,1043845,59.75147,1746978
1001,mhutch,9,0.00052,1043854,59.75198,1746978
1002,michaelstaib,9,0.00052,1043863,59.75250,1746978
1003,morgante,9,0.00052,1043872,59.75301,1746978
1004,mrennie,9,0.00052,1043881,59.75353,1746978
1005,Naddiseo,9,0.00052,1043890,59.75404,1746978
1006,nadiatk,9,0.00052,1043899,59.75456,1746978
1007,njhill,9,0.00052,1043908,59.75507,1746978
1008,olegsu,9,0.00052,1043917,59.75559,1746978
1009,Petrukha,9,0.00052,1043926,59.75610,1746978
1010,ralfhandl,9,0.00052,1043935,59.75662,1746978
1011,shawnhar,9,0.00052,1043944,59.75713,1746978
1012,skevy,9,0.00052,1043953,59.75765,1746978
1013,slandelle,9,0.00052,1043962,59.75817,1746978
1014,slang800,9,0.00052,1043971,59.75868,1746978
1015,TAGC,9,0.00052,1043980,59.75920,1746978
1016,tbroyer,9,0.00052,1043989,59.75971,1746978
1017,timeimp,9,0.00052,1043998,59.76023,1746978
1018,torbenh3,9,0.00052,1044007,59.76074,1746978
1019,vielmetti,9,0.00052,1044016,59.76126,1746978
1020,xiaoshuang-lu,9,0.00052,1044025,59.76177,1746978
1021,yarikoptic,9,0.00052,1044034,59.76229,1746978
1022,yaroslavya,9,0.00052,1044043,59.76280,1746978
1023,yorickhenning,9,0.00052,1044052,59.76332,1746978
1024,adispring,8,0.00046,1044060,59.76377,1746978
1025,blimmer,8,0.00046,1044068,59.76423,1746978
1026,bouk,8,0.00046,1044076,59.76469,1746978
1027,chrishiestand,8,0.00046,1044084,59.76515,1746978
1028,daztucker,8,0.00046,1044092,59.76561,1746978
1029,directhex,8,0.00046,1044100,59.76606,1746978
1030,Dominator008,8,0.00046,1044108,59.76652,1746978
1031,DullReferenceException,8,0.00046,1044116,59.76698,1746978
1032,ecki,8,0.00046,1044124,59.76744,1746978
1033,eddywashere,8,0.00046,1044132,59.76790,1746978
1034,edenlee1212,8,0.00046,1044140,59.76835,1746978
1035,epixa,8,0.00046,1044148,59.76881,1746978
1036,fabdouglas,8,0.00046,1044156,59.76927,1746978
1037,gliptak,8,0.00046,1044164,59.76973,1746978
1038,gnoack,8,0.00046,1044172,59.77019,1746978
1039,halkeye,8,0.00046,1044180,59.77064,1746978
1040,Havner,8,0.00046,1044188,59.77110,1746978
1041,heshamMassoud,8,0.00046,1044196,59.77156,1746978
1042,javabrett,8,0.00046,1044204,59.77202,1746978
1043,jglick,8,0.00046,1044212,59.77248,1746978
1044,JiangJi,8,0.00046,1044220,59.77293,1746978
1045,johngmyers,8,0.00046,1044228,59.77339,1746978
1046,jpiccari,8,0.00046,1044236,59.77385,1746978
1047,jstarks,8,0.00046,1044244,59.77431,1746978
1048,kmala,8,0.00046,1044252,59.77477,1746978
1049,ksophocleous,8,0.00046,1044260,59.77522,1746978
1050,lsiudut,8,0.00046,1044268,59.77568,1746978
1051,marciopuga,8,0.00046,1044276,59.77614,1746978
1052,mausch,8,0.00046,1044284,59.77660,1746978
1053,micmro,8,0.00046,1044292,59.77706,1746978
1054,neosab,8,0.00046,1044300,59.77751,1746978
1055,nickgrealy,8,0.00046,1044308,59.77797,1746978
1056,NothingEverHappens,8,0.00046,1044316,59.77843,1746978
1057,nurse,8,0.00046,1044324,59.77889,1746978
1058,otaviojava,8,0.00046,1044332,59.77934,1746978
1059,perezd,8,0.00046,1044340,59.77980,1746978
1060,pietern,8,0.00046,1044348,59.78026,1746978
1061,rochdev,8,0.00046,1044356,59.78072,1746978
1062,soimy,8,0.00046,1044364,59.78118,1746978
1063,southpolesteve,8,0.00046,1044372,59.78163,1746978
1064,stain,8,0.00046,1044380,59.78209,1746978
1065,starpit,8,0.00046,1044388,59.78255,1746978
1066,StephenMolloy,8,0.00046,1044396,59.78301,1746978
1067,teohhanhui,8,0.00046,1044404,59.78347,1746978
1068,theganyo,8,0.00046,1044412,59.78392,1746978
1069,themez,8,0.00046,1044420,59.78438,1746978
1070,thomasdarimont,8,0.00046,1044428,59.78484,1746978
1071,thomaswelton,8,0.00046,1044436,59.78530,1746978
1072,tIGO,8,0.00046,1044444,59.78576,1746978
1073,Tomas-Kraus,8,0.00046,1044452,59.78621,1746978
1074,wikier,8,0.00046,1044460,59.78667,1746978
1075,wking,8,0.00046,1044468,59.78713,1746978
1076,wolfgangGoedel,8,0.00046,1044476,59.78759,1746978
1077,wub,8,0.00046,1044484,59.78805,1746978
1078,zeke,8,0.00046,1044492,59.78850,1746978
1079,zx2c4,8,0.00046,1044500,59.78896,1746978
1080,alexellis,7,0.00040,1044507,59.78936,1746978
1081,andrebrait,7,0.00040,1044514,59.78976,1746978
1082,andy-ms,7,0.00040,1044521,59.79016,1746978
1083,benjie,7,0.00040,1044528,59.79056,1746978
1084,blueyed,7,0.00040,1044535,59.79096,1746978
1085,bz2,7,0.00040,1044542,59.79137,1746978
1086,Cito,7,0.00040,1044549,59.79177,1746978
1087,cournape,7,0.00040,1044556,59.79217,1746978
1088,DamonGant,7,0.00040,1044563,59.79257,1746978
1089,danielwertheim,7,0.00040,1044570,59.79297,1746978
1090,darcyadams,7,0.00040,1044577,59.79337,1746978
1091,davidstanke,7,0.00040,1044584,59.79377,1746978
1092,daxtens,7,0.00040,1044591,59.79417,1746978
1093,deitch,7,0.00040,1044598,59.79457,1746978
1094,dimaqq,7,0.00040,1044605,59.79497,1746978
1095,dimvar,7,0.00040,1044612,59.79537,1746978
1096,dlech,7,0.00040,1044619,59.79577,1746978
1097,DmitryKakurin,7,0.00040,1044626,59.79617,1746978
1098,dnozay,7,0.00040,1044633,59.79657,1746978
1099,dveeden,7,0.00040,1044640,59.79698,1746978
1100,evolvah,7,0.00040,1044647,59.79738,1746978
1101,floreks,7,0.00040,1044654,59.79778,1746978
1102,frasertweedale,7,0.00040,1044661,59.79818,1746978
1103,frosas,7,0.00040,1044668,59.79858,1746978
1104,fson,7,0.00040,1044675,59.79898,1746978
1105,gk5885,7,0.00040,1044682,59.79938,1746978
1106,goostleek,7,0.00040,1044689,59.79978,1746978
1107,hpurmann,7,0.00040,1044696,59.80018,1746978
1108,hypery2k,7,0.00040,1044703,59.80058,1746978
1109,iemejia,7,0.00040,1044710,59.80098,1746978
1110,jamesr73,7,0.00040,1044717,59.80138,1746978
1111,jefferai,7,0.00040,1044724,59.80178,1746978
1112,jiria,7,0.00040,1044731,59.80218,1746978
1113,JordanP,7,0.00040,1044738,59.80258,1746978
1114,jwuliger,7,0.00040,1044745,59.80299,1746978
1115,kaptajnen,7,0.00040,1044752,59.80339,1746978
1116,myungjoo,7,0.00040,1044759,59.80379,1746978
1117,ndelangen,7,0.00040,1044766,59.80419,1746978
1118,pavlin99th,7,0.00040,1044773,59.80459,1746978
1119,pvanderlinden,7,0.00040,1044780,59.80499,1746978
1120,sanoursa,7,0.00040,1044787,59.80539,1746978
1121,sethpollack,7,0.00040,1044794,59.80579,1746978
1122,sixlettervariables,7,0.00040,1044801,59.80619,1746978
1123,Sovietaced,7,0.00040,1044808,59.80659,1746978
1124,sputnik13,7,0.00040,1044815,59.80699,1746978
1125,stieler-it,7,0.00040,1044822,59.80739,1746978
1126,syrnick,7,0.00040,1044829,59.80779,1746978
1127,tamird,7,0.00040,1044836,59.80819,1746978
1128,tanaka-takayoshi,7,0.00040,1044843,59.80860,1746978
1129,tfarina,7,0.00040,1044850,59.80900,1746978
1130,thedrow,7,0.00040,1044857,59.80940,1746978
1131,thomassuckow,7,0.00040,1044864,59.80980,1746978
1132,tomgeorge,7,0.00040,1044871,59.81020,1746978
1133,torvitas,7,0.00040,1044878,59.81060,1746978
1134,viniciusls,7,0.00040,1044885,59.81100,1746978
1135,vorburger,7,0.00040,1044892,59.81140,1746978
1136,wadahiro,7,0.00040,1044899,59.81180,1746978
1137,Wilfred,7,0.00040,1044906,59.81220,1746978
1138,xerofoify,7,0.00040,1044913,59.81260,1746978
1139,zg,7,0.00040,1044920,59.81300,1746978
1140,zhaozhiming,7,0.00040,1044927,59.81340,1746978
1141,a86c6f7964,6,0.00034,1044933,59.81375,1746978
1142,acarl005,6,0.00034,1044939,59.81409,1746978
1143,agentgonzo,6,0.00034,1044945,59.81443,1746978
1144,alexkli,6,0.00034,1044951,59.81478,1746978
1145,al-k21,6,0.00034,1044957,59.81512,1746978
1146,ankon,6,0.00034,1044963,59.81546,1746978
1147,arnaudruffin,6,0.00034,1044969,59.81581,1746978
1148,aroc,6,0.00034,1044975,59.81615,1746978
1149,askhalil,6,0.00034,1044981,59.81649,1746978
1150,bjori,6,0.00034,1044987,59.81684,1746978
1151,blia,6,0.00034,1044993,59.81718,1746978
1152,brianwyantora,6,0.00034,1044999,59.81752,1746978
1153,chelsiocrypto,6,0.00034,1045005,59.81787,1746978
1154,colus001,6,0.00034,1045011,59.81821,1746978
1155,coryfklein,6,0.00034,1045017,59.81856,1746978
1156,csutherl,6,0.00034,1045023,59.81890,1746978
1157,DanielMSchmidt,6,0.00034,1045029,59.81924,1746978
1158,dcbeckett,6,0.00034,1045035,59.81959,1746978
1159,discostu105,6,0.00034,1045041,59.81993,1746978
1160,djyde,6,0.00034,1045047,59.82027,1746978
1161,dmandelin,6,0.00034,1045053,59.82062,1746978
1162,dsoprea,6,0.00034,1045059,59.82096,1746978
1163,elgalu,6,0.00034,1045065,59.82130,1746978
1164,enaqx,6,0.00034,1045071,59.82165,1746978
1165,Evangelink,6,0.00034,1045077,59.82199,1746978
1166,faascape,6,0.00034,1045083,59.82233,1746978
1167,farazfazli,6,0.00034,1045089,59.82268,1746978
1168,gesellix,6,0.00034,1045095,59.82302,1746978
1169,gperrow-SAP,6,0.00034,1045101,59.82336,1746978
1170,guenhter,6,0.00034,1045107,59.82371,1746978
1171,haxorz,6,0.00034,1045113,59.82405,1746978
1172,hotpxl,6,0.00034,1045119,59.82439,1746978
1173,jamielennox,6,0.00034,1045125,59.82474,1746978
1174,jhmanson,6,0.00034,1045131,59.82508,1746978
1175,jiafu1115,6,0.00034,1045137,59.82542,1746978
1176,jldec,6,0.00034,1045143,59.82577,1746978
1177,jloisel,6,0.00034,1045149,59.82611,1746978
1178,juanpablo-santos,6,0.00034,1045155,59.82645,1746978
1179,kaylangan,6,0.00034,1045161,59.82680,1746978
1180,KindDragon,6,0.00034,1045167,59.82714,1746978
1181,klippx,6,0.00034,1045173,59.82748,1746978
1182,Kornel,6,0.00034,1045179,59.82783,1746978
1183,Kuqd,6,0.00034,1045185,59.82817,1746978
1184,larsks,6,0.00034,1045191,59.82852,1746978
1185,LinuxSuRen,6,0.00034,1045197,59.82886,1746978
1186,marcbachmann,6,0.00034,1045203,59.82920,1746978
1187,marians,6,0.00034,1045209,59.82955,1746978
1188,mayani,6,0.00034,1045215,59.82989,1746978
1189,mgedmin,6,0.00034,1045221,59.83023,1746978
1190,mnadeem,6,0.00034,1045227,59.83058,1746978
1191,nacx,6,0.00034,1045233,59.83092,1746978
1192,nddipiazza,6,0.00034,1045239,59.83126,1746978
1193,nevetS,6,0.00034,1045245,59.83161,1746978
1194,nicky-zs,6,0.00034,1045251,59.83195,1746978
1195,northtyphoon,6,0.00034,1045257,59.83229,1746978
1196,oxlay,6,0.00034,1045263,59.83264,1746978
1197,perlun,6,0.00034,1045269,59.83298,1746978
1198,plappermaul,6,0.00034,1045275,59.83332,1746978
1199,radarhere,6,0.00034,1045281,59.83367,1746978
1200,rafaelsales,6,0.00034,1045287,59.83401,1746978
1201,robey,6,0.00034,1045293,59.83435,1746978
1202,senivam,6,0.00034,1045299,59.83470,1746978
1203,SkReD,6,0.00034,1045305,59.83504,1746978
1204,Starefossen,6,0.00034,1045311,59.83538,1746978
1205,sufuf3,6,0.00034,1045317,59.83573,1746978
1206,taylorwood,6,0.00034,1045323,59.83607,1746978
1207,tokuhirom,6,0.00034,1045329,59.83641,1746978
1208,trappar,6,0.00034,1045335,59.83676,1746978
1209,trxcllnt,6,0.00034,1045341,59.83710,1746978
1210,tsabirgaliev,6,0.00034,1045347,59.83745,1746978
1211,ttencate,6,0.00034,1045353,59.83779,1746978
1212,tycho,6,0.00034,1045359,59.83813,1746978
1213,waynebrantley,6,0.00034,1045365,59.83848,1746978
1214,willseeyou,6,0.00034,1045371,59.83882,1746978
1215,xizhao,6,0.00034,1045377,59.83916,1746978
1216,XZ-X,6,0.00034,1045383,59.83951,1746978
1217,ymlbright,6,0.00034,1045389,59.83985,1746978
1218,15characterlimi,5,0.00029,1045394,59.84014,1746978
1219,AdamWill,5,0.00029,1045399,59.84042,1746978
1220,agwells,5,0.00029,1045404,59.84071,1746978
1221,allanchau,5,0.00029,1045409,59.84099,1746978
1222,amadeus,5,0.00029,1045414,59.84128,1746978
1223,anangaur,5,0.00029,1045419,59.84157,1746978
1224,anpieber,5,0.00029,1045424,59.84185,1746978
1225,antonblanchard,5,0.00029,1045429,59.84214,1746978
1226,asilvas,5,0.00029,1045434,59.84243,1746978
1227,batrick,5,0.00029,1045439,59.84271,1746978
1228,bodewig,5,0.00029,1045444,59.84300,1746978
1229,bsyk,5,0.00029,1045449,59.84328,1746978
1230,buzden,5,0.00029,1045454,59.84357,1746978
1231,cakine,5,0.00029,1045459,59.84386,1746978
1232,cemremengu,5,0.00029,1045464,59.84414,1746978
1233,ClementGautier,5,0.00029,1045469,59.84443,1746978
1234,codesuki,5,0.00029,1045474,59.84471,1746978
1235,dancasey,5,0.00029,1045479,59.84500,1746978
1236,DanLipsitt,5,0.00029,1045484,59.84529,1746978
1237,dhensen,5,0.00029,1045489,59.84557,1746978
1238,donaldchai,5,0.00029,1045494,59.84586,1746978
1239,DQNEO,5,0.00029,1045499,59.84615,1746978
1240,evanlucas,5,0.00029,1045504,59.84643,1746978
1241,evnm,5,0.00029,1045509,59.84672,1746978
1242,fhemberger,5,0.00029,1045514,59.84700,1746978
1243,galenandrew,5,0.00029,1045519,59.84729,1746978
1244,ilovezfs,5,0.00029,1045524,59.84758,1746978
1245,J5,5,0.00029,1045529,59.84786,1746978
1246,jamacku,5,0.00029,1045534,59.84815,1746978
1247,jaytaylor,5,0.00029,1045539,59.84844,1746978
1248,jcruz2us,5,0.00029,1045544,59.84872,1746978
1249,jdom,5,0.00029,1045549,59.84901,1746978
1250,jenlampton,5,0.00029,1045554,59.84929,1746978
1251,jlavallee,5,0.00029,1045559,59.84958,1746978
1252,JongHeonChoi,5,0.00029,1045564,59.84987,1746978
1253,kfenner,5,0.00029,1045569,59.85015,1746978
1254,ligurio,5,0.00029,1045574,59.85044,1746978
1255,localheinz,5,0.00029,1045579,59.85073,1746978
1256,lumag,5,0.00029,1045584,59.85101,1746978
1257,mad-gooze,5,0.00029,1045589,59.85130,1746978
1258,mafagafogigante,5,0.00029,1045594,59.85158,1746978
1259,mar-kolya,5,0.00029,1045599,59.85187,1746978
1260,MatthewDavidCampbell,5,0.00029,1045604,59.85216,1746978
1261,mgalgs,5,0.00029,1045609,59.85244,1746978
1262,michael-k,5,0.00029,1045614,59.85273,1746978
1263,mlorbetske,5,0.00029,1045619,59.85301,1746978
1264,moonchanyong,5,0.00029,1045624,59.85330,1746978
1265,msprotz,5,0.00029,1045629,59.85359,1746978
1266,mtgibbs,5,0.00029,1045634,59.85387,1746978
1267,notxcain,5,0.00029,1045639,59.85416,1746978
1268,pgr0ss,5,0.00029,1045644,59.85445,1746978
1269,ppKrauss,5,0.00029,1045649,59.85473,1746978
1270,pracucci,5,0.00029,1045654,59.85502,1746978
1271,PunKeel,5,0.00029,1045659,59.85530,1746978
1272,rockwotj,5,0.00029,1045664,59.85559,1746978
1273,saponifi3d,5,0.00029,1045669,59.85588,1746978
1274,scottmarlow,5,0.00029,1045674,59.85616,1746978
1275,sergiomcalzada,5,0.00029,1045679,59.85645,1746978
1276,silhouettes,5,0.00029,1045684,59.85674,1746978
1277,slickplaid,5,0.00029,1045689,59.85702,1746978
1278,ssbarnea,5,0.00029,1045694,59.85731,1746978
1279,steven-zou,5,0.00029,1045699,59.85759,1746978
1280,Strajk,5,0.00029,1045704,59.85788,1746978
1281,sweiss-google,5,0.00029,1045709,59.85817,1746978
1282,tan9,5,0.00029,1045714,59.85845,1746978
1283,tasanuma,5,0.00029,1045719,59.85874,1746978
1284,techtonik,5,0.00029,1045724,59.85903,1746978
1285,tonybaroneee,5,0.00029,1045729,59.85931,1746978
1286,tweksteen,5,0.00029,1045734,59.85960,1746978
1287,vanmierlo,5,0.00029,1045739,59.85988,1746978
1288,Vimal-Raghubir,5,0.00029,1045744,59.86017,1746978
1289,vinayvishal,5,0.00029,1045749,59.86046,1746978
1290,vincentbernat,5,0.00029,1045754,59.86074,1746978
1291,vincentwoo,5,0.00029,1045759,59.86103,1746978
1292,whitlockjc,5,0.00029,1045764,59.86131,1746978
1293,ykzts,5,0.00029,1045769,59.86160,1746978
1294,ystarlongzi,5,0.00029,1045774,59.86189,1746978
1295,aaronp24,4,0.00023,1045778,59.86212,1746978
1296,abernix,4,0.00023,1045782,59.86235,1746978
1297,acr31,4,0.00023,1045786,59.86257,1746978
1298,adrian-crum,4,0.00023,1045790,59.86280,1746978
1299,aeharding,4,0.00023,1045794,59.86303,1746978
1300,akx,4,0.00023,1045798,59.86326,1746978
1301,albertvaka,4,0.00023,1045802,59.86349,1746978
1302,apaatsio,4,0.00023,1045806,59.86372,1746978
1303,arliang,4,0.00023,1045810,59.86395,1746978
1304,arpit-nagar,4,0.00023,1045814,59.86418,1746978
1305,arthurschreiber,4,0.00023,1045818,59.86441,1746978
1306,arvinio,4,0.00023,1045822,59.86463,1746978
1307,AsturaPhoenix,4,0.00023,1045826,59.86486,1746978
1308,aterreno,4,0.00023,1045830,59.86509,1746978
1309,aviau,4,0.00023,1045834,59.86532,1746978
1310,benc-uk,4,0.00023,1045838,59.86555,1746978
1311,benjdlambert,4,0.00023,1045842,59.86578,1746978
1312,berendt,4,0.00023,1045846,59.86601,1746978
1313,berkerpeksag,4,0.00023,1045850,59.86624,1746978
1314,biblesyme,4,0.00023,1045854,59.86647,1746978
1315,blueknob,4,0.00023,1045858,59.86670,1746978
1316,brendanashworth,4,0.00023,1045862,59.86692,1746978
1317,bryant1410,4,0.00023,1045866,59.86715,1746978
1318,bsideup,4,0.00023,1045870,59.86738,1746978
1319,c9s,4,0.00023,1045874,59.86761,1746978
1320,carlosjgp,4,0.00023,1045878,59.86784,1746978
1321,Carreau,4,0.00023,1045882,59.86807,1746978
1322,cgrushko,4,0.00023,1045886,59.86830,1746978
1323,charleswhchan,4,0.00023,1045890,59.86853,1746978
1324,christophetd,4,0.00023,1045894,59.86876,1746978
1325,cjolif,4,0.00023,1045898,59.86899,1746978
1326,cndpzc,4,0.00023,1045902,59.86921,1746978
1327,coderanger,4,0.00023,1045906,59.86944,1746978
1328,codito,4,0.00023,1045910,59.86967,1746978
1329,coreybutler,4,0.00023,1045914,59.86990,1746978
1330,crccheck,4,0.00023,1045918,59.87013,1746978
1331,danechitoaie,4,0.00023,1045922,59.87036,1746978
1332,darshanj,4,0.00023,1045926,59.87059,1746978
1333,darthtrevino,4,0.00023,1045930,59.87082,1746978
1334,dmklementiev,4,0.00023,1045934,59.87105,1746978
1335,dolftax,4,0.00023,1045938,59.87127,1746978
1336,dothebart,4,0.00023,1045942,59.87150,1746978
1337,duxinxiao,4,0.00023,1045946,59.87173,1746978
1338,EcutDavid,4,0.00023,1045950,59.87196,1746978
1339,ekimber,4,0.00023,1045954,59.87219,1746978
1340,ekuefler,4,0.00023,1045958,59.87242,1746978
1341,ensonic,4,0.00023,1045962,59.87265,1746978
1342,EricEdens,4,0.00023,1045966,59.87288,1746978
1343,ErikBean,4,0.00023,1045970,59.87311,1746978
1344,eubnara,4,0.00023,1045974,59.87334,1746978
1345,Fizzadar,4,0.00023,1045978,59.87356,1746978
1346,frewsxcv,4,0.00023,1045982,59.87379,1746978
1347,gaplo917,4,0.00023,1045986,59.87402,1746978
1348,gdelhumeau,4,0.00023,1045990,59.87425,1746978
1349,gjcarneiro,4,0.00023,1045994,59.87448,1746978
1350,harobed,4,0.00023,1045998,59.87471,1746978
1351,harshavardhana,4,0.00023,1046002,59.87494,1746978
1352,Hronom,4,0.00023,1046006,59.87517,1746978
1353,iawia002,4,0.00023,1046010,59.87540,1746978
1354,inlined,4,0.00023,1046014,59.87563,1746978
1355,iredelmeier,4,0.00023,1046018,59.87585,1746978
1356,itajaja,4,0.00023,1046022,59.87608,1746978
1357,itamarst,4,0.00023,1046026,59.87631,1746978
1358,JackDanger,4,0.00023,1046030,59.87654,1746978
1359,japf,4,0.00023,1046034,59.87677,1746978
1360,jeffmahoney,4,0.00023,1046038,59.87700,1746978
1361,jgiles,4,0.00023,1046042,59.87723,1746978
1362,jhgg,4,0.00023,1046046,59.87746,1746978
1363,joaoasrosa,4,0.00023,1046050,59.87769,1746978
1364,joehni,4,0.00023,1046054,59.87791,1746978
1365,johnlinp,4,0.00023,1046058,59.87814,1746978
1366,jt143,4,0.00023,1046062,59.87837,1746978
1367,kevgliss,4,0.00023,1046066,59.87860,1746978
1368,kevin-david,4,0.00023,1046070,59.87883,1746978
1369,keyan,4,0.00023,1046074,59.87906,1746978
1370,kybetter,4,0.00023,1046078,59.87929,1746978
1371,leewinder,4,0.00023,1046082,59.87952,1746978
1372,Lewiscowles1986,4,0.00023,1046086,59.87975,1746978
1373,lifubang,4,0.00023,1046090,59.87998,1746978
1374,magnolia-k,4,0.00023,1046094,59.88020,1746978
1375,marceljuenemann,4,0.00023,1046098,59.88043,1746978
1376,mark-rushakoff,4,0.00023,1046102,59.88066,1746978
1377,mcumings,4,0.00023,1046106,59.88089,1746978
1378,metaskills,4,0.00023,1046110,59.88112,1746978
1379,mgrachev,4,0.00023,1046114,59.88135,1746978
1380,mhdawson,4,0.00023,1046118,59.88158,1746978
1381,mikol,4,0.00023,1046122,59.88181,1746978
1382,mindw,4,0.00023,1046126,59.88204,1746978
1383,mosesn,4,0.00023,1046130,59.88227,1746978
1384,mosesoak,4,0.00023,1046134,59.88249,1746978
1385,mxl,4,0.00023,1046138,59.88272,1746978
1386,nasht00,4,0.00023,1046142,59.88295,1746978
1387,netroby,4,0.00023,1046146,59.88318,1746978
1388,nicholaswyoung,4,0.00023,1046150,59.88341,1746978
1389,noackjr,4,0.00023,1046154,59.88364,1746978
1390,odeke-em,4,0.00023,1046158,59.88387,1746978
1391,okkez,4,0.00023,1046162,59.88410,1746978
1392,olivierlemasle,4,0.00023,1046166,59.88433,1746978
1393,olostan,4,0.00023,1046170,59.88455,1746978
1394,pabigot,4,0.00023,1046174,59.88478,1746978
1395,palmerabollo,4,0.00023,1046178,59.88501,1746978
1396,paulduffin,4,0.00023,1046182,59.88524,1746978
1397,pkubowicz,4,0.00023,1046186,59.88547,1746978
1398,pmarks-net,4,0.00023,1046190,59.88570,1746978
1399,pmouawad,4,0.00023,1046194,59.88593,1746978
1400,rahst12,4,0.00023,1046198,59.88616,1746978
1401,raul-arabaolaza,4,0.00023,1046202,59.88639,1746978
1402,reeceaw,4,0.00023,1046206,59.88662,1746978
1403,ryanwalters,4,0.00023,1046210,59.88684,1746978
1404,s1monw,4,0.00023,1046214,59.88707,1746978
1405,samueltardieu,4,0.00023,1046218,59.88730,1746978
1406,schmidt-sebastian,4,0.00023,1046222,59.88753,1746978
1407,sergeykad,4,0.00023,1046226,59.88776,1746978
1408,shicks,4,0.00023,1046230,59.88799,1746978
1409,shirbr510,4,0.00023,1046234,59.88822,1746978
1410,sigorilla,4,0.00023,1046238,59.88845,1746978
1411,sileht,4,0.00023,1046242,59.88868,1746978
1412,sinkingpoint,4,0.00023,1046246,59.88891,1746978
1413,sinthetix,4,0.00023,1046250,59.88913,1746978
1414,sjoerdtalsma,4,0.00023,1046254,59.88936,1746978
1415,Stavrus,4,0.00023,1046258,59.88959,1746978
1416,steven-sheehy,4,0.00023,1046262,59.88982,1746978
1417,stevewhims,4,0.00023,1046266,59.89005,1746978
1418,stkelley,4,0.00023,1046270,59.89028,1746978
1419,stubbornella,4,0.00023,1046274,59.89051,1746978
1420,sunilmut,4,0.00023,1046278,59.89074,1746978
1421,svozza,4,0.00023,1046282,59.89097,1746978
1422,sylvestre,4,0.00023,1046286,59.89119,1746978
1423,t1,4,0.00023,1046290,59.89142,1746978
1424,tao12345666333,4,0.00023,1046294,59.89165,1746978
1425,tauren,4,0.00023,1046298,59.89188,1746978
1426,tazjin,4,0.00023,1046302,59.89211,1746978
1427,teone,4,0.00023,1046306,59.89234,1746978
1428,thinkerou,4,0.00023,1046310,59.89257,1746978
1429,tkellen,4,0.00023,1046314,59.89280,1746978
1430,travishaagen,4,0.00023,1046318,59.89303,1746978
1431,untoldone,4,0.00023,1046322,59.89326,1746978
1432,vasanthk,4,0.00023,1046326,59.89348,1746978
1433,viirya,4,0.00023,1046330,59.89371,1746978
1434,wfhartford,4,0.00023,1046334,59.89394,1746978
1435,wonseop,4,0.00023,1046338,59.89417,1746978
1436,xaka,4,0.00023,1046342,59.89440,1746978
1437,xiaogaozi,4,0.00023,1046346,59.89463,1746978
1438,xnox,4,0.00023,1046350,59.89486,1746978
1439,yselkowitz,4,0.00023,1046354,59.89509,1746978
1440,zaitcev,4,0.00023,1046358,59.89532,1746978
1441,zhjwpku,4,0.00023,1046362,59.89555,1746978
1442,zshamrock,4,0.00023,1046366,59.89577,1746978
1443,ac360,3,0.00017,1046369,59.89595,1746978
1444,acao,3,0.00017,1046372,59.89612,1746978
1445,acdha,3,0.00017,1046375,59.89629,1746978
1446,adamhenson,3,0.00017,1046378,59.89646,1746978
1447,adioss,3,0.00017,1046381,59.89663,1746978
1448,aecolley,3,0.00017,1046384,59.89680,1746978
1449,aldaris,3,0.00017,1046387,59.89698,1746978
1450,alecharp,3,0.00017,1046390,59.89715,1746978
1451,andrewhowdencom,3,0.00017,1046393,59.89732,1746978
1452,andrewmchen,3,0.00017,1046396,59.89749,1746978
1453,andyli,3,0.00017,1046399,59.89766,1746978
1454,anish,3,0.00017,1046402,59.89784,1746978
1455,anthonyfok,3,0.00017,1046405,59.89801,1746978
1456,anuraaga,3,0.00017,1046408,59.89818,1746978
1457,ardbiesheuvel,3,0.00017,1046411,59.89835,1746978
1458,ash2k,3,0.00017,1046414,59.89852,1746978
1459,asottile,3,0.00017,1046417,59.89869,1746978
1460,avinassh,3,0.00017,1046420,59.89887,1746978
1461,bachp,3,0.00017,1046423,59.89904,1746978
1462,bassrock,3,0.00017,1046426,59.89921,1746978
1463,bdelacretaz,3,0.00017,1046429,59.89938,1746978
1464,benjaminapetersen,3,0.00017,1046432,59.89955,1746978
1465,benmoss,3,0.00017,1046435,59.89972,1746978
1466,billpratt,3,0.00017,1046438,59.89990,1746978
1467,brendandburns,3,0.00017,1046441,59.90007,1746978
1468,butchyyyy,3,0.00017,1046444,59.90024,1746978
1469,captainbrosset,3,0.00017,1046447,59.90041,1746978
1470,CatTail,3,0.00017,1046450,59.90058,1746978
1471,cben,3,0.00017,1046453,59.90075,1746978
1472,cesartl,3,0.00017,1046456,59.90093,1746978
1473,charleskorn,3,0.00017,1046459,59.90110,1746978
1474,chenziliang,3,0.00017,1046462,59.90127,1746978
1475,choleraehyq,3,0.00017,1046465,59.90144,1746978
1476,chr-g,3,0.00017,1046468,59.90161,1746978
1477,chrisdunelm,3,0.00017,1046471,59.90178,1746978
1478,chrishoffman,3,0.00017,1046474,59.90196,1746978
1479,cjshawMIT,3,0.00017,1046477,59.90213,1746978
1480,clemens-tolboom,3,0.00017,1046480,59.90230,1746978
1481,cneijenhuis,3,0.00017,1046483,59.90247,1746978
1482,danielkhan,3,0.00017,1046486,59.90264,1746978
1483,danielmbarlow,3,0.00017,1046489,59.90282,1746978
1484,dapengzhang0,3,0.00017,1046492,59.90299,1746978
1485,davedoesdev,3,0.00017,1046495,59.90316,1746978
1486,daviburg,3,0.00017,1046498,59.90333,1746978
1487,davidbarratt,3,0.00017,1046501,59.90350,1746978
1488,dcuenot,3,0.00017,1046504,59.90367,1746978
1489,DenisKolodin,3,0.00017,1046507,59.90385,1746978
1490,dgarzon,3,0.00017,1046510,59.90402,1746978
1491,dgonzalez,3,0.00017,1046513,59.90419,1746978
1492,Diagoras,3,0.00017,1046516,59.90436,1746978
1493,diversario,3,0.00017,1046519,59.90453,1746978
1494,divyenduz,3,0.00017,1046522,59.90470,1746978
1495,dodie,3,0.00017,1046525,59.90488,1746978
1496,doshprompt,3,0.00017,1046528,59.90505,1746978
1497,dschaller,3,0.00017,1046531,59.90522,1746978
1498,dsexton,3,0.00017,1046534,59.90539,1746978
1499,dvorak42,3,0.00017,1046537,59.90556,1746978
1500,dzannotti,3,0.00017,1046540,59.90573,1746978
1501,eaftan,3,0.00017,1046543,59.90591,1746978
1502,ebraminio,3,0.00017,1046546,59.90608,1746978
1503,elimisteve,3,0.00017,1046549,59.90625,1746978
1504,emaste,3,0.00017,1046552,59.90642,1746978
1505,enexusde,3,0.00017,1046555,59.90659,1746978
1506,Envek,3,0.00017,1046558,59.90676,1746978
1507,ericwb,3,0.00017,1046561,59.90694,1746978
1508,foxylion,3,0.00017,1046564,59.90711,1746978
1509,GabrielNicolasAvellaneda,3,0.00017,1046567,59.90728,1746978
1510,gilbode,3,0.00017,1046570,59.90745,1746978
1511,greenpau,3,0.00017,1046573,59.90762,1746978
1512,guyfedwards,3,0.00017,1046576,59.90780,1746978
1513,gyuho,3,0.00017,1046579,59.90797,1746978
1514,hashar,3,0.00017,1046582,59.90814,1746978
1515,hboutemy,3,0.00017,1046585,59.90831,1746978
1516,hiyosi,3,0.00017,1046588,59.90848,1746978
1517,htuch,3,0.00017,1046591,59.90865,1746978
1518,hyandell,3,0.00017,1046594,59.90883,1746978
1519,hynek,3,0.00017,1046597,59.90900,1746978
1520,iamstolis,3,0.00017,1046600,59.90917,1746978
1521,IlyaSemenov,3,0.00017,1046603,59.90934,1746978
1522,infrastation,3,0.00017,1046606,59.90951,1746978
1523,ingvagabund,3,0.00017,1046609,59.90968,1746978
1524,invalid-email-address,3,0.00017,1046612,59.90986,1746978
1525,isyun,3,0.00017,1046615,59.91003,1746978
1526,ivansenic,3,0.00017,1046618,59.91020,1746978
1527,IvanVergiliev,3,0.00017,1046621,59.91037,1746978
1528,JacquesPerrault,3,0.00017,1046624,59.91054,1746978
1529,JaysonRaymond,3,0.00017,1046627,59.91071,1746978
1530,jcwilson,3,0.00017,1046630,59.91089,1746978
1531,jeffposnick,3,0.00017,1046633,59.91106,1746978
1532,jengelh,3,0.00017,1046636,59.91123,1746978
1533,jerryzz0,3,0.00017,1046639,59.91140,1746978
1534,jezdez,3,0.00017,1046642,59.91157,1746978
1535,jiangzeng01,3,0.00017,1046645,59.91174,1746978
1536,johnou,3,0.00017,1046648,59.91192,1746978
1537,johnrees,3,0.00017,1046651,59.91209,1746978
1538,JonasVautherin,3,0.00017,1046654,59.91226,1746978
1539,jonyonson,3,0.00017,1046657,59.91243,1746978
1540,josegonzalez,3,0.00017,1046660,59.91260,1746978
1541,jrbenito,3,0.00017,1046663,59.91278,1746978
1542,jstoja,3,0.00017,1046666,59.91295,1746978
1543,jsuchenia,3,0.00017,1046669,59.91312,1746978
1544,jtblin,3,0.00017,1046672,59.91329,1746978
1545,jterry75,3,0.00017,1046675,59.91346,1746978
1546,jtkukunas,3,0.00017,1046678,59.91363,1746978
1547,julianvmodesto,3,0.00017,1046681,59.91381,1746978
1548,jurobystricky,3,0.00017,1046684,59.91398,1746978
1549,kabir,3,0.00017,1046687,59.91415,1746978
1550,Kaijun,3,0.00017,1046690,59.91432,1746978
1551,kandros,3,0.00017,1046693,59.91449,1746978
1552,kevinawoo,3,0.00017,1046696,59.91466,1746978
1553,kevinoliver,3,0.00017,1046699,59.91484,1746978
1554,kisvegabor,3,0.00017,1046702,59.91501,1746978
1555,klopfdreh,3,0.00017,1046705,59.91518,1746978
1556,ktdreyer,3,0.00017,1046708,59.91535,1746978
1557,ktsaou,3,0.00017,1046711,59.91552,1746978
1558,kvz,3,0.00017,1046714,59.91569,1746978
1559,kyakan,3,0.00017,1046717,59.91587,1746978
1560,kyschouv,3,0.00017,1046720,59.91604,1746978
1561,lakruzz,3,0.00017,1046723,59.91621,1746978
1562,Le0Michine,3,0.00017,1046726,59.91638,1746978
1563,LeoColomb,3,0.00017,1046729,59.91655,1746978
1564,leth,3,0.00017,1046732,59.91672,1746978
1565,lfaraone,3,0.00017,1046735,59.91690,1746978
1566,lgfa29,3,0.00017,1046738,59.91707,1746978
1567,Limess,3,0.00017,1046741,59.91724,1746978
1568,lloydde,3,0.00017,1046744,59.91741,1746978
1569,lorrin,3,0.00017,1046747,59.91758,1746978
1570,magnayn,3,0.00017,1046750,59.91776,1746978
1571,maitesin,3,0.00017,1046753,59.91793,1746978
1572,marc-guenther,3,0.00017,1046756,59.91810,1746978
1573,markusicu,3,0.00017,1046759,59.91827,1746978
1574,mastertinner,3,0.00017,1046762,59.91844,1746978
1575,mattnworb,3,0.00017,1046765,59.91861,1746978
1576,maxibanki,3,0.00017,1046768,59.91879,1746978
1577,messense,3,0.00017,1046771,59.91896,1746978
1578,mfriedenhagen,3,0.00017,1046774,59.91913,1746978
1579,mgadda,3,0.00017,1046777,59.91930,1746978
1580,mgeisler,3,0.00017,1046780,59.91947,1746978
1581,mhils,3,0.00017,1046783,59.91964,1746978
1582,michajlo,3,0.00017,1046786,59.91982,1746978
1583,Mizux,3,0.00017,1046789,59.91999,1746978
1584,morficus,3,0.00017,1046792,59.92016,1746978
1585,mpg,3,0.00017,1046795,59.92033,1746978
1586,msabramo,3,0.00017,1046798,59.92050,1746978
1587,mverver-google,3,0.00017,1046801,59.92067,1746978
1588,mynameistechno,3,0.00017,1046804,59.92085,1746978
1589,nathan-osman,3,0.00017,1046807,59.92102,1746978
1590,nfelt,3,0.00017,1046810,59.92119,1746978
1591,nickleefly,3,0.00017,1046813,59.92136,1746978
1592,nlowe,3,0.00017,1046816,59.92153,1746978
1593,oscerd,3,0.00017,1046819,59.92170,1746978
1594,paralin,3,0.00017,1046822,59.92188,1746978
1595,paulcreates,3,0.00017,1046825,59.92205,1746978
1596,pavelchuchma,3,0.00017,1046828,59.92222,1746978
1597,p-bakker,3,0.00017,1046831,59.92239,1746978
1598,perryao,3,0.00017,1046834,59.92256,1746978
1599,pevik,3,0.00017,1046837,59.92274,1746978
1600,Philmod,3,0.00017,1046840,59.92291,1746978
1601,phvu,3,0.00017,1046843,59.92308,1746978
1602,PierreFritsch,3,0.00017,1046846,59.92325,1746978
1603,PiotrSikora,3,0.00017,1046849,59.92342,1746978
1604,pmeerw,3,0.00017,1046852,59.92359,1746978
1605,ptbrowne,3,0.00017,1046855,59.92377,1746978
1606,RajivPrab-Google,3,0.00017,1046858,59.92394,1746978
1607,RashmicaG,3,0.00017,1046861,59.92411,1746978
1608,redixin,3,0.00017,1046864,59.92428,1746978
1609,rerickson1,3,0.00017,1046867,59.92445,1746978
1610,RobRoseKnows,3,0.00017,1046870,59.92462,1746978
1611,RochesterinNYC,3,0.00017,1046873,59.92480,1746978
1612,roidelapluie,3,0.00017,1046876,59.92497,1746978
1613,rossigee,3,0.00017,1046879,59.92514,1746978
1614,rwillmer,3,0.00017,1046882,59.92531,1746978
1615,sargun,3,0.00017,1046885,59.92548,1746978
1616,scjody,3,0.00017,1046888,59.92565,1746978
1617,seanf,3,0.00017,1046891,59.92583,1746978
1618,sebastianroesch,3,0.00017,1046894,59.92600,1746978
1619,semion1956,3,0.00017,1046897,59.92617,1746978
1620,Sky161,3,0.00017,1046900,59.92634,1746978
1621,sofuture,3,0.00017,1046903,59.92651,1746978
1622,songsong182,3,0.00017,1046906,59.92668,1746978
1623,stephenjust,3,0.00017,1046909,59.92686,1746978
1624,stevekuznetsov,3,0.00017,1046912,59.92703,1746978
1625,stonexer,3,0.00017,1046915,59.92720,1746978
1626,Stono,3,0.00017,1046918,59.92737,1746978
1627,StuartHarris,3,0.00017,1046921,59.92754,1746978
1628,stuart-mclaren,3,0.00017,1046924,59.92772,1746978
1629,superlaziness,3,0.00017,1046927,59.92789,1746978
1630,tadas-subonis,3,0.00017,1046930,59.92806,1746978
1631,tedsuo,3,0.00017,1046933,59.92823,1746978
1632,teresy,3,0.00017,1046936,59.92840,1746978
1633,thardeck,3,0.00017,1046939,59.92857,1746978
1634,thebeebs,3,0.00017,1046942,59.92875,1746978
1635,timofeyb,3,0.00017,1046945,59.92892,1746978
1636,TobiX,3,0.00017,1046948,59.92909,1746978
1637,tuananh,3,0.00017,1046951,59.92926,1746978
1638,vapier,3,0.00017,1046954,59.92943,1746978
1639,vickychijwani,3,0.00017,1046957,59.92960,1746978
1640,vitorarins,3,0.00017,1046960,59.92978,1746978
1641,vvidic,3,0.00017,1046963,59.92995,1746978
1642,wheleph,3,0.00017,1046966,59.93012,1746978
1643,wongmjane,3,0.00017,1046969,59.93029,1746978
1644,wryun,3,0.00017,1046972,59.93046,1746978
1645,wsargent,3,0.00017,1046975,59.93063,1746978
1646,xeor,3,0.00017,1046978,59.93081,1746978
1647,XVincentX,3,0.00017,1046981,59.93098,1746978
1648,yacaovsnc,3,0.00017,1046984,59.93115,1746978
1649,yaxia,3,0.00017,1046987,59.93132,1746978
1650,yhwang,3,0.00017,1046990,59.93149,1746978
1651,yibuyisheng,3,0.00017,1046993,59.93166,1746978
1652,yiuyuho,3,0.00017,1046996,59.93184,1746978
1653,yochem,3,0.00017,1046999,59.93201,1746978
1654,zaverucha,3,0.00017,1047002,59.93218,1746978
1655,zdw,3,0.00017,1047005,59.93235,1746978
1656,aashish-ak,2,0.00011,1047007,59.93247,1746978
1657,abitrolly,2,0.00011,1047009,59.93258,1746978
1658,achew22,2,0.00011,1047011,59.93270,1746978
1659,Ajido,2,0.00011,1047013,59.93281,1746978
1660,ajschlosser,2,0.00011,1047015,59.93292,1746978
1661,akauppi,2,0.00011,1047017,59.93304,1746978
1662,aknuds1,2,0.00011,1047019,59.93315,1746978
1663,Alexendoo,2,0.00011,1047021,59.93327,1746978
1664,aliok,2,0.00011,1047023,59.93338,1746978
1665,Aloren,2,0.00011,1047025,59.93350,1746978
1666,amacneil,2,0.00011,1047027,59.93361,1746978
1667,anandkumarpatel,2,0.00011,1047029,59.93373,1746978
1668,andersk,2,0.00011,1047031,59.93384,1746978
1669,andi-bigswitch,2,0.00011,1047033,59.93395,1746978
1670,andrerom,2,0.00011,1047035,59.93407,1746978
1671,AnneTheAgile,2,0.00011,1047037,59.93418,1746978
1672,antonio-cortes-perez,2,0.00011,1047039,59.93430,1746978
1673,bbrowning,2,0.00011,1047041,59.93441,1746978
1674,benjamminj,2,0.00011,1047043,59.93453,1746978
1675,billytrend,2,0.00011,1047045,59.93464,1746978
1676,bluesliverx,2,0.00011,1047047,59.93476,1746978
1677,bmwiedemann,2,0.00011,1047049,59.93487,1746978
1678,brantburnett,2,0.00011,1047051,59.93498,1746978
1679,brantlk,2,0.00011,1047053,59.93510,1746978
1680,bryanlarsen,2,0.00011,1047055,59.93521,1746978
1681,caarlos0,2,0.00011,1047057,59.93533,1746978
1682,caike,2,0.00011,1047059,59.93544,1746978
1683,campionfellin,2,0.00011,1047061,59.93556,1746978
1684,Capstan,2,0.00011,1047063,59.93567,1746978
1685,carlsverre,2,0.00011,1047065,59.93579,1746978
1686,ccamacho,2,0.00011,1047067,59.93590,1746978
1687,Cellule,2,0.00011,1047069,59.93602,1746978
1688,chaintng,2,0.00011,1047071,59.93613,1746978
1689,charly37,2,0.00011,1047073,59.93624,1746978
1690,chibicode,2,0.00011,1047075,59.93636,1746978
1691,chriskuehl,2,0.00011,1047077,59.93647,1746978
1692,cijothomas,2,0.00011,1047079,59.93659,1746978
1693,cirocosta,2,0.00011,1047081,59.93670,1746978
1694,ckross01,2,0.00011,1047083,59.93682,1746978
1695,clemensv,2,0.00011,1047085,59.93693,1746978
1696,cmoulliard,2,0.00011,1047087,59.93705,1746978
1697,colachg,2,0.00011,1047089,59.93716,1746978
1698,crazytan,2,0.00011,1047091,59.93727,1746978
1699,csantanapr,2,0.00011,1047093,59.93739,1746978
1700,cstyan,2,0.00011,1047095,59.93750,1746978
1701,ctubbsii,2,0.00011,1047097,59.93762,1746978
1702,culmat,2,0.00011,1047099,59.93773,1746978
1703,damienbiggs,2,0.00011,1047101,59.93785,1746978
1704,darrinholst,2,0.00011,1047103,59.93796,1746978
1705,deedubs,2,0.00011,1047105,59.93808,1746978
1706,deepaksood619,2,0.00011,1047107,59.93819,1746978
1707,deinspanjer,2,0.00011,1047109,59.93830,1746978
1708,denismakogon,2,0.00011,1047111,59.93842,1746978
1709,DerDakon,2,0.00011,1047113,59.93853,1746978
1710,digioak,2,0.00011,1047115,59.93865,1746978
1711,dimitropoulos,2,0.00011,1047117,59.93876,1746978
1712,DirtYiCE,2,0.00011,1047119,59.93888,1746978
1713,dmathieu,2,0.00011,1047121,59.93899,1746978
1714,domesticmouse,2,0.00011,1047123,59.93911,1746978
1715,dtaniwaki,2,0.00011,1047125,59.93922,1746978
1716,dunglas,2,0.00011,1047127,59.93934,1746978
1717,eatnumber1,2,0.00011,1047129,59.93945,1746978
1718,egeland,2,0.00011,1047131,59.93956,1746978
1719,ejc3,2,0.00011,1047133,59.93968,1746978
1720,ElfoLiNk,2,0.00011,1047135,59.93979,1746978
1721,EppO,2,0.00011,1047137,59.93991,1746978
1722,erik777,2,0.00011,1047139,59.94002,1746978
1723,estahn,2,0.00011,1047141,59.94014,1746978
1724,everett980,2,0.00011,1047143,59.94025,1746978
1725,Felixzz,2,0.00011,1047145,59.94037,1746978
1726,ferhatelmas,2,0.00011,1047147,59.94048,1746978
1727,figaw,2,0.00011,1047149,59.94059,1746978
1728,flyboarder,2,0.00011,1047151,59.94071,1746978
1729,francescoinfante,2,0.00011,1047153,59.94082,1746978
1730,FrantaM,2,0.00011,1047155,59.94094,1746978
1731,frsyuki,2,0.00011,1047157,59.94105,1746978
1732,gbolo,2,0.00011,1047159,59.94117,1746978
1733,GeorgeSapkin,2,0.00011,1047161,59.94128,1746978
1734,ggreer,2,0.00011,1047163,59.94140,1746978
1735,gigaSproule,2,0.00011,1047165,59.94151,1746978
1736,glyn,2,0.00011,1047167,59.94162,1746978
1737,graememorgan,2,0.00011,1047169,59.94174,1746978
1738,harryge00,2,0.00011,1047171,59.94185,1746978
1739,henryju,2,0.00011,1047173,59.94197,1746978
1740,honkentuber,2,0.00011,1047175,59.94208,1746978
1741,icereval,2,0.00011,1047177,59.94220,1746978
1742,iest,2,0.00011,1047179,59.94231,1746978
1743,ihac,2,0.00011,1047181,59.94243,1746978
1744,ilgrosso,2,0.00011,1047183,59.94254,1746978
1745,iliul,2,0.00011,1047185,59.94266,1746978
1746,ind1go,2,0.00011,1047187,59.94277,1746978
1747,inyee786,2,0.00011,1047189,59.94288,1746978
1748,iphands,2,0.00011,1047191,59.94300,1746978
1749,Ivanwangcy,2,0.00011,1047193,59.94311,1746978
1750,iwinux,2,0.00011,1047195,59.94323,1746978
1751,J7mbo,2,0.00011,1047197,59.94334,1746978
1752,jackielii,2,0.00011,1047199,59.94346,1746978
1753,jakebolam,2,0.00011,1047201,59.94357,1746978
1754,jamiehodge,2,0.00011,1047203,59.94369,1746978
1755,Janario,2,0.00011,1047205,59.94380,1746978
1756,JasonLinMS,2,0.00011,1047207,59.94391,1746978
1757,Jens-G,2,0.00011,1047209,59.94403,1746978
1758,jimrollenhagen,2,0.00011,1047211,59.94414,1746978
1759,jkandasa,2,0.00011,1047213,59.94426,1746978
1760,jlinton,2,0.00011,1047215,59.94437,1746978
1761,johanneswuerbach,2,0.00011,1047217,59.94449,1746978
1762,joshgav,2,0.00011,1047219,59.94460,1746978
1763,jparise,2,0.00011,1047221,59.94472,1746978
1764,jpbetz,2,0.00011,1047223,59.94483,1746978
1765,jpoon,2,0.00011,1047225,59.94494,1746978
1766,jpreese,2,0.00011,1047227,59.94506,1746978
1767,jrsquared,2,0.00011,1047229,59.94517,1746978
1768,juergw,2,0.00011,1047231,59.94529,1746978
1769,jwhitcraft,2,0.00011,1047233,59.94540,1746978
1770,k1988,2,0.00011,1047235,59.94552,1746978
1771,kans,2,0.00011,1047237,59.94563,1746978
1772,karataliu,2,0.00011,1047239,59.94575,1746978
1773,keeganwitt,2,0.00011,1047241,59.94586,1746978
1774,kellycampbell,2,0.00011,1047243,59.94598,1746978
1775,kenperkins,2,0.00011,1047245,59.94609,1746978
1776,kgyrtkirk,2,0.00011,1047247,59.94620,1746978
1777,kikyous,2,0.00011,1047249,59.94632,1746978
1778,kirkthompson,2,0.00011,1047251,59.94643,1746978
1779,kjin,2,0.00011,1047253,59.94655,1746978
1780,klonos,2,0.00011,1047255,59.94666,1746978
1781,kraj,2,0.00011,1047257,59.94678,1746978
1782,kuhlenh,2,0.00011,1047259,59.94689,1746978
1783,kwasimensah,2,0.00011,1047261,59.94701,1746978
1784,larrys,2,0.00011,1047263,59.94712,1746978
1785,laszlocsomor,2,0.00011,1047265,59.94723,1746978
1786,laurawalker,2,0.00011,1047267,59.94735,1746978
1787,lenage,2,0.00011,1047269,59.94746,1746978
1788,leodido,2,0.00011,1047271,59.94758,1746978
1789,lindner,2,0.00011,1047273,59.94769,1746978
1790,lionelvillard,2,0.00011,1047275,59.94781,1746978
1791,listrophy,2,0.00011,1047277,59.94792,1746978
1792,llimllib,2,0.00011,1047279,59.94804,1746978
1793,lmcarreiro,2,0.00011,1047281,59.94815,1746978
1794,longsleep,2,0.00011,1047283,59.94826,1746978
1795,machaval,2,0.00011,1047285,59.94838,1746978
1796,mafrosis,2,0.00011,1047287,59.94849,1746978
1797,marshallbrekka,2,0.00011,1047289,59.94861,1746978
1798,MartinNowak,2,0.00011,1047291,59.94872,1746978
1799,martinpitt,2,0.00011,1047293,59.94884,1746978
1800,martyanov,2,0.00011,1047295,59.94895,1746978
1801,mathstuf,2,0.00011,1047297,59.94907,1746978
1802,maxg,2,0.00011,1047299,59.94918,1746978
1803,mcoolive,2,0.00011,1047301,59.94930,1746978
1804,mdcanham,2,0.00011,1047303,59.94941,1746978
1805,michaeljohnbennett,2,0.00011,1047305,59.94952,1746978
1806,mikesir87,2,0.00011,1047307,59.94964,1746978
1807,mina86,2,0.00011,1047309,59.94975,1746978
1808,mkbehr,2,0.00011,1047311,59.94987,1746978
1809,monners,2,0.00011,1047313,59.94998,1746978
1810,morganfainberg,2,0.00011,1047315,59.95010,1746978
1811,mucahitkurt,2,0.00011,1047317,59.95021,1746978
1812,Nabellaleen,2,0.00011,1047319,59.95033,1746978
1813,NamPNQ,2,0.00011,1047321,59.95044,1746978
1814,NatMack,2,0.00011,1047323,59.95055,1746978
1815,naveensrinivasan,2,0.00011,1047325,59.95067,1746978
1816,nbeckman,2,0.00011,1047327,59.95078,1746978
1817,nealef,2,0.00011,1047329,59.95090,1746978
1818,niik,2,0.00011,1047331,59.95101,1746978
1819,nikai3d,2,0.00011,1047333,59.95113,1746978
1820,Ninir,2,0.00011,1047335,59.95124,1746978
1821,nlopezgi,2,0.00011,1047337,59.95136,1746978
1822,nullstyle,2,0.00011,1047339,59.95147,1746978
1823,nzthiago,2,0.00011,1047341,59.95158,1746978
1824,odedpeer,2,0.00011,1047343,59.95170,1746978
1825,ohadlevy,2,0.00011,1047345,59.95181,1746978
1826,olleolleolle,2,0.00011,1047347,59.95193,1746978
1827,omerzach,2,0.00011,1047349,59.95204,1746978
1828,opinali,2,0.00011,1047351,59.95216,1746978
1829,orlandohohmeier,2,0.00011,1047353,59.95227,1746978
1830,otavio,2,0.00011,1047355,59.95239,1746978
1831,parkr,2,0.00011,1047357,59.95250,1746978
1832,paulgmiller,2,0.00011,1047359,59.95262,1746978
1833,paultiplady,2,0.00011,1047361,59.95273,1746978
1834,pdudits,2,0.00011,1047363,59.95284,1746978
1835,pdxJayhawk,2,0.00011,1047365,59.95296,1746978
1836,pengx17,2,0.00011,1047367,59.95307,1746978
1837,petercgrant,2,0.00011,1047369,59.95319,1746978
1838,pfsmorigo,2,0.00011,1047371,59.95330,1746978
1839,pgadige,2,0.00011,1047373,59.95342,1746978
1840,pierreozoux,2,0.00011,1047375,59.95353,1746978
1841,pingunaut,2,0.00011,1047377,59.95365,1746978
1842,pulse00,2,0.00011,1047379,59.95376,1746978
1843,pushrax,2,0.00011,1047381,59.95387,1746978
1844,qar,2,0.00011,1047383,59.95399,1746978
1845,rdrgmnzs,2,0.00011,1047385,59.95410,1746978
1846,resker,2,0.00011,1047387,59.95422,1746978
1847,retrohacker,2,0.00011,1047389,59.95433,1746978
1848,reubn,2,0.00011,1047391,59.95445,1746978
1849,rhencke,2,0.00011,1047393,59.95456,1746978
1850,ringw,2,0.00011,1047395,59.95468,1746978
1851,rohanpai,2,0.00011,1047397,59.95479,1746978
1852,russgray,2,0.00011,1047399,59.95490,1746978
1853,samridh90,2,0.00011,1047401,59.95502,1746978
1854,samuelkarp,2,0.00011,1047403,59.95513,1746978
1855,samv,2,0.00011,1047405,59.95525,1746978
1856,saschagrunert,2,0.00011,1047407,59.95536,1746978
1857,scboffspring,2,0.00011,1047409,59.95548,1746978
1858,schickling,2,0.00011,1047411,59.95559,1746978
1859,scothis,2,0.00011,1047413,59.95571,1746978
1860,seh,2,0.00011,1047415,59.95582,1746978
1861,sharonvardi,2,0.00011,1047417,59.95594,1746978
1862,shauns,2,0.00011,1047419,59.95605,1746978
1863,shichao-an,2,0.00011,1047421,59.95616,1746978
1864,silasb,2,0.00011,1047423,59.95628,1746978
1865,simonbrandhof,2,0.00011,1047425,59.95639,1746978
1866,sinstein,2,0.00011,1047427,59.95651,1746978
1867,sjug,2,0.00011,1047429,59.95662,1746978
1868,sjungwirth,2,0.00011,1047431,59.95674,1746978
1869,sosiouxme,2,0.00011,1047433,59.95685,1746978
1870,srcLurker,2,0.00011,1047435,59.95697,1746978
1871,stephenjannin,2,0.00011,1047437,59.95708,1746978
1872,StevenACoffman,2,0.00011,1047439,59.95719,1746978
1873,stubailo,2,0.00011,1047441,59.95731,1746978
1874,SurferJeffAtGoogle,2,0.00011,1047443,59.95742,1746978
1875,syndbg,2,0.00011,1047445,59.95754,1746978
1876,tangiel,2,0.00011,1047447,59.95765,1746978
1877,testingbot,2,0.00011,1047449,59.95777,1746978
1878,TFenby,2,0.00011,1047451,59.95788,1746978
1879,tklauser,2,0.00011,1047453,59.95800,1746978
1880,tmm1,2,0.00011,1047455,59.95811,1746978
1881,Todd-Davies,2,0.00011,1047457,59.95823,1746978
1882,tomasbjerre,2,0.00011,1047459,59.95834,1746978
1883,tomgco,2,0.00011,1047461,59.95845,1746978
1884,tomkerkhove,2,0.00011,1047463,59.95857,1746978
1885,tsl0922,2,0.00011,1047465,59.95868,1746978
1886,twKrash,2,0.00011,1047467,59.95880,1746978
1887,tylerlong,2,0.00011,1047469,59.95891,1746978
1888,vania-pooh,2,0.00011,1047471,59.95903,1746978
1889,vbuslov,2,0.00011,1047473,59.95914,1746978
1890,wilk,2,0.00011,1047475,59.95926,1746978
1891,wohali,2,0.00011,1047477,59.95937,1746978
1892,WonyoungChoi,2,0.00011,1047479,59.95948,1746978
1893,wyllys66,2,0.00011,1047481,59.95960,1746978
1894,xfxyjwf,2,0.00011,1047483,59.95971,1746978
1895,yadoer,2,0.00011,1047485,59.95983,1746978
1896,yeputons,2,0.00011,1047487,59.95994,1746978
1897,yhirano55,2,0.00011,1047489,59.96006,1746978
1898,yurrriq,2,0.00011,1047491,59.96017,1746978
1899,yury,2,0.00011,1047493,59.96029,1746978
1900,zhangsu,2,0.00011,1047495,59.96040,1746978
1901,zhiliangxu,2,0.00011,1047497,59.96051,1746978
1902,zhuscat,2,0.00011,1047499,59.96063,1746978
1903,ZZITE,2,0.00011,1047501,59.96074,1746978
1904,0emily0,1,0.00006,1047502,59.96080,1746978
1905,0x0539,1,0.00006,1047503,59.96086,1746978
1906,1st1,1,0.00006,1047504,59.96092,1746978
1907,2color,1,0.00006,1047505,59.96097,1746978
1908,a8m,1,0.00006,1047506,59.96103,1746978
1909,aalexand,1,0.00006,1047507,59.96109,1746978
1910,abergmann,1,0.00006,1047508,59.96114,1746978
1911,abucodonosor,1,0.00006,1047509,59.96120,1746978
1912,acdvorak,1,0.00006,1047510,59.96126,1746978
1913,achermes,1,0.00006,1047511,59.96132,1746978
1914,acomagu,1,0.00006,1047512,59.96137,1746978
1915,AdamMajer,1,0.00006,1047513,59.96143,1746978
1916,adrianmoisey,1,0.00006,1047514,59.96149,1746978
1917,AdrianPal,1,0.00006,1047515,59.96155,1746978
1918,ahmadalli,1,0.00006,1047516,59.96160,1746978
1919,aizatsky-at-google,1,0.00006,1047517,59.96166,1746978
1920,akervern,1,0.00006,1047518,59.96172,1746978
1921,alanrussian,1,0.00006,1047519,59.96177,1746978
1922,alecmerdler,1,0.00006,1047520,59.96183,1746978
1923,alenkacz,1,0.00006,1047521,59.96189,1746978
1924,alexander-bolshakov,1,0.00006,1047522,59.96195,1746978
1925,AlexanderGH,1,0.00006,1047523,59.96200,1746978
1926,alexandrebodin,1,0.00006,1047524,59.96206,1746978
1927,alexcasalboni,1,0.00006,1047525,59.96212,1746978
1928,alexmt,1,0.00006,1047526,59.96217,1746978
1929,alexvicegrab,1,0.00006,1047527,59.96223,1746978
1930,alfirin,1,0.00006,1047528,59.96229,1746978
1931,alokrajiv,1,0.00006,1047529,59.96235,1746978
1932,alonl,1,0.00006,1047530,59.96240,1746978
1933,alpeb,1,0.00006,1047531,59.96246,1746978
1934,alvgarvilla,1,0.00006,1047532,59.96252,1746978
1935,amalloy,1,0.00006,1047533,59.96258,1746978
1936,anacrolix,1,0.00006,1047534,59.96263,1746978
1937,anagrius,1,0.00006,1047535,59.96269,1746978
1938,andrewsomething,1,0.00006,1047536,59.96275,1746978
1939,andreykaipov,1,0.00006,1047537,59.96280,1746978
1940,AngelosP,1,0.00006,1047538,59.96286,1746978
1941,annarozin,1,0.00006,1047539,59.96292,1746978
1942,answer1991,1,0.00006,1047540,59.96298,1746978
1943,apaprocki,1,0.00006,1047541,59.96303,1746978
1944,ApsOps,1,0.00006,1047542,59.96309,1746978
1945,arapov,1,0.00006,1047543,59.96315,1746978
1946,arghya88,1,0.00006,1047544,59.96321,1746978
1947,ArieShout,1,0.00006,1047545,59.96326,1746978
1948,arunkjn,1,0.00006,1047546,59.96332,1746978
1949,arunvelsriram,1,0.00006,1047547,59.96338,1746978
1950,aschepis,1,0.00006,1047548,59.96343,1746978
1951,aspiers,1,0.00006,1047549,59.96349,1746978
1952,atomantic,1,0.00006,1047550,59.96355,1746978
1953,atombender,1,0.00006,1047551,59.96361,1746978
1954,Autophagy,1,0.00006,1047552,59.96366,1746978
1955,avarabyeu,1,0.00006,1047553,59.96372,1746978
1956,avoinea,1,0.00006,1047554,59.96378,1746978
1957,avranju,1,0.00006,1047555,59.96383,1746978
1958,awturner,1,0.00006,1047556,59.96389,1746978
1959,awused,1,0.00006,1047557,59.96395,1746978
1960,batmat,1,0.00006,1047558,59.96401,1746978
1961,bbarenblat,1,0.00006,1047559,59.96406,1746978
1962,bcorso,1,0.00006,1047560,59.96412,1746978
1963,Bege13mot,1,0.00006,1047561,59.96418,1746978
1964,benbalter,1,0.00006,1047562,59.96424,1746978
1965,BenderV,1,0.00006,1047563,59.96429,1746978
1966,benoitf,1,0.00006,1047564,59.96435,1746978
1967,ben-st,1,0.00006,1047565,59.96441,1746978
1968,bentmann,1,0.00006,1047566,59.96446,1746978
1969,bezda,1,0.00006,1047567,59.96452,1746978
1970,bhcopeland,1,0.00006,1047568,59.96458,1746978
1971,bnjbvr,1,0.00006,1047569,59.96464,1746978
1972,bobintornado,1,0.00006,1047570,59.96469,1746978
1973,bobmshannon,1,0.00006,1047571,59.96475,1746978
1974,boeboe,1,0.00006,1047572,59.96481,1746978
1975,bonifaido,1,0.00006,1047573,59.96487,1746978
1976,bradydowling,1,0.00006,1047574,59.96492,1746978
1977,brandonh-msft,1,0.00006,1047575,59.96498,1746978
1978,breeswish,1,0.00006,1047576,59.96504,1746978
1979,brettjacobson,1,0.00006,1047577,59.96509,1746978
1980,bthelen,1,0.00006,1047578,59.96515,1746978
1981,budhrg,1,0.00006,1047579,59.96521,1746978
1982,bulach,1,0.00006,1047580,59.96527,1746978
1983,burkeholland,1,0.00006,1047581,59.96532,1746978
1984,BusyJay,1,0.00006,1047582,59.96538,1746978
1985,camrdale,1,0.00006,1047583,59.96544,1746978
1986,captain5050,1,0.00006,1047584,59.96549,1746978
1987,carl-mastrangelo,1,0.00006,1047585,59.96555,1746978
1988,cburmeister,1,0.00006,1047586,59.96561,1746978
1989,cdown,1,0.00006,1047587,59.96567,1746978
1990,cedriclam,1,0.00006,1047588,59.96572,1746978
1991,cehoffman,1,0.00006,1047589,59.96578,1746978
1992,cengiz-demir,1,0.00006,1047590,59.96584,1746978
1993,centic9,1,0.00006,1047591,59.96590,1746978
1994,cfieber,1,0.00006,1047592,59.96595,1746978
1995,cfs-pure,1,0.00006,1047593,59.96601,1746978
1996,chancez,1,0.00006,1047594,59.96607,1746978
1997,chandresh-pancholi,1,0.00006,1047595,59.96612,1746978
1998,chardch,1,0.00006,1047596,59.96618,1746978
1999,chenrui333,1,0.00006,1047597,59.96624,1746978
2000,chirino,1,0.00006,1047598,59.96630,1746978
2001,chmouel,1,0.00006,1047599,59.96635,1746978
2002,chrisoverzero,1,0.00006,1047600,59.96641,1746978
2003,chris-rock,1,0.00006,1047601,59.96647,1746978
2004,chrisseto,1,0.00006,1047602,59.96653,1746978
2005,chris-short,1,0.00006,1047603,59.96658,1746978
2006,chuckbutler,1,0.00006,1047604,59.96664,1746978
2007,chwarr,1,0.00006,1047605,59.96670,1746978
2008,clawr,1,0.00006,1047606,59.96675,1746978
2009,cleac,1,0.00006,1047607,59.96681,1746978
2010,clguimanMSFT,1,0.00006,1047608,59.96687,1746978
2011,clucey,1,0.00006,1047609,59.96693,1746978
2012,codewiz,1,0.00006,1047610,59.96698,1746978
2013,collinpeters,1,0.00006,1047611,59.96704,1746978
2014,Colstuwjx,1,0.00006,1047612,59.96710,1746978
2015,cpointner,1,0.00006,1047613,59.96715,1746978
2016,craigsmitham,1,0.00006,1047614,59.96721,1746978
2017,curi0usJack,1,0.00006,1047615,59.96727,1746978
2018,cybergrind,1,0.00006,1047616,59.96733,1746978
2019,dalanmiller,1,0.00006,1047617,59.96738,1746978
2020,daniel-beck,1,0.00006,1047618,59.96744,1746978
2021,daniel-kun,1,0.00006,1047619,59.96750,1746978
2022,dankohn,1,0.00006,1047620,59.96756,1746978
2023,dankurka,1,0.00006,1047621,59.96761,1746978
2024,dannyvernovsky,1,0.00006,1047622,59.96767,1746978
2025,darioblanco,1,0.00006,1047623,59.96773,1746978
2026,davejamesmiller,1,0.00006,1047624,59.96778,1746978
2027,davidcelis,1,0.00006,1047625,59.96784,1746978
2028,davidmichaelkarr,1,0.00006,1047626,59.96790,1746978
2029,DazWilkin,1,0.00006,1047627,59.96796,1746978
2030,dbarlett,1,0.00006,1047628,59.96801,1746978
2031,dblock,1,0.00006,1047629,59.96807,1746978
2032,dborowitz,1,0.00006,1047630,59.96813,1746978
2033,dbussink,1,0.00006,1047631,59.96819,1746978
2034,dcbw,1,0.00006,1047632,59.96824,1746978
2035,dconnelly,1,0.00006,1047633,59.96830,1746978
2036,dcoraboeuf,1,0.00006,1047634,59.96836,1746978
2037,deiwin,1,0.00006,1047635,59.96841,1746978
2038,dennis-benzinger-hybris,1,0.00006,1047636,59.96847,1746978
2039,Derbeth,1,0.00006,1047637,59.96853,1746978
2040,derekperkins,1,0.00006,1047638,59.96859,1746978
2041,derpierre65,1,0.00006,1047639,59.96864,1746978
2042,d-e-s-o,1,0.00006,1047640,59.96870,1746978
2043,dfarrow0,1,0.00006,1047641,59.96876,1746978
2044,dfredell,1,0.00006,1047642,59.96881,1746978
2045,dgem,1,0.00006,1047643,59.96887,1746978
2046,dillonburns,1,0.00006,1047644,59.96893,1746978
2047,dims,1,0.00006,1047645,59.96899,1746978
2048,dingwilson,1,0.00006,1047646,59.96904,1746978
2049,diogogmt,1,0.00006,1047647,59.96910,1746978
2050,dipak-pawar,1,0.00006,1047648,59.96916,1746978
2051,dishantgniit,1,0.00006,1047649,59.96922,1746978
2052,displague,1,0.00006,1047650,59.96927,1746978
2053,diwu1989,1,0.00006,1047651,59.96933,1746978
2054,dkagedal,1,0.00006,1047652,59.96939,1746978
2055,dlebed,1,0.00006,1047653,59.96944,1746978
2056,d-los,1,0.00006,1047654,59.96950,1746978
2057,dmsimard,1,0.00006,1047655,59.96956,1746978
2058,dorav,1,0.00006,1047656,59.96962,1746978
2059,dosire,1,0.00006,1047657,59.96967,1746978
2060,dpurrington,1,0.00006,1047658,59.96973,1746978
2061,drdamour,1,0.00006,1047659,59.96979,1746978
2062,drusellers,1,0.00006,1047660,59.96985,1746978
2063,dsyer,1,0.00006,1047661,59.96990,1746978
2064,dy-dx,1,0.00006,1047662,59.96996,1746978
2065,dzimine,1,0.00006,1047663,59.97002,1746978
2066,earlbread,1,0.00006,1047664,59.97007,1746978
2067,ejamesc,1,0.00006,1047665,59.97013,1746978
2068,ejoerns,1,0.00006,1047666,59.97019,1746978
2069,ejona86,1,0.00006,1047667,59.97025,1746978
2070,ekarlso,1,0.00006,1047668,59.97030,1746978
2071,ekoome,1,0.00006,1047669,59.97036,1746978
2072,emaildanwilson,1,0.00006,1047670,59.97042,1746978
2073,erain,1,0.00006,1047671,59.97047,1746978
2074,E-T-,1,0.00006,1047672,59.97053,1746978
2075,etsauer,1,0.00006,1047673,59.97059,1746978
2076,everett-toews,1,0.00006,1047674,59.97065,1746978
2077,fasaxc,1,0.00006,1047675,59.97070,1746978
2078,ferantivero,1,0.00006,1047676,59.97076,1746978
2079,flakerimi,1,0.00006,1047677,59.97082,1746978
2080,four43,1,0.00006,1047678,59.97088,1746978
2081,Francisco-Gamino,1,0.00006,1047679,59.97093,1746978
2082,frankgreco,1,0.00006,1047680,59.97099,1746978
2083,fungi,1,0.00006,1047681,59.97105,1746978
2084,gabel,1,0.00006,1047682,59.97110,1746978
2085,gabikliot,1,0.00006,1047683,59.97116,1746978
2086,gabrfarina,1,0.00006,1047684,59.97122,1746978
2087,gam-phon,1,0.00006,1047685,59.97128,1746978
2088,garyiwu,1,0.00006,1047686,59.97133,1746978
2089,gaziqbal,1,0.00006,1047687,59.97139,1746978
2090,gbraad,1,0.00006,1047688,59.97145,1746978
2091,gdeangel,1,0.00006,1047689,59.97151,1746978
2092,gdubya,1,0.00006,1047690,59.97156,1746978
2093,georgecrawford,1,0.00006,1047691,59.97162,1746978
2094,ggarnier,1,0.00006,1047692,59.97168,1746978
2095,glaubitz,1,0.00006,1047693,59.97173,1746978
2096,glouischandra,1,0.00006,1047694,59.97179,1746978
2097,goldshtn,1,0.00006,1047695,59.97185,1746978
2098,golonzovsky,1,0.00006,1047696,59.97191,1746978
2099,gonzojive,1,0.00006,1047697,59.97196,1746978
2100,grosser,1,0.00006,1047698,59.97202,1746978
2101,guoshimin,1,0.00006,1047699,59.97208,1746978
2102,guyben13,1,0.00006,1047700,59.97213,1746978
2103,haberman,1,0.00006,1047701,59.97219,1746978
2104,hach-que,1,0.00006,1047702,59.97225,1746978
2105,HackToday,1,0.00006,1047703,59.97231,1746978
2106,hakan42,1,0.00006,1047704,59.97236,1746978
2107,harai,1,0.00006,1047705,59.97242,1746978
2108,hjacobs,1,0.00006,1047706,59.97248,1746978
2109,hoffin,1,0.00006,1047707,59.97254,1746978
2110,huikang,1,0.00006,1047708,59.97259,1746978
2111,ianlancetaylor,1,0.00006,1047709,59.97265,1746978
2112,ifigotin,1,0.00006,1047710,59.97271,1746978
2113,iflan,1,0.00006,1047711,59.97276,1746978
2114,igalic,1,0.00006,1047712,59.97282,1746978
2115,ikatson,1,0.00006,1047713,59.97288,1746978
2116,immannino,1,0.00006,1047714,59.97294,1746978
2117,irissmann,1,0.00006,1047715,59.97299,1746978
2118,itsavvy-ankur,1,0.00006,1047716,59.97305,1746978
2119,JackFish,1,0.00006,1047717,59.97311,1746978
2120,jacmet,1,0.00006,1047718,59.97317,1746978
2121,jakon89,1,0.00006,1047719,59.97322,1746978
2122,jameslyon,1,0.00006,1047720,59.97328,1746978
2123,jamland,1,0.00006,1047721,59.97334,1746978
2124,jart,1,0.00006,1047722,59.97339,1746978
2125,javeme,1,0.00006,1047723,59.97345,1746978
2126,jbaruch,1,0.00006,1047724,59.97351,1746978
2127,jcoeltjen,1,0.00006,1047725,59.97357,1746978
2128,jd,1,0.00006,1047726,59.97362,1746978
2129,JeffRMoore,1,0.00006,1047727,59.97368,1746978
2130,jeroenvisser101,1,0.00006,1047728,59.97374,1746978
2131,jgkamat,1,0.00006,1047729,59.97379,1746978
2132,jhorwit2,1,0.00006,1047730,59.97385,1746978
2133,jianglai,1,0.00006,1047731,59.97391,1746978
2134,jiangzhuo,1,0.00006,1047732,59.97397,1746978
2135,jmagnusson,1,0.00006,1047733,59.97402,1746978
2136,jmervine,1,0.00006,1047734,59.97408,1746978
2137,jmini,1,0.00006,1047735,59.97414,1746978
2138,joanrieu,1,0.00006,1047736,59.97420,1746978
2139,joelschopp,1,0.00006,1047737,59.97425,1746978
2140,johnaoss,1,0.00006,1047738,59.97431,1746978
2141,johnzheng1975,1,0.00006,1047739,59.97437,1746978
2142,JonathanSun,1,0.00006,1047740,59.97442,1746978
2143,joschi,1,0.00006,1047741,59.97448,1746978
2144,jpeterson88,1,0.00006,1047742,59.97454,1746978
2145,JRBANCEL,1,0.00006,1047743,59.97460,1746978
2146,jrn,1,0.00006,1047744,59.97465,1746978
2147,jryu,1,0.00006,1047745,59.97471,1746978
2148,j-stewart,1,0.00006,1047746,59.97477,1746978
2149,jsyrjala,1,0.00006,1047747,59.97483,1746978
2150,julian-klode,1,0.00006,1047748,59.97488,1746978
2151,justcla,1,0.00006,1047749,59.97494,1746978
2152,jyane,1,0.00006,1047750,59.97500,1746978
2153,kamaln7,1,0.00006,1047751,59.97505,1746978
2154,karlkfi,1,0.00006,1047752,59.97511,1746978
2155,kenegozi,1,0.00006,1047753,59.97517,1746978
2156,kghost,1,0.00006,1047754,59.97523,1746978
2157,kilink,1,0.00006,1047755,59.97528,1746978
2158,komamitsu,1,0.00006,1047756,59.97534,1746978
2159,konryd,1,0.00006,1047757,59.97540,1746978
2160,kool79,1,0.00006,1047758,59.97545,1746978
2161,KostyaSha,1,0.00006,1047759,59.97551,1746978
2162,krasnoukhov,1,0.00006,1047760,59.97557,1746978
2163,kriskowal,1,0.00006,1047761,59.97563,1746978
2164,kuroky360,1,0.00006,1047762,59.97568,1746978
2165,kvochko,1,0.00006,1047763,59.97574,1746978
2166,laurentlb,1,0.00006,1047764,59.97580,1746978
2167,leighmcculloch,1,0.00006,1047765,59.97586,1746978
2168,leitao,1,0.00006,1047766,59.97591,1746978
2169,leseb,1,0.00006,1047767,59.97597,1746978
2170,lexholden,1,0.00006,1047768,59.97603,1746978
2171,limscoder,1,0.00006,1047769,59.97608,1746978
2172,lizrice,1,0.00006,1047770,59.97614,1746978
2173,lostick,1,0.00006,1047771,59.97620,1746978
2174,ludokx,1,0.00006,1047772,59.97626,1746978
2175,luizcarraro,1,0.00006,1047773,59.97631,1746978
2176,lweichselbaum,1,0.00006,1047774,59.97637,1746978
2177,lyda,1,0.00006,1047775,59.97643,1746978
2178,maciaszczykm,1,0.00006,1047776,59.97649,1746978
2179,magdazk,1,0.00006,1047777,59.97654,1746978
2180,makdharma,1,0.00006,1047778,59.97660,1746978
2181,malaporte,1,0.00006,1047779,59.97666,1746978
2182,manolo,1,0.00006,1047780,59.97671,1746978
2183,marcelbirkner,1,0.00006,1047781,59.97677,1746978
2184,marcosnils,1,0.00006,1047782,59.97683,1746978
2185,markgibaud,1,0.00006,1047783,59.97689,1746978
2186,martijnwalraven,1,0.00006,1047784,59.97694,1746978
2187,marwanad,1,0.00006,1047785,59.97700,1746978
2188,maryshak1996,1,0.00006,1047786,59.97706,1746978
2189,Masquerade0097,1,0.00006,1047787,59.97711,1746978
2190,matthewdias,1,0.00006,1047788,59.97717,1746978
2191,maugusto-cit,1,0.00006,1047789,59.97723,1746978
2192,maxenglander,1,0.00006,1047790,59.97729,1746978
2193,mazzy89,1,0.00006,1047791,59.97734,1746978
2194,mbabker,1,0.00006,1047792,59.97740,1746978
2195,mbearup,1,0.00006,1047793,59.97746,1746978
2196,mbonaci,1,0.00006,1047794,59.97752,1746978
2197,mbrevoort,1,0.00006,1047795,59.97757,1746978
2198,merge,1,0.00006,1047796,59.97763,1746978
2199,metmajer,1,0.00006,1047797,59.97769,1746978
2200,michaelklishin,1,0.00006,1047798,59.97774,1746978
2201,michaelolbrich,1,0.00006,1047799,59.97780,1746978
2202,mickep76,1,0.00006,1047800,59.97786,1746978
2203,MikeGoldsmith,1,0.00006,1047801,59.97792,1746978
2204,mikemeko,1,0.00006,1047802,59.97797,1746978
2205,mikesplain,1,0.00006,1047803,59.97803,1746978
2206,mindscratch,1,0.00006,1047804,59.97809,1746978
2207,mirosval,1,0.00006,1047805,59.97815,1746978
2208,misterbeegee,1,0.00006,1047806,59.97820,1746978
2209,mitchlloyd,1,0.00006,1047807,59.97826,1746978
2210,mkanat,1,0.00006,1047808,59.97832,1746978
2211,mkobit,1,0.00006,1047809,59.97837,1746978
2212,mkulke,1,0.00006,1047810,59.97843,1746978
2213,mmoffitt,1,0.00006,1047811,59.97849,1746978
2214,monday0rsunday,1,0.00006,1047812,59.97855,1746978
2215,mritche,1,0.00006,1047813,59.97860,1746978
2216,msiebuhr,1,0.00006,1047814,59.97866,1746978
2217,msolomon,1,0.00006,1047815,59.97872,1746978
2218,mtaran-google,1,0.00006,1047816,59.97877,1746978
2219,mtwo,1,0.00006,1047817,59.97883,1746978
2220,mxpv,1,0.00006,1047818,59.97889,1746978
2221,ncopa,1,0.00006,1047819,59.97895,1746978
2222,nertim,1,0.00006,1047820,59.97900,1746978
2223,nfalco79,1,0.00006,1047821,59.97906,1746978
2224,nickygerritsen,1,0.00006,1047822,59.97912,1746978
2225,NicolasT,1,0.00006,1047823,59.97918,1746978
2226,nikita-nuka,1,0.00006,1047824,59.97923,1746978
2227,nlamirault,1,0.00006,1047825,59.97929,1746978
2228,nmckay,1,0.00006,1047826,59.97935,1746978
2229,nnordrum,1,0.00006,1047827,59.97940,1746978
2230,Noamyoungerm,1,0.00006,1047828,59.97946,1746978
2231,nodo,1,0.00006,1047829,59.97952,1746978
2232,noqcks,1,0.00006,1047830,59.97958,1746978
2233,notslang,1,0.00006,1047831,59.97963,1746978
2234,nrook-google,1,0.00006,1047832,59.97969,1746978
2235,octete,1,0.00006,1047833,59.97975,1746978
2236,ohookins,1,0.00006,1047834,59.97981,1746978
2237,OlafSzmidt,1,0.00006,1047835,59.97986,1746978
2238,olamy,1,0.00006,1047836,59.97992,1746978
2239,OMMHOA,1,0.00006,1047837,59.97998,1746978
2240,p8952,1,0.00006,1047838,59.98003,1746978
2241,pablochacin,1,0.00006,1047839,59.98009,1746978
2242,pascalandy,1,0.00006,1047840,59.98015,1746978
2243,patelrit,1,0.00006,1047841,59.98021,1746978
2244,PatrickLang,1,0.00006,1047842,59.98026,1746978
2245,paultyng,1,0.00006,1047843,59.98032,1746978
2246,pcbailey,1,0.00006,1047844,59.98038,1746978
2247,pclinger,1,0.00006,1047845,59.98043,1746978
2248,pesama,1,0.00006,1047846,59.98049,1746978
2249,petervandenabeele,1,0.00006,1047847,59.98055,1746978
2250,petrvandrovec,1,0.00006,1047848,59.98061,1746978
2251,pfalcon,1,0.00006,1047849,59.98066,1746978
2252,philipbjorge,1,0.00006,1047850,59.98072,1746978
2253,php-coder,1,0.00006,1047851,59.98078,1746978
2254,phuonghuynh,1,0.00006,1047852,59.98084,1746978
2255,pierrebeaucamp,1,0.00006,1047853,59.98089,1746978
2256,plumpy,1,0.00006,1047854,59.98095,1746978
2257,pluttrell,1,0.00006,1047855,59.98101,1746978
2258,porridge,1,0.00006,1047856,59.98106,1746978
2259,posquit0,1,0.00006,1047857,59.98112,1746978
2260,prabhu43,1,0.00006,1047858,59.98118,1746978
2261,PRDinesh,1,0.00006,1047859,59.98124,1746978
2262,priley86,1,0.00006,1047860,59.98129,1746978
2263,prometheanfire,1,0.00006,1047861,59.98135,1746978
2264,pspacek,1,0.00006,1047862,59.98141,1746978
2265,psteitz,1,0.00006,1047863,59.98147,1746978
2266,quidryan,1,0.00006,1047864,59.98152,1746978
2267,radu-matei,1,0.00006,1047865,59.98158,1746978
2268,randomvariable,1,0.00006,1047866,59.98164,1746978
2269,ras0219-msft,1,0.00006,1047867,59.98169,1746978
2270,ratteler50,1,0.00006,1047868,59.98175,1746978
2271,raviqqe,1,0.00006,1047869,59.98181,1746978
2272,rbarazzutti,1,0.00006,1047870,59.98187,1746978
2273,rcoh,1,0.00006,1047871,59.98192,1746978
2274,redseiko,1,0.00006,1047872,59.98198,1746978
2275,reimertz,1,0.00006,1047873,59.98204,1746978
2276,Richardinho,1,0.00006,1047874,59.98209,1746978
2277,richerlariviere,1,0.00006,1047875,59.98215,1746978
2278,rickard-von-essen,1,0.00006,1047876,59.98221,1746978
2279,rinokadijk,1,0.00006,1047877,59.98227,1746978
2280,rlubke,1,0.00006,1047878,59.98232,1746978
2281,rmmh,1,0.00006,1047879,59.98238,1746978
2282,robermorales,1,0.00006,1047880,59.98244,1746978
2283,roidayan,1,0.00006,1047881,59.98250,1746978
2284,rossjudson,1,0.00006,1047882,59.98255,1746978
2285,rpothier,1,0.00006,1047883,59.98261,1746978
2286,rpristopan,1,0.00006,1047884,59.98267,1746978
2287,runcom,1,0.00006,1047885,59.98272,1746978
2288,ryankennedy,1,0.00006,1047886,59.98278,1746978
2289,ryanpetrello,1,0.00006,1047887,59.98284,1746978
2290,ryanwalls,1,0.00006,1047888,59.98290,1746978
2291,saada,1,0.00006,1047889,59.98295,1746978
2292,sagikazarmark,1,0.00006,1047890,59.98301,1746978
2293,sakshamsharma,1,0.00006,1047891,59.98307,1746978
2294,salehe,1,0.00006,1047892,59.98313,1746978
2295,samueltbrown,1,0.00006,1047893,59.98318,1746978
2296,saserr,1,0.00006,1047894,59.98324,1746978
2297,sbstjn,1,0.00006,1047895,59.98330,1746978
2298,schatekar,1,0.00006,1047896,59.98335,1746978
2299,scherler,1,0.00006,1047897,59.98341,1746978
2300,sdague,1,0.00006,1047898,59.98347,1746978
2301,sean-,1,0.00006,1047899,59.98353,1746978
2302,seaneagan,1,0.00006,1047900,59.98358,1746978
2303,sebastian-philipp,1,0.00006,1047901,59.98364,1746978
2304,seemethere,1,0.00006,1047902,59.98370,1746978
2305,segrax,1,0.00006,1047903,59.98375,1746978
2306,SEJeff,1,0.00006,1047904,59.98381,1746978
2307,serbrech,1,0.00006,1047905,59.98387,1746978
2308,SergejSalnikov,1,0.00006,1047906,59.98393,1746978
2309,seth-priya,1,0.00006,1047907,59.98398,1746978
2310,sghall,1,0.00006,1047908,59.98404,1746978
2311,Sharpie,1,0.00006,1047909,59.98410,1746978
2312,shawnps,1,0.00006,1047910,59.98416,1746978
2313,shaxbee,1,0.00006,1047911,59.98421,1746978
2314,ShenJack,1,0.00006,1047912,59.98427,1746978
2315,shin-,1,0.00006,1047913,59.98433,1746978
2316,Shrugs,1,0.00006,1047914,59.98438,1746978
2317,siavashs,1,0.00006,1047915,59.98444,1746978
2318,sidnei,1,0.00006,1047916,59.98450,1746978
2319,Simon-Li,1,0.00006,1047917,59.98456,1746978
2320,slix,1,0.00006,1047918,59.98461,1746978
2321,snowsky,1,0.00006,1047919,59.98467,1746978
2322,solsson,1,0.00006,1047920,59.98473,1746978
2323,sorenh,1,0.00006,1047921,59.98479,1746978
2324,sorensenjs,1,0.00006,1047922,59.98484,1746978
2325,sourcesoft,1,0.00006,1047923,59.98490,1746978
2326,srabraham,1,0.00006,1047924,59.98496,1746978
2327,srijs,1,0.00006,1047925,59.98501,1746978
2328,sshrdp,1,0.00006,1047926,59.98507,1746978
2329,stapelberg,1,0.00006,1047927,59.98513,1746978
2330,stefanhendriks,1,0.00006,1047928,59.98519,1746978
2331,stepancheg,1,0.00006,1047929,59.98524,1746978
2332,stephenway,1,0.00006,1047930,59.98530,1746978
2333,stevemcquaid,1,0.00006,1047931,59.98536,1746978
2334,stkevintan,1,0.00006,1047932,59.98541,1746978
2335,stmcginnis,1,0.00006,1047933,59.98547,1746978
2336,SummerWish,1,0.00006,1047934,59.98553,1746978
2337,superbrothers,1,0.00006,1047935,59.98559,1746978
2338,superhighfives,1,0.00006,1047936,59.98564,1746978
2339,suryagaddipati,1,0.00006,1047937,59.98570,1746978
2340,suside,1,0.00006,1047938,59.98576,1746978
2341,suwatch,1,0.00006,1047939,59.98582,1746978
2342,svenefftinge,1,0.00006,1047940,59.98587,1746978
2343,sylwit,1,0.00006,1047941,59.98593,1746978
2344,sym3tri,1,0.00006,1047942,59.98599,1746978
2345,t3chnoboy,1,0.00006,1047943,59.98604,1746978
2346,Tahler,1,0.00006,1047944,59.98610,1746978
2347,tcyrus,1,0.00006,1047945,59.98616,1746978
2348,techdragon,1,0.00006,1047946,59.98622,1746978
2349,tedli,1,0.00006,1047947,59.98627,1746978
2350,tedmiston,1,0.00006,1047948,59.98633,1746978
2351,tgxworld,1,0.00006,1047949,59.98639,1746978
2352,thomaschaaf,1,0.00006,1047950,59.98645,1746978
2353,thuey,1,0.00006,1047951,59.98650,1746978
2354,tianhuil,1,0.00006,1047952,59.98656,1746978
2355,timonvo,1,0.00006,1047953,59.98662,1746978
2356,timrchavez,1,0.00006,1047954,59.98667,1746978
2357,tjbenton,1,0.00006,1047955,59.98673,1746978
2358,t-miyake,1,0.00006,1047956,59.98679,1746978
2359,tobilarscheid,1,0.00006,1047957,59.98685,1746978
2360,tomball,1,0.00006,1047958,59.98690,1746978
2361,TomerWeisberg,1,0.00006,1047959,59.98696,1746978
2362,tomwganem,1,0.00006,1047960,59.98702,1746978
2363,tonycapone,1,0.00006,1047961,59.98707,1746978
2364,tothandras,1,0.00006,1047962,59.98713,1746978
2365,tpounds,1,0.00006,1047963,59.98719,1746978
2366,tr33house,1,0.00006,1047964,59.98725,1746978
2367,treeder,1,0.00006,1047965,59.98730,1746978
2368,treyhyde,1,0.00006,1047966,59.98736,1746978
2369,trofi,1,0.00006,1047967,59.98742,1746978
2370,tslater,1,0.00006,1047968,59.98748,1746978
2371,tsufiev,1,0.00006,1047969,59.98753,1746978
2372,tsums,1,0.00006,1047970,59.98759,1746978
2373,TsuyoshiUshio,1,0.00006,1047971,59.98765,1746978
2374,turb,1,0.00006,1047972,59.98770,1746978
2375,TurboTim,1,0.00006,1047973,59.98776,1746978
2376,typingduck,1,0.00006,1047974,59.98782,1746978
2377,umayr,1,0.00006,1047975,59.98788,1746978
2378,uzilan,1,0.00006,1047976,59.98793,1746978
2379,vadimeisenbergibm,1,0.00006,1047977,59.98799,1746978
2380,vanupam,1,0.00006,1047978,59.98805,1746978
2381,veblush,1,0.00006,1047979,59.98811,1746978
2382,victorboissiere,1,0.00006,1047980,59.98816,1746978
2383,victoriaaa234,1,0.00006,1047981,59.98822,1746978
2384,vietj,1,0.00006,1047982,59.98828,1746978
2385,vijayrkn,1,0.00006,1047983,59.98833,1746978
2386,vitalyisaev2,1,0.00006,1047984,59.98839,1746978
2387,vongohren,1,0.00006,1047985,59.98845,1746978
2388,vrana,1,0.00006,1047986,59.98851,1746978
2389,watashiSHUN,1,0.00006,1047987,59.98856,1746978
2390,wbrefvem,1,0.00006,1047988,59.98862,1746978
2391,westarle,1,0.00006,1047989,59.98868,1746978
2392,WGautier,1,0.00006,1047990,59.98873,1746978
2393,wiarlawd,1,0.00006,1047991,59.98879,1746978
2394,wolfs,1,0.00006,1047992,59.98885,1746978
2395,woosley,1,0.00006,1047993,59.98891,1746978
2396,workmaster2n,1,0.00006,1047994,59.98896,1746978
2397,wu-sheng,1,0.00006,1047995,59.98902,1746978
2398,x1957,1,0.00006,1047996,59.98908,1746978
2399,xale,1,0.00006,1047997,59.98914,1746978
2400,xalep,1,0.00006,1047998,59.98919,1746978
2401,xerial,1,0.00006,1047999,59.98925,1746978
2402,xinyanmsft,1,0.00006,1048000,59.98931,1746978
2403,yanyixing,1,0.00006,1048001,59.98936,1746978
2404,yaojingguo,1,0.00006,1048002,59.98942,1746978
2405,yaronr,1,0.00006,1048003,59.98948,1746978
2406,yissachar,1,0.00006,1048004,59.98954,1746978
2407,yourcelf,1,0.00006,1048005,59.98959,1746978
2408,yowakita,1,0.00006,1048006,59.98965,1746978
2409,zfraa,1,0.00006,1048007,59.98971,1746978
2410,zhe,1,0.00006,1048008,59.98977,1746978
2411,zhexuany,1,0.00006,1048009,59.98982,1746978
2412,zhouyanggao,1,0.00006,1048010,59.98988,1746978
