rank_number,actor,contributions,percent,cumulative_sum,cumulative_percent,all_contributions
1,zpao,6077,0.35605,6077,0.35605,1706803
2,JamesNK,4257,0.24941,10334,0.60546,1706803
3,christopherthielen,3706,0.21713,14040,0.82259,1706803
4,aweary,2868,0.16803,16908,0.99062,1706803
5,mmitche,2357,0.13809,19265,1.12872,1706803
6,davidfowl,2044,0.11976,21309,1.24847,1706803
7,pjanotti,1467,0.08595,22776,1.33442,1706803
8,kkirsche,1337,0.07833,24113,1.41276,1706803
9,gdi2290,974,0.05707,25087,1.46982,1706803
10,Aweary,963,0.05642,26050,1.52625,1706803
11,maxbeatty,875,0.05127,26925,1.57751,1706803
12,davidben,861,0.05045,27786,1.62796,1706803
13,akoeplinger,710,0.04160,28496,1.66955,1706803
14,JakeWharton,701,0.04107,29197,1.71063,1706803
15,vjeux,644,0.03773,29841,1.74836,1706803
16,garydgregory,618,0.03621,30459,1.78456,1706803
17,qmfrederik,576,0.03375,31035,1.81831,1706803
18,dwmw2,539,0.03158,31574,1.84989,1706803
19,swankjesse,530,0.03105,32104,1.88094,1706803
20,sharwell,519,0.03041,32623,1.91135,1706803
21,AArnott,513,0.03006,33136,1.94141,1706803
22,captbaritone,502,0.02941,33638,1.97082,1706803
23,chkal,434,0.02543,34072,1.99625,1706803
24,bendrucker,415,0.02431,34487,2.02056,1706803
25,kinow,301,0.01764,34788,2.03820,1706803
26,mgechev,300,0.01758,35088,2.05577,1706803
27,gunnarmorling,273,0.01599,35361,2.07177,1706803
28,tintoy,272,0.01594,35633,2.08770,1706803
29,SimenB,271,0.01588,35904,2.10358,1706803
30,icfantv,254,0.01488,36158,2.11846,1706803
31,xuwei-k,254,0.01488,36412,2.13335,1706803
32,sebbASF,234,0.01371,36646,2.14706,1706803
33,bep,196,0.01148,36842,2.15854,1706803
34,ronaldtse,196,0.01148,37038,2.17002,1706803
35,graingert,192,0.01125,37230,2.18127,1706803
36,Daniel15,173,0.01014,37403,2.19141,1706803
37,felixfbecker,165,0.00967,37568,2.20107,1706803
38,smile21prc,158,0.00926,37726,2.21033,1706803
39,netdpb,157,0.00920,37883,2.21953,1706803
40,simo5,151,0.00885,38034,2.22838,1706803
41,andschwa,141,0.00826,38175,2.23664,1706803
42,tatsuhiro-t,135,0.00791,38310,2.24455,1706803
43,Krinkle,129,0.00756,38439,2.25211,1706803
44,divdavem,126,0.00738,38565,2.25949,1706803
45,alex,120,0.00703,38685,2.26652,1706803
46,tiran,109,0.00639,38794,2.27290,1706803
47,cwe1ss,105,0.00615,38899,2.27906,1706803
48,jmrodri,102,0.00598,39001,2.28503,1706803
49,JustinBeckwith,99,0.00580,39100,2.29083,1706803
50,jsoref,95,0.00557,39195,2.29640,1706803
51,RReverser,94,0.00551,39289,2.30191,1706803
52,jcrugzz,89,0.00521,39378,2.30712,1706803
53,gregw,86,0.00504,39464,2.31216,1706803
54,ruippeixotog,82,0.00480,39546,2.31696,1706803
55,jcdickinson,81,0.00475,39627,2.32171,1706803
56,jskeet,81,0.00475,39708,2.32645,1706803
57,PeterDaveHello,73,0.00428,39781,2.33073,1706803
58,yoshuawuyts,69,0.00404,39850,2.33477,1706803
59,zertosh,67,0.00393,39917,2.33870,1706803
60,markt-asf,66,0.00387,39983,2.34257,1706803
61,dstufft,65,0.00381,40048,2.34638,1706803
62,leebyron,65,0.00381,40113,2.35018,1706803
63,jamesgeorge007,64,0.00375,40177,2.35393,1706803
64,briansmith,63,0.00369,40240,2.35762,1706803
65,kevinburke,63,0.00369,40303,2.36132,1706803
66,Lekensteyn,63,0.00369,40366,2.36501,1706803
67,olalonde,63,0.00369,40429,2.36870,1706803
68,haf,62,0.00363,40491,2.37233,1706803
69,aeijdenberg,61,0.00357,40552,2.37590,1706803
70,epeli,61,0.00357,40613,2.37948,1706803
71,pprindeville,61,0.00357,40674,2.38305,1706803
72,edevil,59,0.00346,40733,2.38651,1706803
73,SergeyKanzhelev,56,0.00328,40789,2.38979,1706803
74,orta,55,0.00322,40844,2.39301,1706803
75,krosenvold,54,0.00316,40898,2.39618,1706803
76,agl,53,0.00311,40951,2.39928,1706803
77,CodingFabian,51,0.00299,41002,2.40227,1706803
78,KyleAMathews,45,0.00264,41047,2.40491,1706803
79,lukesandberg,43,0.00252,41090,2.40742,1706803
80,martinheidegger,43,0.00252,41133,2.40994,1706803
81,JounQin,42,0.00246,41175,2.41240,1706803
82,zbjornson,42,0.00246,41217,2.41487,1706803
83,333fred,41,0.00240,41258,2.41727,1706803
84,lpereira,41,0.00240,41299,2.41967,1706803
85,ofrobots,41,0.00240,41340,2.42207,1706803
86,t-8ch,40,0.00234,41380,2.42442,1706803
87,elharo,39,0.00228,41419,2.42670,1706803
88,meteorcloudy,39,0.00228,41458,2.42899,1706803
89,tgriesser,39,0.00228,41497,2.43127,1706803
90,trevorlinton,39,0.00228,41536,2.43356,1706803
91,csvn,36,0.00211,41572,2.43566,1706803
92,ide,36,0.00211,41608,2.43777,1706803
93,sfackler,36,0.00211,41644,2.43988,1706803
94,calebmer,35,0.00205,41679,2.44193,1706803
95,ericelliott,35,0.00205,41714,2.44398,1706803
96,langpavel,34,0.00199,41748,2.44598,1706803
97,reda-alaoui,34,0.00199,41782,2.44797,1706803
98,vslinko,34,0.00199,41816,2.44996,1706803
99,Eddman,33,0.00193,41849,2.45189,1706803
100,kachkaev,33,0.00193,41882,2.45383,1706803
101,steelbrain,33,0.00193,41915,2.45576,1706803
102,ghatwala,32,0.00187,41947,2.45764,1706803
103,thomasmey,32,0.00187,41979,2.45951,1706803
104,mcandre,30,0.00176,42009,2.46127,1706803
105,eamonnmcmanus,29,0.00170,42038,2.46297,1706803
106,erikerlandson,29,0.00170,42067,2.46467,1706803
107,JunTaoLuo,29,0.00170,42096,2.46637,1706803
108,felixbuenemann,28,0.00164,42124,2.46801,1706803
109,Freyert,28,0.00164,42152,2.46965,1706803
110,grooverdan,28,0.00164,42180,2.47129,1706803
111,jakkdu,28,0.00164,42208,2.47293,1706803
112,jtattermusch,28,0.00164,42236,2.47457,1706803
113,jvz,28,0.00164,42264,2.47621,1706803
114,krotscheck,28,0.00164,42292,2.47785,1706803
115,LoicMahieu,28,0.00164,42320,2.47949,1706803
116,motiz88,28,0.00164,42348,2.48113,1706803
117,ruiaraujo,28,0.00164,42376,2.48277,1706803
118,wincent,28,0.00164,42404,2.48441,1706803
119,dciccale,27,0.00158,42431,2.48599,1706803
120,jeremycline,27,0.00158,42458,2.48757,1706803
121,josephsavona,27,0.00158,42485,2.48916,1706803
122,Pothulapati,26,0.00152,42511,2.49068,1706803
123,dminkovsky,25,0.00146,42536,2.49214,1706803
124,ebourg,25,0.00146,42561,2.49361,1706803
125,gitter-badger,25,0.00146,42586,2.49507,1706803
126,Globegitter,25,0.00146,42611,2.49654,1706803
127,huntc,25,0.00146,42636,2.49800,1706803
128,ilovett,25,0.00146,42661,2.49947,1706803
129,JensRantil,25,0.00146,42686,2.50093,1706803
130,JohnVillalovos,25,0.00146,42711,2.50240,1706803
131,nickdesaulniers,25,0.00146,42736,2.50386,1706803
132,pra85,25,0.00146,42761,2.50533,1706803
133,tbroadley,25,0.00146,42786,2.50679,1706803
134,terinjokes,25,0.00146,42811,2.50826,1706803
135,cjihrig,24,0.00141,42835,2.50966,1706803
136,matthauck,24,0.00141,42859,2.51107,1706803
137,mike-marcacci,24,0.00141,42883,2.51248,1706803
138,tcurdt,24,0.00141,42907,2.51388,1706803
139,jozefizso,23,0.00135,42930,2.51523,1706803
140,kevinsimper,23,0.00135,42953,2.51658,1706803
141,borekb,22,0.00129,42975,2.51787,1706803
142,dpursehouse,22,0.00129,42997,2.51915,1706803
143,Gregoirevda,22,0.00129,43019,2.52044,1706803
144,omeid,22,0.00129,43041,2.52173,1706803
145,raboof,22,0.00129,43063,2.52302,1706803
146,rwinch,22,0.00129,43085,2.52431,1706803
147,sheerun,22,0.00129,43107,2.52560,1706803
148,Vanuan,22,0.00129,43129,2.52689,1706803
149,chentsulin,21,0.00123,43150,2.52812,1706803
150,christianhuening,21,0.00123,43171,2.52935,1706803
151,gsans,21,0.00123,43192,2.53058,1706803
152,IvanGoncharov,21,0.00123,43213,2.53181,1706803
153,tiziano88,21,0.00123,43234,2.53304,1706803
154,vlajos,21,0.00123,43255,2.53427,1706803
155,aditya-shankar,20,0.00117,43275,2.53544,1706803
156,danielnorberg,20,0.00117,43295,2.53661,1706803
157,dongjoon-hyun,20,0.00117,43315,2.53779,1706803
158,EdwardBetts,20,0.00117,43335,2.53896,1706803
159,Jokero,20,0.00117,43355,2.54013,1706803
160,lersek,20,0.00117,43375,2.54130,1706803
161,monkey-mas,20,0.00117,43395,2.54247,1706803
162,nikolas,20,0.00117,43415,2.54364,1706803
163,sschuberth,20,0.00117,43435,2.54482,1706803
164,bkniffler,19,0.00111,43454,2.54593,1706803
165,ido-ran,19,0.00111,43473,2.54704,1706803
166,meenie,19,0.00111,43492,2.54816,1706803
167,rmg,19,0.00111,43511,2.54927,1706803
168,robphoenix,19,0.00111,43530,2.55038,1706803
169,watson,19,0.00111,43549,2.55150,1706803
170,bruno-garcia,18,0.00105,43567,2.55255,1706803
171,brycecr,18,0.00105,43585,2.55360,1706803
172,cesarandreu,18,0.00105,43603,2.55466,1706803
173,davido,18,0.00105,43621,2.55571,1706803
174,egor-n,18,0.00105,43639,2.55677,1706803
175,feloy,18,0.00105,43657,2.55782,1706803
176,hzamani,18,0.00105,43675,2.55888,1706803
177,nateq314,18,0.00105,43693,2.55993,1706803
178,slintes,18,0.00105,43711,2.56099,1706803
179,avkonst,17,0.00100,43728,2.56198,1706803
180,baer,17,0.00100,43745,2.56298,1706803
181,cushon,17,0.00100,43762,2.56397,1706803
182,deki,17,0.00100,43779,2.56497,1706803
183,gabelevi,17,0.00100,43796,2.56597,1706803
184,github-cygwin,17,0.00100,43813,2.56696,1706803
185,jameskyle,17,0.00100,43830,2.56796,1706803
186,snakefoot,17,0.00100,43847,2.56895,1706803
187,andyfleming,16,0.00094,43863,2.56989,1706803
188,astorije,16,0.00094,43879,2.57083,1706803
189,client9,16,0.00094,43895,2.57177,1706803
190,gmile,16,0.00094,43911,2.57270,1706803
191,jadekler,16,0.00094,43927,2.57364,1706803
192,macrozone,16,0.00094,43943,2.57458,1706803
193,MichielDeMey,16,0.00094,43959,2.57552,1706803
194,pjfanning,16,0.00094,43975,2.57645,1706803
195,stuartpb,16,0.00094,43991,2.57739,1706803
196,tmortagne,16,0.00094,44007,2.57833,1706803
197,Urigo,16,0.00094,44023,2.57927,1706803
198,armujahid,15,0.00088,44038,2.58015,1706803
199,benmccann,15,0.00088,44053,2.58102,1706803
200,cminyard,15,0.00088,44068,2.58190,1706803
201,eljefedelrodeodeljefe,15,0.00088,44083,2.58278,1706803
202,ericedens,15,0.00088,44098,2.58366,1706803
203,mebigfatguy,15,0.00088,44113,2.58454,1706803
204,ryysud,15,0.00088,44128,2.58542,1706803
205,StarpTech,15,0.00088,44143,2.58630,1706803
206,vbauer,15,0.00088,44158,2.58718,1706803
207,cvle,14,0.00082,44172,2.58800,1706803
208,FGRibreau,14,0.00082,44186,2.58882,1706803
209,gregturn,14,0.00082,44200,2.58964,1706803
210,hmalphettes,14,0.00082,44214,2.59046,1706803
211,johnjbarton,14,0.00082,44228,2.59128,1706803
212,lyip1992,14,0.00082,44242,2.59210,1706803
213,mbroz,14,0.00082,44256,2.59292,1706803
214,nodkz,14,0.00082,44270,2.59374,1706803
215,pavolloffay,14,0.00082,44284,2.59456,1706803
216,simonferquel,14,0.00082,44298,2.59538,1706803
217,srl295,14,0.00082,44312,2.59620,1706803
218,adam-26,13,0.00076,44325,2.59696,1706803
219,aheckmann,13,0.00076,44338,2.59772,1706803
220,briananderson1222,13,0.00076,44351,2.59848,1706803
221,BrunoQuaresma,13,0.00076,44364,2.59925,1706803
222,fourcube,13,0.00076,44377,2.60001,1706803
223,gnomeontherun,13,0.00076,44390,2.60077,1706803
224,jermowery,13,0.00076,44403,2.60153,1706803
225,jin,13,0.00076,44416,2.60229,1706803
226,kaelig,13,0.00076,44429,2.60305,1706803
227,kofemann,13,0.00076,44442,2.60382,1706803
228,marob,13,0.00076,44455,2.60458,1706803
229,mbrukman,13,0.00076,44468,2.60534,1706803
230,nvartolomei,13,0.00076,44481,2.60610,1706803
231,oshalygin,13,0.00076,44494,2.60686,1706803
232,puradox,13,0.00076,44507,2.60762,1706803
233,ralphbean,13,0.00076,44520,2.60839,1706803
234,ravishivt,13,0.00076,44533,2.60915,1706803
235,rdsubhas,13,0.00076,44546,2.60991,1706803
236,remram44,13,0.00076,44559,2.61067,1706803
237,robcresswell,13,0.00076,44572,2.61143,1706803
238,spacepluk,13,0.00076,44585,2.61219,1706803
239,ahmetb,12,0.00070,44597,2.61290,1706803
240,anarcat,12,0.00070,44609,2.61360,1706803
241,Awk34,12,0.00070,44621,2.61430,1706803
242,bgw,12,0.00070,44633,2.61501,1706803
243,cclauss,12,0.00070,44645,2.61571,1706803
244,davidkarlsen,12,0.00070,44657,2.61641,1706803
245,devknoll,12,0.00070,44669,2.61712,1706803
246,ericcurtin,12,0.00070,44681,2.61782,1706803
247,hairyhenderson,12,0.00070,44693,2.61852,1706803
248,jacobwgillespie,12,0.00070,44705,2.61922,1706803
249,jakub-bochenski,12,0.00070,44717,2.61993,1706803
250,jeremejevs,12,0.00070,44729,2.62063,1706803
251,jroper,12,0.00070,44741,2.62133,1706803
252,karolz-ms,12,0.00070,44753,2.62204,1706803
253,peterhuene,12,0.00070,44765,2.62274,1706803
254,plaes,12,0.00070,44777,2.62344,1706803
255,randing89,12,0.00070,44789,2.62415,1706803
256,richardweinberger,12,0.00070,44801,2.62485,1706803
257,RinkAttendant6,12,0.00070,44813,2.62555,1706803
258,samwgoldman,12,0.00070,44825,2.62626,1706803
259,shiftkey,12,0.00070,44837,2.62696,1706803
260,alexwlchan,11,0.00064,44848,2.62760,1706803
261,alistair23,11,0.00064,44859,2.62825,1706803
262,alokmenghrajani,11,0.00064,44870,2.62889,1706803
263,bolinfest,11,0.00064,44881,2.62954,1706803
264,connor4312,11,0.00064,44892,2.63018,1706803
265,fcamblor,11,0.00064,44903,2.63082,1706803
266,felixonmars,11,0.00064,44914,2.63147,1706803
267,icholy,11,0.00064,44925,2.63211,1706803
268,ipuustin,11,0.00064,44936,2.63276,1706803
269,jgangemi,11,0.00064,44947,2.63340,1706803
270,jonasfj,11,0.00064,44958,2.63405,1706803
271,joshuagl,11,0.00064,44969,2.63469,1706803
272,moander,11,0.00064,44980,2.63534,1706803
273,msmeissn,11,0.00064,44991,2.63598,1706803
274,AlexZeitler,10,0.00059,45001,2.63657,1706803
275,cemo,10,0.00059,45011,2.63715,1706803
276,dyladan,10,0.00059,45021,2.63774,1706803
277,fwbrasil,10,0.00059,45031,2.63832,1706803
278,glasser,10,0.00059,45041,2.63891,1706803
279,grant,10,0.00059,45051,2.63950,1706803
280,hyandell,10,0.00059,45061,2.64008,1706803
281,jamesward,10,0.00059,45071,2.64067,1706803
282,jhaber,10,0.00059,45081,2.64125,1706803
283,joshperry,10,0.00059,45091,2.64184,1706803
284,kassens,10,0.00059,45101,2.64243,1706803
285,kaycebasques,10,0.00059,45111,2.64301,1706803
286,kkm000,10,0.00059,45121,2.64360,1706803
287,lvarayut,10,0.00059,45131,2.64418,1706803
288,mdonoughe,10,0.00059,45141,2.64477,1706803
289,mikesamuel,10,0.00059,45151,2.64536,1706803
290,pierre-b,10,0.00059,45161,2.64594,1706803
291,r4j4h,10,0.00059,45171,2.64653,1706803
292,rdodev,10,0.00059,45181,2.64711,1706803
293,RobertKielty,10,0.00059,45191,2.64770,1706803
294,sjackman,10,0.00059,45201,2.64828,1706803
295,vladmos,10,0.00059,45211,2.64887,1706803
296,2rs2ts,9,0.00053,45220,2.64940,1706803
297,abcfy2,9,0.00053,45229,2.64993,1706803
298,andrenarchy,9,0.00053,45238,2.65045,1706803
299,carltonf,9,0.00053,45247,2.65098,1706803
300,flozano,9,0.00053,45256,2.65151,1706803
301,JackOfMostTrades,9,0.00053,45265,2.65203,1706803
302,jasonkuhrt,9,0.00053,45274,2.65256,1706803
303,johnlabarge,9,0.00053,45283,2.65309,1706803
304,mairin,9,0.00053,45292,2.65362,1706803
305,md5,9,0.00053,45301,2.65414,1706803
306,michaelstaib,9,0.00053,45310,2.65467,1706803
307,micmro,9,0.00053,45319,2.65520,1706803
308,morgante,9,0.00053,45328,2.65573,1706803
309,Naddiseo,9,0.00053,45337,2.65625,1706803
310,njhill,9,0.00053,45346,2.65678,1706803
311,olegsu,9,0.00053,45355,2.65731,1706803
312,ReadmeCritic,9,0.00053,45364,2.65783,1706803
313,skevy,9,0.00053,45373,2.65836,1706803
314,slandelle,9,0.00053,45382,2.65889,1706803
315,slang800,9,0.00053,45391,2.65942,1706803
316,TAGC,9,0.00053,45400,2.65994,1706803
317,tbroyer,9,0.00053,45409,2.66047,1706803
318,torbenh3,9,0.00053,45418,2.66100,1706803
319,vielmetti,9,0.00053,45427,2.66153,1706803
320,xiaoshuang-lu,9,0.00053,45436,2.66205,1706803
321,yarikoptic,9,0.00053,45445,2.66258,1706803
322,yaroslavya,9,0.00053,45454,2.66311,1706803
323,blimmer,8,0.00047,45462,2.66358,1706803
324,bouk,8,0.00047,45470,2.66405,1706803
325,chrishiestand,8,0.00047,45478,2.66451,1706803
326,DullReferenceException,8,0.00047,45486,2.66498,1706803
327,ecki,8,0.00047,45494,2.66545,1706803
328,eddywashere,8,0.00047,45502,2.66592,1706803
329,epixa,8,0.00047,45510,2.66639,1706803
330,fabdouglas,8,0.00047,45518,2.66686,1706803
331,gliptak,8,0.00047,45526,2.66733,1706803
332,gnoack,8,0.00047,45534,2.66779,1706803
333,halkeye,8,0.00047,45542,2.66826,1706803
334,heshamMassoud,8,0.00047,45550,2.66873,1706803
335,javabrett,8,0.00047,45558,2.66920,1706803
336,johngmyers,8,0.00047,45566,2.66967,1706803
337,jpiccari,8,0.00047,45574,2.67014,1706803
338,jstarks,8,0.00047,45582,2.67061,1706803
339,kmala,8,0.00047,45590,2.67108,1706803
340,ksophocleous,8,0.00047,45598,2.67154,1706803
341,lsiudut,8,0.00047,45606,2.67201,1706803
342,marciopuga,8,0.00047,45614,2.67248,1706803
343,mausch,8,0.00047,45622,2.67295,1706803
344,neosab,8,0.00047,45630,2.67342,1706803
345,nickgrealy,8,0.00047,45638,2.67389,1706803
346,nurse,8,0.00047,45646,2.67436,1706803
347,otaviojava,8,0.00047,45654,2.67483,1706803
348,perezd,8,0.00047,45662,2.67529,1706803
349,pietern,8,0.00047,45670,2.67576,1706803
350,rochdev,8,0.00047,45678,2.67623,1706803
351,southpolesteve,8,0.00047,45686,2.67670,1706803
352,starpit,8,0.00047,45694,2.67717,1706803
353,teohhanhui,8,0.00047,45702,2.67764,1706803
354,theganyo,8,0.00047,45710,2.67811,1706803
355,themez,8,0.00047,45718,2.67858,1706803
356,thomasdarimont,8,0.00047,45726,2.67904,1706803
357,tIGO,8,0.00047,45734,2.67951,1706803
358,wking,8,0.00047,45742,2.67998,1706803
359,wub,8,0.00047,45750,2.68045,1706803
360,zx2c4,8,0.00047,45758,2.68092,1706803
361,alexellis,7,0.00041,45765,2.68133,1706803
362,benjie,7,0.00041,45772,2.68174,1706803
363,blueyed,7,0.00041,45779,2.68215,1706803
364,bolu,7,0.00041,45786,2.68256,1706803
365,bz2,7,0.00041,45793,2.68297,1706803
366,Cito,7,0.00041,45800,2.68338,1706803
367,cournape,7,0.00041,45807,2.68379,1706803
368,DamonGant,7,0.00041,45814,2.68420,1706803
369,danielwertheim,7,0.00041,45821,2.68461,1706803
370,daxtens,7,0.00041,45828,2.68502,1706803
371,deitch,7,0.00041,45835,2.68543,1706803
372,dimaqq,7,0.00041,45842,2.68584,1706803
373,directhex,7,0.00041,45849,2.68625,1706803
374,dlech,7,0.00041,45856,2.68666,1706803
375,dnozay,7,0.00041,45863,2.68707,1706803
376,dveeden,7,0.00041,45870,2.68748,1706803
377,evolvah,7,0.00041,45877,2.68789,1706803
378,floreks,7,0.00041,45884,2.68830,1706803
379,frosas,7,0.00041,45891,2.68871,1706803
380,fson,7,0.00041,45898,2.68912,1706803
381,goostleek,7,0.00041,45905,2.68953,1706803
382,hpurmann,7,0.00041,45912,2.68994,1706803
383,hypery2k,7,0.00041,45919,2.69035,1706803
384,iemejia,7,0.00041,45926,2.69076,1706803
385,jefferai,7,0.00041,45933,2.69117,1706803
386,jiria,7,0.00041,45940,2.69158,1706803
387,JordanP,7,0.00041,45947,2.69199,1706803
388,jwuliger,7,0.00041,45954,2.69240,1706803
389,myungjoo,7,0.00041,45961,2.69281,1706803
390,pvanderlinden,7,0.00041,45968,2.69322,1706803
391,sethpollack,7,0.00041,45975,2.69363,1706803
392,sixlettervariables,7,0.00041,45982,2.69404,1706803
393,Sovietaced,7,0.00041,45989,2.69445,1706803
394,sputnik13,7,0.00041,45996,2.69486,1706803
395,stieler-it,7,0.00041,46003,2.69527,1706803
396,syrnick,7,0.00041,46010,2.69568,1706803
397,tamird,7,0.00041,46017,2.69609,1706803
398,tanaka-takayoshi,7,0.00041,46024,2.69650,1706803
399,tfarina,7,0.00041,46031,2.69691,1706803
400,thedrow,7,0.00041,46038,2.69732,1706803
401,tomgeorge,7,0.00041,46045,2.69773,1706803
402,torvitas,7,0.00041,46052,2.69814,1706803
403,vorburger,7,0.00041,46059,2.69855,1706803
404,wadahiro,7,0.00041,46066,2.69896,1706803
405,Wilfred,7,0.00041,46073,2.69937,1706803
406,xerofoify,7,0.00041,46080,2.69978,1706803
407,zg,7,0.00041,46087,2.70019,1706803
408,a86c6f7964,6,0.00035,46093,2.70055,1706803
409,acarl005,6,0.00035,46099,2.70090,1706803
410,agentgonzo,6,0.00035,46105,2.70125,1706803
411,ankon,6,0.00035,46111,2.70160,1706803
412,aroc,6,0.00035,46117,2.70195,1706803
413,askhalil,6,0.00035,46123,2.70230,1706803
414,bjori,6,0.00035,46129,2.70266,1706803
415,chelsiocrypto,6,0.00035,46135,2.70301,1706803
416,CindyXing,6,0.00035,46141,2.70336,1706803
417,coryfklein,6,0.00035,46147,2.70371,1706803
418,dcbeckett,6,0.00035,46153,2.70406,1706803
419,discostu105,6,0.00035,46159,2.70441,1706803
420,dsoprea,6,0.00035,46165,2.70476,1706803
421,elgalu,6,0.00035,46171,2.70512,1706803
422,enaqx,6,0.00035,46177,2.70547,1706803
423,Evangelink,6,0.00035,46183,2.70582,1706803
424,farazfazli,6,0.00035,46189,2.70617,1706803
425,gesellix,6,0.00035,46195,2.70652,1706803
426,guenhter,6,0.00035,46201,2.70687,1706803
427,Havner,6,0.00035,46207,2.70723,1706803
428,hotpxl,6,0.00035,46213,2.70758,1706803
429,jglick,6,0.00035,46219,2.70793,1706803
430,jiafu1115,6,0.00035,46225,2.70828,1706803
431,jloisel,6,0.00035,46231,2.70863,1706803
432,juanpablo-santos,6,0.00035,46237,2.70898,1706803
433,KindDragon,6,0.00035,46243,2.70933,1706803
434,klippx,6,0.00035,46249,2.70969,1706803
435,Kuqd,6,0.00035,46255,2.71004,1706803
436,larsks,6,0.00035,46261,2.71039,1706803
437,LinuxSuRen,6,0.00035,46267,2.71074,1706803
438,marcbachmann,6,0.00035,46273,2.71109,1706803
439,marians,6,0.00035,46279,2.71144,1706803
440,mgedmin,6,0.00035,46285,2.71180,1706803
441,mnadeem,6,0.00035,46291,2.71215,1706803
442,nacx,6,0.00035,46297,2.71250,1706803
443,nddipiazza,6,0.00035,46303,2.71285,1706803
444,nevetS,6,0.00035,46309,2.71320,1706803
445,northtyphoon,6,0.00035,46315,2.71355,1706803
446,perlun,6,0.00035,46321,2.71390,1706803
447,qizha,6,0.00035,46327,2.71426,1706803
448,rafaelsales,6,0.00035,46333,2.71461,1706803
449,robey,6,0.00035,46339,2.71496,1706803
450,sourabhmodi,6,0.00035,46345,2.71531,1706803
451,Starefossen,6,0.00035,46351,2.71566,1706803
452,sufuf3,6,0.00035,46357,2.71601,1706803
453,thomassuckow,6,0.00035,46363,2.71637,1706803
454,tokuhirom,6,0.00035,46369,2.71672,1706803
455,tsabirgaliev,6,0.00035,46375,2.71707,1706803
456,ttencate,6,0.00035,46381,2.71742,1706803
457,tycho,6,0.00035,46387,2.71777,1706803
458,waynebrantley,6,0.00035,46393,2.71812,1706803
459,willseeyou,6,0.00035,46399,2.71847,1706803
460,AdamWill,5,0.00029,46404,2.71877,1706803
461,amadeus,5,0.00029,46409,2.71906,1706803
462,anangaur,5,0.00029,46414,2.71935,1706803
463,anpieber,5,0.00029,46419,2.71965,1706803
464,antonblanchard,5,0.00029,46424,2.71994,1706803
465,batrick,5,0.00029,46429,2.72023,1706803
466,bsyk,5,0.00029,46434,2.72052,1706803
467,cemremengu,5,0.00029,46439,2.72082,1706803
468,ClementGautier,5,0.00029,46444,2.72111,1706803
469,codesuki,5,0.00029,46449,2.72140,1706803
470,DanielMSchmidt,5,0.00029,46454,2.72170,1706803
471,DanLipsitt,5,0.00029,46459,2.72199,1706803
472,dhensen,5,0.00029,46464,2.72228,1706803
473,DQNEO,5,0.00029,46469,2.72258,1706803
474,evnm,5,0.00029,46474,2.72287,1706803
475,faascape,5,0.00029,46479,2.72316,1706803
476,fhemberger,5,0.00029,46484,2.72345,1706803
477,ilovezfs,5,0.00029,46489,2.72375,1706803
478,jaytaylor,5,0.00029,46494,2.72404,1706803
479,jcruz2us,5,0.00029,46499,2.72433,1706803
480,jenlampton,5,0.00029,46504,2.72463,1706803
481,kfenner,5,0.00029,46509,2.72492,1706803
482,ligurio,5,0.00029,46514,2.72521,1706803
483,localheinz,5,0.00029,46519,2.72550,1706803
484,lumag,5,0.00029,46524,2.72580,1706803
485,mafagafogigante,5,0.00029,46529,2.72609,1706803
486,mar-kolya,5,0.00029,46534,2.72638,1706803
487,MatthewDavidCampbell,5,0.00029,46539,2.72668,1706803
488,mgalgs,5,0.00029,46544,2.72697,1706803
489,mtgibbs,5,0.00029,46549,2.72726,1706803
490,notxcain,5,0.00029,46554,2.72756,1706803
491,pgr0ss,5,0.00029,46559,2.72785,1706803
492,plappermaul,5,0.00029,46564,2.72814,1706803
493,pracucci,5,0.00029,46569,2.72843,1706803
494,PunKeel,5,0.00029,46574,2.72873,1706803
495,rockwotj,5,0.00029,46579,2.72902,1706803
496,saponifi3d,5,0.00029,46584,2.72931,1706803
497,seans3,5,0.00029,46589,2.72961,1706803
498,sergiomcalzada,5,0.00029,46594,2.72990,1706803
499,slickplaid,5,0.00029,46599,2.73019,1706803
500,ssbarnea,5,0.00029,46604,2.73049,1706803
501,steven-zou,5,0.00029,46609,2.73078,1706803
502,tan9,5,0.00029,46614,2.73107,1706803
503,techtonik,5,0.00029,46619,2.73136,1706803
504,tweksteen,5,0.00029,46624,2.73166,1706803
505,vanmierlo,5,0.00029,46629,2.73195,1706803
506,Vimal-Raghubir,5,0.00029,46634,2.73224,1706803
507,vincentbernat,5,0.00029,46639,2.73254,1706803
508,vincentwoo,5,0.00029,46644,2.73283,1706803
509,whitlockjc,5,0.00029,46649,2.73312,1706803
510,xizhao,5,0.00029,46654,2.73341,1706803
511,ykzts,5,0.00029,46659,2.73371,1706803
512,aaronp24,4,0.00023,46663,2.73394,1706803
513,abernix,4,0.00023,46667,2.73418,1706803
514,albertvaka,4,0.00023,46671,2.73441,1706803
515,alexanderrtaylor,4,0.00023,46675,2.73464,1706803
516,apaatsio,4,0.00023,46679,2.73488,1706803
517,arpit-nagar,4,0.00023,46683,2.73511,1706803
518,arthurschreiber,4,0.00023,46687,2.73535,1706803
519,AsturaPhoenix,4,0.00023,46691,2.73558,1706803
520,aterreno,4,0.00023,46695,2.73582,1706803
521,aviau,4,0.00023,46699,2.73605,1706803
522,benjdlambert,4,0.00023,46703,2.73629,1706803
523,berendt,4,0.00023,46707,2.73652,1706803
524,berkerpeksag,4,0.00023,46711,2.73675,1706803
525,bryant1410,4,0.00023,46715,2.73699,1706803
526,bsideup,4,0.00023,46719,2.73722,1706803
527,c9s,4,0.00023,46723,2.73746,1706803
528,carlosjgp,4,0.00023,46727,2.73769,1706803
529,Carreau,4,0.00023,46731,2.73793,1706803
530,cgrushko,4,0.00023,46735,2.73816,1706803
531,charleswhchan,4,0.00023,46739,2.73839,1706803
532,christophetd,4,0.00023,46743,2.73863,1706803
533,coderanger,4,0.00023,46747,2.73886,1706803
534,coreybutler,4,0.00023,46751,2.73910,1706803
535,crccheck,4,0.00023,46755,2.73933,1706803
536,danechitoaie,4,0.00023,46759,2.73957,1706803
537,darthtrevino,4,0.00023,46763,2.73980,1706803
538,dolftax,4,0.00023,46767,2.74004,1706803
539,dothebart,4,0.00023,46771,2.74027,1706803
540,EcutDavid,4,0.00023,46775,2.74050,1706803
541,edtan,4,0.00023,46779,2.74074,1706803
542,ekimber,4,0.00023,46783,2.74097,1706803
543,ensonic,4,0.00023,46787,2.74121,1706803
544,EricEdens,4,0.00023,46791,2.74144,1706803
545,ErikBean,4,0.00023,46795,2.74168,1706803
546,Fizzadar,4,0.00023,46799,2.74191,1706803
547,frewsxcv,4,0.00023,46803,2.74214,1706803
548,gdelhumeau,4,0.00023,46807,2.74238,1706803
549,gjcarneiro,4,0.00023,46811,2.74261,1706803
550,harobed,4,0.00023,46815,2.74285,1706803
551,harshavardhana,4,0.00023,46819,2.74308,1706803
552,Hronom,4,0.00023,46823,2.74332,1706803
553,inlined,4,0.00023,46827,2.74355,1706803
554,iredelmeier,4,0.00023,46831,2.74378,1706803
555,itajaja,4,0.00023,46835,2.74402,1706803
556,itamarst,4,0.00023,46839,2.74425,1706803
557,jeffmahoney,4,0.00023,46843,2.74449,1706803
558,jhgg,4,0.00023,46847,2.74472,1706803
559,johnlinp,4,0.00023,46851,2.74496,1706803
560,kevgliss,4,0.00023,46855,2.74519,1706803
561,keyan,4,0.00023,46859,2.74543,1706803
562,leewinder,4,0.00023,46863,2.74566,1706803
563,Lewiscowles1986,4,0.00023,46867,2.74589,1706803
564,lifubang,4,0.00023,46871,2.74613,1706803
565,mark-rushakoff,4,0.00023,46875,2.74636,1706803
566,mcumings,4,0.00023,46879,2.74660,1706803
567,metaskills,4,0.00023,46883,2.74683,1706803
568,mgrachev,4,0.00023,46887,2.74707,1706803
569,mhdawson,4,0.00023,46891,2.74730,1706803
570,mikol,4,0.00023,46895,2.74753,1706803
571,mindw,4,0.00023,46899,2.74777,1706803
572,mosesn,4,0.00023,46903,2.74800,1706803
573,netroby,4,0.00023,46907,2.74824,1706803
574,nicholaswyoung,4,0.00023,46911,2.74847,1706803
575,odeke-em,4,0.00023,46915,2.74871,1706803
576,olivierlemasle,4,0.00023,46919,2.74894,1706803
577,olostan,4,0.00023,46923,2.74917,1706803
578,pabigot,4,0.00023,46927,2.74941,1706803
579,palmerabollo,4,0.00023,46931,2.74964,1706803
580,pkubowicz,4,0.00023,46935,2.74988,1706803
581,pmouawad,4,0.00023,46939,2.75011,1706803
582,rahst12,4,0.00023,46943,2.75035,1706803
583,raul-arabaolaza,4,0.00023,46947,2.75058,1706803
584,reeceaw,4,0.00023,46951,2.75082,1706803
585,ryanwalters,4,0.00023,46955,2.75105,1706803
586,samueltardieu,4,0.00023,46959,2.75128,1706803
587,schmidt-sebastian,4,0.00023,46963,2.75152,1706803
588,sergeykad,4,0.00023,46967,2.75175,1706803
589,shirbr510,4,0.00023,46971,2.75199,1706803
590,sileht,4,0.00023,46975,2.75222,1706803
591,sinkingpoint,4,0.00023,46979,2.75246,1706803
592,sinthetix,4,0.00023,46983,2.75269,1706803
593,sjoerdtalsma,4,0.00023,46987,2.75292,1706803
594,steven-sheehy,4,0.00023,46991,2.75316,1706803
595,sunilmut,4,0.00023,46995,2.75339,1706803
596,svozza,4,0.00023,46999,2.75363,1706803
597,sylvestre,4,0.00023,47003,2.75386,1706803
598,t1,4,0.00023,47007,2.75410,1706803
599,tao12345666333,4,0.00023,47011,2.75433,1706803
600,tauren,4,0.00023,47015,2.75457,1706803
601,tazjin,4,0.00023,47019,2.75480,1706803
602,teone,4,0.00023,47023,2.75503,1706803
603,thinkerou,4,0.00023,47027,2.75527,1706803
604,tkellen,4,0.00023,47031,2.75550,1706803
605,travishaagen,4,0.00023,47035,2.75574,1706803
606,untoldone,4,0.00023,47039,2.75597,1706803
607,viirya,4,0.00023,47043,2.75621,1706803
608,wfhartford,4,0.00023,47047,2.75644,1706803
609,xaka,4,0.00023,47051,2.75667,1706803
610,xiaogaozi,4,0.00023,47055,2.75691,1706803
611,xnox,4,0.00023,47059,2.75714,1706803
612,yselkowitz,4,0.00023,47063,2.75738,1706803
613,zaitcev,4,0.00023,47067,2.75761,1706803
614,zhjwpku,4,0.00023,47071,2.75785,1706803
615,zshamrock,4,0.00023,47075,2.75808,1706803
616,ac360,3,0.00018,47078,2.75826,1706803
617,acao,3,0.00018,47081,2.75843,1706803
618,acdha,3,0.00018,47084,2.75861,1706803
619,adamhenson,3,0.00018,47087,2.75878,1706803
620,adioss,3,0.00018,47090,2.75896,1706803
621,aecolley,3,0.00018,47093,2.75914,1706803
622,akauppi,3,0.00018,47096,2.75931,1706803
623,akx,3,0.00018,47099,2.75949,1706803
624,aldaris,3,0.00018,47102,2.75966,1706803
625,alecharp,3,0.00018,47105,2.75984,1706803
626,andrewhowdencom,3,0.00018,47108,2.76001,1706803
627,andrewmchen,3,0.00018,47111,2.76019,1706803
628,andyli,3,0.00018,47114,2.76037,1706803
629,anish,3,0.00018,47117,2.76054,1706803
630,anthonyfok,3,0.00018,47120,2.76072,1706803
631,anuraaga,3,0.00018,47123,2.76089,1706803
632,ardbiesheuvel,3,0.00018,47126,2.76107,1706803
633,ash2k,3,0.00018,47129,2.76124,1706803
634,asottile,3,0.00018,47132,2.76142,1706803
635,avinassh,3,0.00018,47135,2.76160,1706803
636,bachp,3,0.00018,47138,2.76177,1706803
637,bassrock,3,0.00018,47141,2.76195,1706803
638,benmoss,3,0.00018,47144,2.76212,1706803
639,billpratt,3,0.00018,47147,2.76230,1706803
640,bmwiedemann,3,0.00018,47150,2.76247,1706803
641,brendandburns,3,0.00018,47153,2.76265,1706803
642,butchyyyy,3,0.00018,47156,2.76283,1706803
643,captainbrosset,3,0.00018,47159,2.76300,1706803
644,CatTail,3,0.00018,47162,2.76318,1706803
645,cben,3,0.00018,47165,2.76335,1706803
646,cesartl,3,0.00018,47168,2.76353,1706803
647,charleskorn,3,0.00018,47171,2.76371,1706803
648,choleraehyq,3,0.00018,47174,2.76388,1706803
649,chrisdunelm,3,0.00018,47177,2.76406,1706803
650,chrishoffman,3,0.00018,47180,2.76423,1706803
651,clemens-tolboom,3,0.00018,47183,2.76441,1706803
652,cneijenhuis,3,0.00018,47186,2.76458,1706803
653,danielkhan,3,0.00018,47189,2.76476,1706803
654,dapengzhang0,3,0.00018,47192,2.76494,1706803
655,davedoesdev,3,0.00018,47195,2.76511,1706803
656,davidbarratt,3,0.00018,47198,2.76529,1706803
657,dcuenot,3,0.00018,47201,2.76546,1706803
658,DenisKolodin,3,0.00018,47204,2.76564,1706803
659,dgarzon,3,0.00018,47207,2.76581,1706803
660,dgonzalez,3,0.00018,47210,2.76599,1706803
661,Diagoras,3,0.00018,47213,2.76617,1706803
662,diversario,3,0.00018,47216,2.76634,1706803
663,divyenduz,3,0.00018,47219,2.76652,1706803
664,dodie,3,0.00018,47222,2.76669,1706803
665,doshprompt,3,0.00018,47225,2.76687,1706803
666,dschaller,3,0.00018,47228,2.76704,1706803
667,dsexton,3,0.00018,47231,2.76722,1706803
668,ebraminio,3,0.00018,47234,2.76740,1706803
669,ekuefler,3,0.00018,47237,2.76757,1706803
670,elimisteve,3,0.00018,47240,2.76775,1706803
671,emaste,3,0.00018,47243,2.76792,1706803
672,enexusde,3,0.00018,47246,2.76810,1706803
673,Envek,3,0.00018,47249,2.76827,1706803
674,foxylion,3,0.00018,47252,2.76845,1706803
675,GabrielNicolasAvellaneda,3,0.00018,47255,2.76863,1706803
676,gilbode,3,0.00018,47258,2.76880,1706803
677,greenpau,3,0.00018,47261,2.76898,1706803
678,guyfedwards,3,0.00018,47264,2.76915,1706803
679,gyuho,3,0.00018,47267,2.76933,1706803
680,hashar,3,0.00018,47270,2.76951,1706803
681,hiyosi,3,0.00018,47273,2.76968,1706803
682,htuch,3,0.00018,47276,2.76986,1706803
683,hynek,3,0.00018,47279,2.77003,1706803
684,iawia002,3,0.00018,47282,2.77021,1706803
685,IlyaSemenov,3,0.00018,47285,2.77038,1706803
686,infrastation,3,0.00018,47288,2.77056,1706803
687,ingvagabund,3,0.00018,47291,2.77074,1706803
688,ivansenic,3,0.00018,47294,2.77091,1706803
689,IvanVergiliev,3,0.00018,47297,2.77109,1706803
690,JackDanger,3,0.00018,47300,2.77126,1706803
691,JaysonRaymond,3,0.00018,47303,2.77144,1706803
692,jcwilson,3,0.00018,47306,2.77161,1706803
693,jeffposnick,3,0.00018,47309,2.77179,1706803
694,jengelh,3,0.00018,47312,2.77197,1706803
695,joehni,3,0.00018,47315,2.77214,1706803
696,johnou,3,0.00018,47318,2.77232,1706803
697,johnrees,3,0.00018,47321,2.77249,1706803
698,JonasVautherin,3,0.00018,47324,2.77267,1706803
699,josegonzalez,3,0.00018,47327,2.77284,1706803
700,jrbenito,3,0.00018,47330,2.77302,1706803
701,jstoja,3,0.00018,47333,2.77320,1706803
702,jsuchenia,3,0.00018,47336,2.77337,1706803
703,jtblin,3,0.00018,47339,2.77355,1706803
704,jterry75,3,0.00018,47342,2.77372,1706803
705,jtkukunas,3,0.00018,47345,2.77390,1706803
706,julianvmodesto,3,0.00018,47348,2.77408,1706803
707,jurobystricky,3,0.00018,47351,2.77425,1706803
708,Kaijun,3,0.00018,47354,2.77443,1706803
709,kevinawoo,3,0.00018,47357,2.77460,1706803
710,kevinoliver,3,0.00018,47360,2.77478,1706803
711,ktdreyer,3,0.00018,47363,2.77495,1706803
712,ktsaou,3,0.00018,47366,2.77513,1706803
713,kvz,3,0.00018,47369,2.77531,1706803
714,kyakan,3,0.00018,47372,2.77548,1706803
715,kyschouv,3,0.00018,47375,2.77566,1706803
716,lakruzz,3,0.00018,47378,2.77583,1706803
717,Le0Michine,3,0.00018,47381,2.77601,1706803
718,LeoColomb,3,0.00018,47384,2.77618,1706803
719,leth,3,0.00018,47387,2.77636,1706803
720,lfaraone,3,0.00018,47390,2.77654,1706803
721,lgfa29,3,0.00018,47393,2.77671,1706803
722,Limess,3,0.00018,47396,2.77689,1706803
723,lloydde,3,0.00018,47399,2.77706,1706803
724,lorrin,3,0.00018,47402,2.77724,1706803
725,magnayn,3,0.00018,47405,2.77741,1706803
726,maitesin,3,0.00018,47408,2.77759,1706803
727,marc-guenther,3,0.00018,47411,2.77777,1706803
728,mark007,3,0.00018,47414,2.77794,1706803
729,mastertinner,3,0.00018,47417,2.77812,1706803
730,mattnworb,3,0.00018,47420,2.77829,1706803
731,maxibanki,3,0.00018,47423,2.77847,1706803
732,mfriedenhagen,3,0.00018,47426,2.77865,1706803
733,mgadda,3,0.00018,47429,2.77882,1706803
734,mgeisler,3,0.00018,47432,2.77900,1706803
735,mhils,3,0.00018,47435,2.77917,1706803
736,michael-k,3,0.00018,47438,2.77935,1706803
737,mike-rogers,3,0.00018,47441,2.77952,1706803
738,Mizux,3,0.00018,47444,2.77970,1706803
739,morficus,3,0.00018,47447,2.77988,1706803
740,mpg,3,0.00018,47450,2.78005,1706803
741,msabramo,3,0.00018,47453,2.78023,1706803
742,nathan-osman,3,0.00018,47456,2.78040,1706803
743,nickleefly,3,0.00018,47459,2.78058,1706803
744,nlowe,3,0.00018,47462,2.78075,1706803
745,oscerd,3,0.00018,47465,2.78093,1706803
746,paralin,3,0.00018,47468,2.78111,1706803
747,pavelchuchma,3,0.00018,47471,2.78128,1706803
748,p-bakker,3,0.00018,47474,2.78146,1706803
749,perryao,3,0.00018,47477,2.78163,1706803
750,pevik,3,0.00018,47480,2.78181,1706803
751,Philmod,3,0.00018,47483,2.78198,1706803
752,phvu,3,0.00018,47486,2.78216,1706803
753,PierreFritsch,3,0.00018,47489,2.78234,1706803
754,PiotrSikora,3,0.00018,47492,2.78251,1706803
755,pmeerw,3,0.00018,47495,2.78269,1706803
756,ptbrowne,3,0.00018,47498,2.78286,1706803
757,redixin,3,0.00018,47501,2.78304,1706803
758,rerickson1,3,0.00018,47504,2.78322,1706803
759,RochesterinNYC,3,0.00018,47507,2.78339,1706803
760,roidelapluie,3,0.00018,47510,2.78357,1706803
761,rossigee,3,0.00018,47513,2.78374,1706803
762,russgray,3,0.00018,47516,2.78392,1706803
763,rwillmer,3,0.00018,47519,2.78409,1706803
764,sargun,3,0.00018,47522,2.78427,1706803
765,scjody,3,0.00018,47525,2.78445,1706803
766,seanf,3,0.00018,47528,2.78462,1706803
767,sebastianroesch,3,0.00018,47531,2.78480,1706803
768,sofuture,3,0.00018,47534,2.78497,1706803
769,stephenjust,3,0.00018,47537,2.78515,1706803
770,stevekuznetsov,3,0.00018,47540,2.78532,1706803
771,Stono,3,0.00018,47543,2.78550,1706803
772,StuartHarris,3,0.00018,47546,2.78568,1706803
773,stuart-mclaren,3,0.00018,47549,2.78585,1706803
774,tadas-subonis,3,0.00018,47552,2.78603,1706803
775,tedsuo,3,0.00018,47555,2.78620,1706803
776,teresy,3,0.00018,47558,2.78638,1706803
777,tgxworld,3,0.00018,47561,2.78655,1706803
778,TobiX,3,0.00018,47564,2.78673,1706803
779,tombuildsstuff,3,0.00018,47567,2.78691,1706803
780,trshafer,3,0.00018,47570,2.78708,1706803
781,tuananh,3,0.00018,47573,2.78726,1706803
782,tuannvm,3,0.00018,47576,2.78743,1706803
783,vapier,3,0.00018,47579,2.78761,1706803
784,vickychijwani,3,0.00018,47582,2.78779,1706803
785,vitorarins,3,0.00018,47585,2.78796,1706803
786,wheleph,3,0.00018,47588,2.78814,1706803
787,wryun,3,0.00018,47591,2.78831,1706803
788,wsargent,3,0.00018,47594,2.78849,1706803
789,xeor,3,0.00018,47597,2.78866,1706803
790,XVincentX,3,0.00018,47600,2.78884,1706803
791,yacaovsnc,3,0.00018,47603,2.78902,1706803
792,zdw,3,0.00018,47606,2.78919,1706803
793,zhangyi089,3,0.00018,47609,2.78937,1706803
794,aashish-ak,2,0.00012,47611,2.78948,1706803
795,abitrolly,2,0.00012,47613,2.78960,1706803
796,achew22,2,0.00012,47615,2.78972,1706803
797,ajschlosser,2,0.00012,47617,2.78984,1706803
798,aknuds1,2,0.00012,47619,2.78995,1706803
799,aliok,2,0.00012,47621,2.79007,1706803
800,Aloren,2,0.00012,47623,2.79019,1706803
801,amacneil,2,0.00012,47625,2.79030,1706803
802,andersk,2,0.00012,47627,2.79042,1706803
803,andi-bigswitch,2,0.00012,47629,2.79054,1706803
804,andrerom,2,0.00012,47631,2.79066,1706803
805,AnneTheAgile,2,0.00012,47633,2.79077,1706803
806,ApsOps,2,0.00012,47635,2.79089,1706803
807,bbrowning,2,0.00012,47637,2.79101,1706803
808,BinaryDevil,2,0.00012,47639,2.79112,1706803
809,bluesliverx,2,0.00012,47641,2.79124,1706803
810,brantburnett,2,0.00012,47643,2.79136,1706803
811,brantlk,2,0.00012,47645,2.79148,1706803
812,bryanlarsen,2,0.00012,47647,2.79159,1706803
813,caarlos0,2,0.00012,47649,2.79171,1706803
814,caike,2,0.00012,47651,2.79183,1706803
815,campionfellin,2,0.00012,47653,2.79194,1706803
816,Capstan,2,0.00012,47655,2.79206,1706803
817,carlsverre,2,0.00012,47657,2.79218,1706803
818,ccamacho,2,0.00012,47659,2.79230,1706803
819,Cellule,2,0.00012,47661,2.79241,1706803
820,chaintng,2,0.00012,47663,2.79253,1706803
821,charly37,2,0.00012,47665,2.79265,1706803
822,chibicode,2,0.00012,47667,2.79277,1706803
823,christopher-s-hall,2,0.00012,47669,2.79288,1706803
824,cirocosta,2,0.00012,47671,2.79300,1706803
825,clemensv,2,0.00012,47673,2.79312,1706803
826,cmoulliard,2,0.00012,47675,2.79323,1706803
827,colachg,2,0.00012,47677,2.79335,1706803
828,crazytan,2,0.00012,47679,2.79347,1706803
829,cstyan,2,0.00012,47681,2.79359,1706803
830,ctubbsii,2,0.00012,47683,2.79370,1706803
831,culmat,2,0.00012,47685,2.79382,1706803
832,damienbiggs,2,0.00012,47687,2.79394,1706803
833,darrinholst,2,0.00012,47689,2.79405,1706803
834,deedubs,2,0.00012,47691,2.79417,1706803
835,deepaksood619,2,0.00012,47693,2.79429,1706803
836,deinspanjer,2,0.00012,47695,2.79441,1706803
837,denismakogon,2,0.00012,47697,2.79452,1706803
838,dimitropoulos,2,0.00012,47699,2.79464,1706803
839,DirtYiCE,2,0.00012,47701,2.79476,1706803
840,dmathieu,2,0.00012,47703,2.79487,1706803
841,domesticmouse,2,0.00012,47705,2.79499,1706803
842,dtaniwaki,2,0.00012,47707,2.79511,1706803
843,dunglas,2,0.00012,47709,2.79523,1706803
844,egeland,2,0.00012,47711,2.79534,1706803
845,ejc3,2,0.00012,47713,2.79546,1706803
846,EppO,2,0.00012,47715,2.79558,1706803
847,erik777,2,0.00012,47717,2.79569,1706803
848,estahn,2,0.00012,47719,2.79581,1706803
849,everett980,2,0.00012,47721,2.79593,1706803
850,ferhatelmas,2,0.00012,47723,2.79605,1706803
851,figaw,2,0.00012,47725,2.79616,1706803
852,flyboarder,2,0.00012,47727,2.79628,1706803
853,FrantaM,2,0.00012,47729,2.79640,1706803
854,frsyuki,2,0.00012,47731,2.79651,1706803
855,gbolo,2,0.00012,47733,2.79663,1706803
856,GeorgeSapkin,2,0.00012,47735,2.79675,1706803
857,gigaSproule,2,0.00012,47737,2.79687,1706803
858,glyn,2,0.00012,47739,2.79698,1706803
859,harryge00,2,0.00012,47741,2.79710,1706803
860,hboutemy,2,0.00012,47743,2.79722,1706803
861,henryju,2,0.00012,47745,2.79734,1706803
862,icereval,2,0.00012,47747,2.79745,1706803
863,ilgrosso,2,0.00012,47749,2.79757,1706803
864,iliul,2,0.00012,47751,2.79769,1706803
865,inyee786,2,0.00012,47753,2.79780,1706803
866,iwinux,2,0.00012,47755,2.79792,1706803
867,jackielii,2,0.00012,47757,2.79804,1706803
868,jakebolam,2,0.00012,47759,2.79816,1706803
869,jamiehodge,2,0.00012,47761,2.79827,1706803
870,Janario,2,0.00012,47763,2.79839,1706803
871,Jens-G,2,0.00012,47765,2.79851,1706803
872,jimrollenhagen,2,0.00012,47767,2.79862,1706803
873,jkandasa,2,0.00012,47769,2.79874,1706803
874,jlinton,2,0.00012,47771,2.79886,1706803
875,johanneswuerbach,2,0.00012,47773,2.79898,1706803
876,joshgav,2,0.00012,47775,2.79909,1706803
877,jparise,2,0.00012,47777,2.79921,1706803
878,jpbetz,2,0.00012,47779,2.79933,1706803
879,jpoon,2,0.00012,47781,2.79944,1706803
880,jrsquared,2,0.00012,47783,2.79956,1706803
881,jwhitcraft,2,0.00012,47785,2.79968,1706803
882,karataliu,2,0.00012,47787,2.79980,1706803
883,keeganwitt,2,0.00012,47789,2.79991,1706803
884,kellycampbell,2,0.00012,47791,2.80003,1706803
885,kgyrtkirk,2,0.00012,47793,2.80015,1706803
886,kirk91,2,0.00012,47795,2.80026,1706803
887,kjin,2,0.00012,47797,2.80038,1706803
888,kraj,2,0.00012,47799,2.80050,1706803
889,kwasimensah,2,0.00012,47801,2.80062,1706803
890,laszlocsomor,2,0.00012,47803,2.80073,1706803
891,lenage,2,0.00012,47805,2.80085,1706803
892,leodido,2,0.00012,47807,2.80097,1706803
893,lionelvillard,2,0.00012,47809,2.80108,1706803
894,llimllib,2,0.00012,47811,2.80120,1706803
895,lmcarreiro,2,0.00012,47813,2.80132,1706803
896,longsleep,2,0.00012,47815,2.80144,1706803
897,mafrosis,2,0.00012,47817,2.80155,1706803
898,marshallbrekka,2,0.00012,47819,2.80167,1706803
899,MartinNowak,2,0.00012,47821,2.80179,1706803
900,martinpitt,2,0.00012,47823,2.80191,1706803
901,martyanov,2,0.00012,47825,2.80202,1706803
902,mathstuf,2,0.00012,47827,2.80214,1706803
903,mblair,2,0.00012,47829,2.80226,1706803
904,mcoolive,2,0.00012,47831,2.80237,1706803
905,michaeljohnbennett,2,0.00012,47833,2.80249,1706803
906,mikesir87,2,0.00012,47835,2.80261,1706803
907,mina86,2,0.00012,47837,2.80273,1706803
908,morganfainberg,2,0.00012,47839,2.80284,1706803
909,mucahitkurt,2,0.00012,47841,2.80296,1706803
910,NamPNQ,2,0.00012,47843,2.80308,1706803
911,naveensrinivasan,2,0.00012,47845,2.80319,1706803
912,nbeckman,2,0.00012,47847,2.80331,1706803
913,nealef,2,0.00012,47849,2.80343,1706803
914,nikai3d,2,0.00012,47851,2.80355,1706803
915,Ninir,2,0.00012,47853,2.80366,1706803
916,nlopezgi,2,0.00012,47855,2.80378,1706803
917,nullstyle,2,0.00012,47857,2.80390,1706803
918,nzthiago,2,0.00012,47859,2.80401,1706803
919,okkez,2,0.00012,47861,2.80413,1706803
920,olleolleolle,2,0.00012,47863,2.80425,1706803
921,omerzach,2,0.00012,47865,2.80437,1706803
922,otavio,2,0.00012,47867,2.80448,1706803
923,parkr,2,0.00012,47869,2.80460,1706803
924,paulgmiller,2,0.00012,47871,2.80472,1706803
925,paultiplady,2,0.00012,47873,2.80483,1706803
926,pdudits,2,0.00012,47875,2.80495,1706803
927,pengx17,2,0.00012,47877,2.80507,1706803
928,petercgrant,2,0.00012,47879,2.80519,1706803
929,pfsmorigo,2,0.00012,47881,2.80530,1706803
930,pgadige,2,0.00012,47883,2.80542,1706803
931,pierreozoux,2,0.00012,47885,2.80554,1706803
932,pingunaut,2,0.00012,47887,2.80565,1706803
933,pmarks-net,2,0.00012,47889,2.80577,1706803
934,pulse00,2,0.00012,47891,2.80589,1706803
935,pushrax,2,0.00012,47893,2.80601,1706803
936,qar,2,0.00012,47895,2.80612,1706803
937,rdrgmnzs,2,0.00012,47897,2.80624,1706803
938,resker,2,0.00012,47899,2.80636,1706803
939,retrohacker,2,0.00012,47901,2.80648,1706803
940,rhencke,2,0.00012,47903,2.80659,1706803
941,rohanpai,2,0.00012,47905,2.80671,1706803
942,samridh90,2,0.00012,47907,2.80683,1706803
943,samuelkarp,2,0.00012,47909,2.80694,1706803
944,samv,2,0.00012,47911,2.80706,1706803
945,saschagrunert,2,0.00012,47913,2.80718,1706803
946,scboffspring,2,0.00012,47915,2.80730,1706803
947,schickling,2,0.00012,47917,2.80741,1706803
948,scothis,2,0.00012,47919,2.80753,1706803
949,seh,2,0.00012,47921,2.80765,1706803
950,sharonvardi,2,0.00012,47923,2.80776,1706803
951,shauns,2,0.00012,47925,2.80788,1706803
952,shichao-an,2,0.00012,47927,2.80800,1706803
953,shirdrn,2,0.00012,47929,2.80812,1706803
954,shubheksha,2,0.00012,47931,2.80823,1706803
955,silasb,2,0.00012,47933,2.80835,1706803
956,simonbrandhof,2,0.00012,47935,2.80847,1706803
957,sinstein,2,0.00012,47937,2.80858,1706803
958,sjug,2,0.00012,47939,2.80870,1706803
959,sjungwirth,2,0.00012,47941,2.80882,1706803
960,spen,2,0.00012,47943,2.80894,1706803
961,stephenjannin,2,0.00012,47945,2.80905,1706803
962,StevenACoffman,2,0.00012,47947,2.80917,1706803
963,stubailo,2,0.00012,47949,2.80929,1706803
964,SurferJeffAtGoogle,2,0.00012,47951,2.80940,1706803
965,syndbg,2,0.00012,47953,2.80952,1706803
966,tangiel,2,0.00012,47955,2.80964,1706803
967,testingbot,2,0.00012,47957,2.80976,1706803
968,TFenby,2,0.00012,47959,2.80987,1706803
969,TimvdLippe,2,0.00012,47961,2.80999,1706803
970,tklauser,2,0.00012,47963,2.81011,1706803
971,tmm1,2,0.00012,47965,2.81022,1706803
972,tomasbjerre,2,0.00012,47967,2.81034,1706803
973,tomgco,2,0.00012,47969,2.81046,1706803
974,tomkerkhove,2,0.00012,47971,2.81058,1706803
975,tsl0922,2,0.00012,47973,2.81069,1706803
976,twKrash,2,0.00012,47975,2.81081,1706803
977,tylerlong,2,0.00012,47977,2.81093,1706803
978,vania-pooh,2,0.00012,47979,2.81104,1706803
979,vbuslov,2,0.00012,47981,2.81116,1706803
980,vvidic,2,0.00012,47983,2.81128,1706803
981,wilk,2,0.00012,47985,2.81140,1706803
982,wohali,2,0.00012,47987,2.81151,1706803
983,wyllys66,2,0.00012,47989,2.81163,1706803
984,xfxyjwf,2,0.00012,47991,2.81175,1706803
985,yeputons,2,0.00012,47993,2.81187,1706803
986,yurrriq,2,0.00012,47995,2.81198,1706803
987,2color,1,0.00006,47996,2.81204,1706803
988,a8m,1,0.00006,47997,2.81210,1706803
989,aalexand,1,0.00006,47998,2.81216,1706803
990,abergmann,1,0.00006,47999,2.81222,1706803
991,abucodonosor,1,0.00006,48000,2.81228,1706803
992,acomagu,1,0.00006,48001,2.81233,1706803
993,AdamMajer,1,0.00006,48002,2.81239,1706803
994,adrianmoisey,1,0.00006,48003,2.81245,1706803
995,ahmadalli,1,0.00006,48004,2.81251,1706803
996,akervern,1,0.00006,48005,2.81257,1706803
997,alenkacz,1,0.00006,48006,2.81263,1706803
998,alexandrebodin,1,0.00006,48007,2.81269,1706803
999,alexmt,1,0.00006,48008,2.81274,1706803
1000,alexvicegrab,1,0.00006,48009,2.81280,1706803
1001,alfirin,1,0.00006,48010,2.81286,1706803
1002,alokrajiv,1,0.00006,48011,2.81292,1706803
1003,alonl,1,0.00006,48012,2.81298,1706803
1004,alpeb,1,0.00006,48013,2.81304,1706803
1005,alvgarvilla,1,0.00006,48014,2.81310,1706803
1006,anacrolix,1,0.00006,48015,2.81315,1706803
1007,anagrius,1,0.00006,48016,2.81321,1706803
1008,anandkumarpatel,1,0.00006,48017,2.81327,1706803
1009,andrewsomething,1,0.00006,48018,2.81333,1706803
1010,andreykaipov,1,0.00006,48019,2.81339,1706803
1011,annarozin,1,0.00006,48020,2.81345,1706803
1012,apaprocki,1,0.00006,48021,2.81351,1706803
1013,arapov,1,0.00006,48022,2.81356,1706803
1014,arghya88,1,0.00006,48023,2.81362,1706803
1015,ArieShout,1,0.00006,48024,2.81368,1706803
1016,arunkjn,1,0.00006,48025,2.81374,1706803
1017,arunvelsriram,1,0.00006,48026,2.81380,1706803
1018,aschepis,1,0.00006,48027,2.81386,1706803
1019,aspiers,1,0.00006,48028,2.81392,1706803
1020,atomantic,1,0.00006,48029,2.81397,1706803
1021,atombender,1,0.00006,48030,2.81403,1706803
1022,Autophagy,1,0.00006,48031,2.81409,1706803
1023,avarabyeu,1,0.00006,48032,2.81415,1706803
1024,avoinea,1,0.00006,48033,2.81421,1706803
1025,avranju,1,0.00006,48034,2.81427,1706803
1026,batmat,1,0.00006,48035,2.81433,1706803
1027,Bege13mot,1,0.00006,48036,2.81438,1706803
1028,benbalter,1,0.00006,48037,2.81444,1706803
1029,BenderV,1,0.00006,48038,2.81450,1706803
1030,benoitf,1,0.00006,48039,2.81456,1706803
1031,ben-st,1,0.00006,48040,2.81462,1706803
1032,bentmann,1,0.00006,48041,2.81468,1706803
1033,bezda,1,0.00006,48042,2.81474,1706803
1034,bhcopeland,1,0.00006,48043,2.81479,1706803
1035,biglovisa,1,0.00006,48044,2.81485,1706803
1036,bnjbvr,1,0.00006,48045,2.81491,1706803
1037,bobintornado,1,0.00006,48046,2.81497,1706803
1038,bobmshannon,1,0.00006,48047,2.81503,1706803
1039,boeboe,1,0.00006,48048,2.81509,1706803
1040,bonifaido,1,0.00006,48049,2.81515,1706803
1041,breeswish,1,0.00006,48050,2.81520,1706803
1042,bthelen,1,0.00006,48051,2.81526,1706803
1043,budhrg,1,0.00006,48052,2.81532,1706803
1044,BusyJay,1,0.00006,48053,2.81538,1706803
1045,cburmeister,1,0.00006,48054,2.81544,1706803
1046,cdown,1,0.00006,48055,2.81550,1706803
1047,cedriclam,1,0.00006,48056,2.81556,1706803
1048,cehoffman,1,0.00006,48057,2.81561,1706803
1049,centic9,1,0.00006,48058,2.81567,1706803
1050,cfieber,1,0.00006,48059,2.81573,1706803
1051,cfs-pure,1,0.00006,48060,2.81579,1706803
1052,chancez,1,0.00006,48061,2.81585,1706803
1053,chandresh-pancholi,1,0.00006,48062,2.81591,1706803
1054,Chen-Gang,1,0.00006,48063,2.81597,1706803
1055,chenrui333,1,0.00006,48064,2.81603,1706803
1056,chirino,1,0.00006,48065,2.81608,1706803
1057,chmouel,1,0.00006,48066,2.81614,1706803
1058,chris-rock,1,0.00006,48067,2.81620,1706803
1059,chrisseto,1,0.00006,48068,2.81626,1706803
1060,chris-short,1,0.00006,48069,2.81632,1706803
1061,chuckbutler,1,0.00006,48070,2.81638,1706803
1062,chwarr,1,0.00006,48071,2.81644,1706803
1063,ckross01,1,0.00006,48072,2.81649,1706803
1064,cleac,1,0.00006,48073,2.81655,1706803
1065,clguimanMSFT,1,0.00006,48074,2.81661,1706803
1066,collinpeters,1,0.00006,48075,2.81667,1706803
1067,Colstuwjx,1,0.00006,48076,2.81673,1706803
1068,cpointner,1,0.00006,48077,2.81679,1706803
1069,craigsmitham,1,0.00006,48078,2.81685,1706803
1070,cybergrind,1,0.00006,48079,2.81690,1706803
1071,dalanmiller,1,0.00006,48080,2.81696,1706803
1072,daniel-beck,1,0.00006,48081,2.81702,1706803
1073,daniel-kun,1,0.00006,48082,2.81708,1706803
1074,danielmbarlow,1,0.00006,48083,2.81714,1706803
1075,dankohn,1,0.00006,48084,2.81720,1706803
1076,darioblanco,1,0.00006,48085,2.81726,1706803
1077,davejamesmiller,1,0.00006,48086,2.81731,1706803
1078,davidcelis,1,0.00006,48087,2.81737,1706803
1079,davidmichaelkarr,1,0.00006,48088,2.81743,1706803
1080,DazWilkin,1,0.00006,48089,2.81749,1706803
1081,dblock,1,0.00006,48090,2.81755,1706803
1082,dbussink,1,0.00006,48091,2.81761,1706803
1083,dcbw,1,0.00006,48092,2.81767,1706803
1084,dconnelly,1,0.00006,48093,2.81772,1706803
1085,dcoraboeuf,1,0.00006,48094,2.81778,1706803
1086,deiwin,1,0.00006,48095,2.81784,1706803
1087,dennis-benzinger-hybris,1,0.00006,48096,2.81790,1706803
1088,Derbeth,1,0.00006,48097,2.81796,1706803
1089,DerDakon,1,0.00006,48098,2.81802,1706803
1090,derekperkins,1,0.00006,48099,2.81808,1706803
1091,d-e-s-o,1,0.00006,48100,2.81813,1706803
1092,devlance,1,0.00006,48101,2.81819,1706803
1093,dfredell,1,0.00006,48102,2.81825,1706803
1094,dgem,1,0.00006,48103,2.81831,1706803
1095,dims,1,0.00006,48104,2.81837,1706803
1096,dingwilson,1,0.00006,48105,2.81843,1706803
1097,diogogmt,1,0.00006,48106,2.81849,1706803
1098,dipak-pawar,1,0.00006,48107,2.81854,1706803
1099,displague,1,0.00006,48108,2.81860,1706803
1100,diwu1989,1,0.00006,48109,2.81866,1706803
1101,dlebed,1,0.00006,48110,2.81872,1706803
1102,dmsimard,1,0.00006,48111,2.81878,1706803
1103,dorav,1,0.00006,48112,2.81884,1706803
1104,dosire,1,0.00006,48113,2.81890,1706803
1105,dpurrington,1,0.00006,48114,2.81895,1706803
1106,drdamour,1,0.00006,48115,2.81901,1706803
1107,drusellers,1,0.00006,48116,2.81907,1706803
1108,dy-dx,1,0.00006,48117,2.81913,1706803
1109,dzimine,1,0.00006,48118,2.81919,1706803
1110,earlbread,1,0.00006,48119,2.81925,1706803
1111,ejamesc,1,0.00006,48120,2.81931,1706803
1112,ejoerns,1,0.00006,48121,2.81936,1706803
1113,ejona86,1,0.00006,48122,2.81942,1706803
1114,ekarlso,1,0.00006,48123,2.81948,1706803
1115,ekoome,1,0.00006,48124,2.81954,1706803
1116,ElfoLiNk,1,0.00006,48125,2.81960,1706803
1117,emaildanwilson,1,0.00006,48126,2.81966,1706803
1118,erain,1,0.00006,48127,2.81972,1706803
1119,etsauer,1,0.00006,48128,2.81977,1706803
1120,everett-toews,1,0.00006,48129,2.81983,1706803
1121,fasaxc,1,0.00006,48130,2.81989,1706803
1122,ferantivero,1,0.00006,48131,2.81995,1706803
1123,four43,1,0.00006,48132,2.82001,1706803
1124,frankgreco,1,0.00006,48133,2.82007,1706803
1125,fungi,1,0.00006,48134,2.82013,1706803
1126,gabel,1,0.00006,48135,2.82018,1706803
1127,gabikliot,1,0.00006,48136,2.82024,1706803
1128,gabrfarina,1,0.00006,48137,2.82030,1706803
1129,gam-phon,1,0.00006,48138,2.82036,1706803
1130,garyiwu,1,0.00006,48139,2.82042,1706803
1131,gaziqbal,1,0.00006,48140,2.82048,1706803
1132,gbraad,1,0.00006,48141,2.82054,1706803
1133,gdeangel,1,0.00006,48142,2.82059,1706803
1134,gdubya,1,0.00006,48143,2.82065,1706803
1135,georgecrawford,1,0.00006,48144,2.82071,1706803
1136,ggarnier,1,0.00006,48145,2.82077,1706803
1137,glaubitz,1,0.00006,48146,2.82083,1706803
1138,goldshtn,1,0.00006,48147,2.82089,1706803
1139,golonzovsky,1,0.00006,48148,2.82095,1706803
1140,grosser,1,0.00006,48149,2.82101,1706803
1141,guoshimin,1,0.00006,48150,2.82106,1706803
1142,haberman,1,0.00006,48151,2.82112,1706803
1143,hach-que,1,0.00006,48152,2.82118,1706803
1144,HackToday,1,0.00006,48153,2.82124,1706803
1145,harai,1,0.00006,48154,2.82130,1706803
1146,hjacobs,1,0.00006,48155,2.82136,1706803
1147,hoffin,1,0.00006,48156,2.82142,1706803
1148,huikang,1,0.00006,48157,2.82147,1706803
1149,ianlancetaylor,1,0.00006,48158,2.82153,1706803
1150,igalic,1,0.00006,48159,2.82159,1706803
1151,ihac,1,0.00006,48160,2.82165,1706803
1152,ikatson,1,0.00006,48161,2.82171,1706803
1153,irissmann,1,0.00006,48162,2.82177,1706803
1154,j14s,1,0.00006,48163,2.82183,1706803
1155,JackFish,1,0.00006,48164,2.82188,1706803
1156,jacmet,1,0.00006,48165,2.82194,1706803
1157,jakon89,1,0.00006,48166,2.82200,1706803
1158,javeme,1,0.00006,48167,2.82206,1706803
1159,jbaruch,1,0.00006,48168,2.82212,1706803
1160,jcoeltjen,1,0.00006,48169,2.82218,1706803
1161,jd,1,0.00006,48170,2.82224,1706803
1162,jeffrey4l,1,0.00006,48171,2.82229,1706803
1163,JeffRMoore,1,0.00006,48172,2.82235,1706803
1164,jeroenvisser101,1,0.00006,48173,2.82241,1706803
1165,jessica-dl,1,0.00006,48174,2.82247,1706803
1166,jgkamat,1,0.00006,48175,2.82253,1706803
1167,jhorwit2,1,0.00006,48176,2.82259,1706803
1168,jmagnusson,1,0.00006,48177,2.82265,1706803
1169,jmervine,1,0.00006,48178,2.82270,1706803
1170,jmini,1,0.00006,48179,2.82276,1706803
1171,joanrieu,1,0.00006,48180,2.82282,1706803
1172,joelschopp,1,0.00006,48181,2.82288,1706803
1173,johnaoss,1,0.00006,48182,2.82294,1706803
1174,johnzheng1975,1,0.00006,48183,2.82300,1706803
1175,JonnyIncognito,1,0.00006,48184,2.82306,1706803
1176,joschi,1,0.00006,48185,2.82311,1706803
1177,jpeterson88,1,0.00006,48186,2.82317,1706803
1178,jpreese,1,0.00006,48187,2.82323,1706803
1179,JRBANCEL,1,0.00006,48188,2.82329,1706803
1180,jrn,1,0.00006,48189,2.82335,1706803
1181,jsyrjala,1,0.00006,48190,2.82341,1706803
1182,julian-klode,1,0.00006,48191,2.82347,1706803
1183,jyane,1,0.00006,48192,2.82352,1706803
1184,karlkfi,1,0.00006,48193,2.82358,1706803
1185,kenegozi,1,0.00006,48194,2.82364,1706803
1186,kghost,1,0.00006,48195,2.82370,1706803
1187,kilink,1,0.00006,48196,2.82376,1706803
1188,komamitsu,1,0.00006,48197,2.82382,1706803
1189,konryd,1,0.00006,48198,2.82388,1706803
1190,kool79,1,0.00006,48199,2.82393,1706803
1191,KostyaSha,1,0.00006,48200,2.82399,1706803
1192,krasnoukhov,1,0.00006,48201,2.82405,1706803
1193,kriskowal,1,0.00006,48202,2.82411,1706803
1194,larrys,1,0.00006,48203,2.82417,1706803
1195,laurentlb,1,0.00006,48204,2.82423,1706803
1196,leighmcculloch,1,0.00006,48205,2.82429,1706803
1197,leitao,1,0.00006,48206,2.82434,1706803
1198,leseb,1,0.00006,48207,2.82440,1706803
1199,lexholden,1,0.00006,48208,2.82446,1706803
1200,limscoder,1,0.00006,48209,2.82452,1706803
1201,lindner,1,0.00006,48210,2.82458,1706803
1202,lizrice,1,0.00006,48211,2.82464,1706803
1203,lostick,1,0.00006,48212,2.82470,1706803
1204,ludokx,1,0.00006,48213,2.82475,1706803
1205,lyda,1,0.00006,48214,2.82481,1706803
1206,maciaszczykm,1,0.00006,48215,2.82487,1706803
1207,makdharma,1,0.00006,48216,2.82493,1706803
1208,malaporte,1,0.00006,48217,2.82499,1706803
1209,manolo,1,0.00006,48218,2.82505,1706803
1210,marcelbirkner,1,0.00006,48219,2.82511,1706803
1211,marcosnils,1,0.00006,48220,2.82516,1706803
1212,markgibaud,1,0.00006,48221,2.82522,1706803
1213,martijnwalraven,1,0.00006,48222,2.82528,1706803
1214,marwanad,1,0.00006,48223,2.82534,1706803
1215,Masquerade0097,1,0.00006,48224,2.82540,1706803
1216,maugusto-cit,1,0.00006,48225,2.82546,1706803
1217,maxenglander,1,0.00006,48226,2.82552,1706803
1218,mazzy89,1,0.00006,48227,2.82558,1706803
1219,mbabker,1,0.00006,48228,2.82563,1706803
1220,mbearup,1,0.00006,48229,2.82569,1706803
1221,mbonaci,1,0.00006,48230,2.82575,1706803
1222,mbrevoort,1,0.00006,48231,2.82581,1706803
1223,merge,1,0.00006,48232,2.82587,1706803
1224,metmajer,1,0.00006,48233,2.82593,1706803
1225,michaelklishin,1,0.00006,48234,2.82599,1706803
1226,michaelolbrich,1,0.00006,48235,2.82604,1706803
1227,mickep76,1,0.00006,48236,2.82610,1706803
1228,MikeGoldsmith,1,0.00006,48237,2.82616,1706803
1229,mikesplain,1,0.00006,48238,2.82622,1706803
1230,mindscratch,1,0.00006,48239,2.82628,1706803
1231,mirosval,1,0.00006,48240,2.82634,1706803
1232,mkobit,1,0.00006,48241,2.82640,1706803
1233,mkulke,1,0.00006,48242,2.82645,1706803
1234,monday0rsunday,1,0.00006,48243,2.82651,1706803
1235,mook-as,1,0.00006,48244,2.82657,1706803
1236,msiebuhr,1,0.00006,48245,2.82663,1706803
1237,msolomon,1,0.00006,48246,2.82669,1706803
1238,msrb,1,0.00006,48247,2.82675,1706803
1239,mtwo,1,0.00006,48248,2.82681,1706803
1240,mxpv,1,0.00006,48249,2.82686,1706803
1241,ncopa,1,0.00006,48250,2.82692,1706803
1242,nfalco79,1,0.00006,48251,2.82698,1706803
1243,nickygerritsen,1,0.00006,48252,2.82704,1706803
1244,NicolasT,1,0.00006,48253,2.82710,1706803
1245,nikolay-fedotov,1,0.00006,48254,2.82716,1706803
1246,nlamirault,1,0.00006,48255,2.82722,1706803
1247,nnordrum,1,0.00006,48256,2.82727,1706803
1248,nodo,1,0.00006,48257,2.82733,1706803
1249,noqcks,1,0.00006,48258,2.82739,1706803
1250,notslang,1,0.00006,48259,2.82745,1706803
1251,octete,1,0.00006,48260,2.82751,1706803
1252,ohookins,1,0.00006,48261,2.82757,1706803
1253,OlafSzmidt,1,0.00006,48262,2.82763,1706803
1254,olamy,1,0.00006,48263,2.82768,1706803
1255,OMMHOA,1,0.00006,48264,2.82774,1706803
1256,p8952,1,0.00006,48265,2.82780,1706803
1257,pablochacin,1,0.00006,48266,2.82786,1706803
1258,pascalandy,1,0.00006,48267,2.82792,1706803
1259,patelrit,1,0.00006,48268,2.82798,1706803
1260,PatrickLang,1,0.00006,48269,2.82804,1706803
1261,paultyng,1,0.00006,48270,2.82809,1706803
1262,pclinger,1,0.00006,48271,2.82815,1706803
1263,petervandenabeele,1,0.00006,48272,2.82821,1706803
1264,petrvandrovec,1,0.00006,48273,2.82827,1706803
1265,pfalcon,1,0.00006,48274,2.82833,1706803
1266,philipbjorge,1,0.00006,48275,2.82839,1706803
1267,php-coder,1,0.00006,48276,2.82845,1706803
1268,phuonghuynh,1,0.00006,48277,2.82850,1706803
1269,pierrebeaucamp,1,0.00006,48278,2.82856,1706803
1270,pluttrell,1,0.00006,48279,2.82862,1706803
1271,porridge,1,0.00006,48280,2.82868,1706803
1272,posquit0,1,0.00006,48281,2.82874,1706803
1273,prabhu43,1,0.00006,48282,2.82880,1706803
1274,PRDinesh,1,0.00006,48283,2.82886,1706803
1275,prometheanfire,1,0.00006,48284,2.82891,1706803
1276,qinix,1,0.00006,48285,2.82897,1706803
1277,quidryan,1,0.00006,48286,2.82903,1706803
1278,radu-matei,1,0.00006,48287,2.82909,1706803
1279,randomvariable,1,0.00006,48288,2.82915,1706803
1280,ras0219-msft,1,0.00006,48289,2.82921,1706803
1281,RashmicaG,1,0.00006,48290,2.82927,1706803
1282,raviqqe,1,0.00006,48291,2.82932,1706803
1283,rbarazzutti,1,0.00006,48292,2.82938,1706803
1284,rcoh,1,0.00006,48293,2.82944,1706803
1285,reimertz,1,0.00006,48294,2.82950,1706803
1286,richerlariviere,1,0.00006,48295,2.82956,1706803
1287,rickard-von-essen,1,0.00006,48296,2.82962,1706803
1288,rinokadijk,1,0.00006,48297,2.82968,1706803
1289,rlubke,1,0.00006,48298,2.82973,1706803
1290,rmmh,1,0.00006,48299,2.82979,1706803
1291,robermorales,1,0.00006,48300,2.82985,1706803
1292,roidayan,1,0.00006,48301,2.82991,1706803
1293,rpothier,1,0.00006,48302,2.82997,1706803
1294,runcom,1,0.00006,48303,2.83003,1706803
1295,ryanpetrello,1,0.00006,48304,2.83009,1706803
1296,ryanwalls,1,0.00006,48305,2.83015,1706803
1297,saada,1,0.00006,48306,2.83020,1706803
1298,sagikazarmark,1,0.00006,48307,2.83026,1706803
1299,sakshamsharma,1,0.00006,48308,2.83032,1706803
1300,salehe,1,0.00006,48309,2.83038,1706803
1301,samueltbrown,1,0.00006,48310,2.83044,1706803
1302,sbstjn,1,0.00006,48311,2.83050,1706803
1303,schatekar,1,0.00006,48312,2.83056,1706803
1304,scherler,1,0.00006,48313,2.83061,1706803
1305,ScottyBauer,1,0.00006,48314,2.83067,1706803
1306,sdague,1,0.00006,48315,2.83073,1706803
1307,sean-,1,0.00006,48316,2.83079,1706803
1308,seaneagan,1,0.00006,48317,2.83085,1706803
1309,sebastian-philipp,1,0.00006,48318,2.83091,1706803
1310,seemethere,1,0.00006,48319,2.83097,1706803
1311,segrax,1,0.00006,48320,2.83102,1706803
1312,SEJeff,1,0.00006,48321,2.83108,1706803
1313,serbrech,1,0.00006,48322,2.83114,1706803
1314,seth-priya,1,0.00006,48323,2.83120,1706803
1315,sghall,1,0.00006,48324,2.83126,1706803
1316,Sharpie,1,0.00006,48325,2.83132,1706803
1317,shawnps,1,0.00006,48326,2.83138,1706803
1318,shaxbee,1,0.00006,48327,2.83143,1706803
1319,shin-,1,0.00006,48328,2.83149,1706803
1320,Shrugs,1,0.00006,48329,2.83155,1706803
1321,siavashs,1,0.00006,48330,2.83161,1706803
1322,sidnei,1,0.00006,48331,2.83167,1706803
1323,Simon-Li,1,0.00006,48332,2.83173,1706803
1324,snowsky,1,0.00006,48333,2.83179,1706803
1325,solsson,1,0.00006,48334,2.83184,1706803
1326,sorenh,1,0.00006,48335,2.83190,1706803
1327,sourcesoft,1,0.00006,48336,2.83196,1706803
1328,srijs,1,0.00006,48337,2.83202,1706803
1329,stapelberg,1,0.00006,48338,2.83208,1706803
1330,stefanhendriks,1,0.00006,48339,2.83214,1706803
1331,stepancheg,1,0.00006,48340,2.83220,1706803
1332,stevemcquaid,1,0.00006,48341,2.83225,1706803
1333,stkevintan,1,0.00006,48342,2.83231,1706803
1334,stmcginnis,1,0.00006,48343,2.83237,1706803
1335,SummerWish,1,0.00006,48344,2.83243,1706803
1336,superbrothers,1,0.00006,48345,2.83249,1706803
1337,superhighfives,1,0.00006,48346,2.83255,1706803
1338,suryagaddipati,1,0.00006,48347,2.83261,1706803
1339,suside,1,0.00006,48348,2.83266,1706803
1340,svenefftinge,1,0.00006,48349,2.83272,1706803
1341,sylwit,1,0.00006,48350,2.83278,1706803
1342,sym3tri,1,0.00006,48351,2.83284,1706803
1343,Tahler,1,0.00006,48352,2.83290,1706803
1344,tcyrus,1,0.00006,48353,2.83296,1706803
1345,techdragon,1,0.00006,48354,2.83302,1706803
1346,tedli,1,0.00006,48355,2.83307,1706803
1347,tedmiston,1,0.00006,48356,2.83313,1706803
1348,thomaschaaf,1,0.00006,48357,2.83319,1706803
1349,thuey,1,0.00006,48358,2.83325,1706803
1350,tianhuil,1,0.00006,48359,2.83331,1706803
1351,t-miyake,1,0.00006,48360,2.83337,1706803
1352,tobilarscheid,1,0.00006,48361,2.83343,1706803
1353,tomwganem,1,0.00006,48362,2.83348,1706803
1354,tonycapone,1,0.00006,48363,2.83354,1706803
1355,tothandras,1,0.00006,48364,2.83360,1706803
1356,tpounds,1,0.00006,48365,2.83366,1706803
1357,tr33house,1,0.00006,48366,2.83372,1706803
1358,treyhyde,1,0.00006,48367,2.83378,1706803
1359,trofi,1,0.00006,48368,2.83384,1706803
1360,tslater,1,0.00006,48369,2.83389,1706803
1361,tsufiev,1,0.00006,48370,2.83395,1706803
1362,turb,1,0.00006,48371,2.83401,1706803
1363,TurboTim,1,0.00006,48372,2.83407,1706803
1364,typingduck,1,0.00006,48373,2.83413,1706803
1365,umayr,1,0.00006,48374,2.83419,1706803
1366,uzilan,1,0.00006,48375,2.83425,1706803
1367,vadimeisenbergibm,1,0.00006,48376,2.83430,1706803
1368,veblush,1,0.00006,48377,2.83436,1706803
1369,victorboissiere,1,0.00006,48378,2.83442,1706803
1370,vietj,1,0.00006,48379,2.83448,1706803
1371,vitalyisaev2,1,0.00006,48380,2.83454,1706803
1372,vongohren,1,0.00006,48381,2.83460,1706803
1373,wbrefvem,1,0.00006,48382,2.83466,1706803
1374,WGautier,1,0.00006,48383,2.83471,1706803
1375,wolfs,1,0.00006,48384,2.83477,1706803
1376,woosley,1,0.00006,48385,2.83483,1706803
1377,workmaster2n,1,0.00006,48386,2.83489,1706803
1378,wu-sheng,1,0.00006,48387,2.83495,1706803
1379,x1957,1,0.00006,48388,2.83501,1706803
1380,xerial,1,0.00006,48389,2.83507,1706803
1381,xinyanmsft,1,0.00006,48390,2.83513,1706803
1382,yanyixing,1,0.00006,48391,2.83518,1706803
1383,yaojingguo,1,0.00006,48392,2.83524,1706803
1384,yaronr,1,0.00006,48393,2.83530,1706803
1385,yissachar,1,0.00006,48394,2.83536,1706803
1386,yowakita,1,0.00006,48395,2.83542,1706803
1387,ytan29,1,0.00006,48396,2.83548,1706803
1388,zcwang,1,0.00006,48397,2.83554,1706803
1389,zhe,1,0.00006,48398,2.83559,1706803
1390,zhexuany,1,0.00006,48399,2.83565,1706803
