rank_number,actor,contributions,percent,cumulative_sum,cumulative_percent,all_contributions
1,stephentoub,66681,3.90209,66681,3.90209,1708855
2,mhevery,44279,2.59115,110960,6.49324,1708855
3,levitte,29535,1.72835,140495,8.22159,1708855
4,gaearon,22638,1.32475,163133,9.54633,1708855
5,IgorMinar,20900,1.22304,184033,10.76937,1708855
6,danmosemsft,19782,1.15762,203815,11.92699,1708855
7,gkalpak,19677,1.15147,223492,13.07846,1708855
8,matsko,17174,1.00500,240666,14.08347,1708855
9,petebacondarwin,16126,0.94367,256792,15.02714,1708855
10,kara,15992,0.93583,272784,15.96297,1708855
11,mattcaswell,15933,0.93238,288717,16.89535,1708855
12,tagliala,15920,0.93162,304637,17.82697,1708855
13,mdo,15866,0.92846,320503,18.75542,1708855
14,pkozlowski-opensource,14745,0.86286,335248,19.61828,1708855
15,vicb,14559,0.85197,349807,20.47026,1708855
16,alxhub,14504,0.84876,364311,21.31901,1708855
17,richsalz,14343,0.83933,378654,22.15835,1708855
18,jdalton,13963,0.81710,392617,22.97544,1708855
19,dougwilson,12990,0.76016,405607,23.73560,1708855
20,XhmikosR,12889,0.75425,418496,24.48985,1708855
21,cowtowncoder,12344,0.72236,430840,25.21220,1708855
22,karelz,11229,0.65711,442069,25.86931,1708855
23,AndrewKushnir,10746,0.62884,452815,26.49815,1708855
24,weshaggard,10688,0.62545,463503,27.12360,1708855
25,bartonjs,10342,0.60520,473845,27.72880,1708855
26,CharliePoole,10280,0.60157,484125,28.33037,1708855
27,davidsh,10148,0.59385,494273,28.92422,1708855
28,cvrebert,9777,0.57214,504050,29.49636,1708855
29,Narretz,9605,0.56207,513655,30.05843,1708855
30,alexeagle,8806,0.51532,522461,30.57375,1708855
31,jkotas,8232,0.48173,530693,31.05547,1708855
32,ericstj,8164,0.47775,538857,31.53322,1708855
33,ViktorHofer,8028,0.46979,546885,32.00301,1708855
34,timdorr,7734,0.45258,554619,32.45559,1708855
35,ahsonkhan,7709,0.45112,562328,32.90671,1708855
36,safern,6967,0.40770,569295,33.31441,1708855
37,tbosch,6748,0.39488,576043,33.70930,1708855
38,lrytz,6337,0.37083,582380,34.08013,1708855
39,jnm2,6250,0.36574,588630,34.44587,1708855
40,zpao,6077,0.35562,594707,34.80149,1708855
41,spicyj,5897,0.34508,600604,35.14657,1708855
42,tarekgh,5811,0.34005,606415,35.48663,1708855
43,retronym,5799,0.33935,612214,35.82598,1708855
44,Johann-S,5613,0.32847,617827,36.15444,1708855
45,adriaanm,5590,0.32712,623417,36.48156,1708855
46,rprouse,5441,0.31840,628858,36.79996,1708855
47,mellinoe,5420,0.31717,634278,37.11713,1708855
48,bvaughn,5139,0.30073,639417,37.41786,1708855
49,xzyfer,5109,0.29897,644526,37.71683,1708855
50,Lukasa,5045,0.29523,649571,38.01206,1708855
51,patrickhlauke,4865,0.28469,654436,38.29675,1708855
52,joperezr,4831,0.28270,659267,38.57946,1708855
53,JeremyKuhne,4804,0.28112,664071,38.86058,1708855
54,sebmarkbage,4483,0.26234,668554,39.12292,1708855
55,epoberezkin,4482,0.26228,673036,39.38520,1708855
56,SethTisue,4416,0.25842,677452,39.64362,1708855
57,JamesNK,4262,0.24941,681714,39.89303,1708855
58,ianhays,4046,0.23677,685760,40.12979,1708855
59,mgol,3921,0.22945,689681,40.35925,1708855
60,zloirock,3793,0.22196,693474,40.58121,1708855
61,acdlite,3765,0.22032,697239,40.80153,1708855
62,Priya91,3719,0.21763,700958,41.01916,1708855
63,christopherthielen,3706,0.21687,704664,41.23603,1708855
64,krwq,3702,0.21664,708366,41.45267,1708855
65,geoffkizer,3637,0.21283,712003,41.66550,1708855
66,bgrainger,3586,0.20985,715589,41.87535,1708855
67,jasonaden,3579,0.20944,719168,42.08479,1708855
68,CIPop,3435,0.20101,722603,42.28580,1708855
69,vsavkin,3278,0.19182,725881,42.47762,1708855
70,bcoe,3224,0.18866,729105,42.66629,1708855
71,wfurt,3180,0.18609,732285,42.85238,1708855
72,JiaLiPassion,3145,0.18404,735430,43.03642,1708855
73,benaadams,3062,0.17918,738492,43.21560,1708855
74,steveharter,3059,0.17901,741551,43.39461,1708855
75,knalli,3054,0.17872,744605,43.57333,1708855
76,MartijnCuppens,2903,0.16988,747508,43.74321,1708855
77,aweary,2876,0.16830,750384,43.91151,1708855
78,ellismg,2871,0.16801,753255,44.07952,1708855
79,ariya,2855,0.16707,756110,44.24659,1708855
80,tannergooding,2826,0.16537,758936,44.41196,1708855
81,timmywil,2812,0.16455,761748,44.57651,1708855
82,saurabh500,2802,0.16397,764550,44.74048,1708855
83,cpovirk,2782,0.16280,767332,44.90328,1708855
84,dmethvin,2745,0.16063,770077,45.06392,1708855
85,aearly,2652,0.15519,772729,45.21911,1708855
86,sindresorhus,2646,0.15484,775375,45.37395,1708855
87,mj1856,2633,0.15408,778008,45.52803,1708855
88,patrickkettner,2498,0.14618,780506,45.67421,1708855
89,VSadov,2491,0.14577,782997,45.81998,1708855
90,chuckjaz,2450,0.14337,785447,45.96335,1708855
91,nhunzaker,2411,0.14109,787858,46.10444,1708855
92,Anipik,2381,0.13933,790239,46.24377,1708855
93,mmitche,2360,0.13810,792599,46.38188,1708855
94,maxokorokov,2321,0.13582,794920,46.51770,1708855
95,nguerrera,2294,0.13424,797214,46.65194,1708855
96,petkaantonov,2283,0.13360,799497,46.78554,1708855
97,ocombe,2230,0.13050,801727,46.91603,1708855
98,shmao,2224,0.13015,803951,47.04618,1708855
99,vikerman,2185,0.12786,806136,47.17404,1708855
100,megawac,2169,0.12693,808305,47.30097,1708855
101,markerikson,2146,0.12558,810451,47.42655,1708855
102,kaduk,2110,0.12347,812561,47.55003,1708855
103,ljharb,2109,0.12342,814670,47.67344,1708855
104,wtgodbe,2105,0.12318,816775,47.79662,1708855
105,benjamingr,2079,0.12166,818854,47.91828,1708855
106,lgalfaso,2072,0.12125,820926,48.03954,1708855
107,davidfowl,2049,0.11990,822975,48.15944,1708855
108,jeffbcross,2042,0.11950,825017,48.27894,1708855
109,scottgonzalez,2016,0.11797,827033,48.39691,1708855
110,slontis,1965,0.11499,828998,48.51190,1708855
111,mzgol,1944,0.11376,830942,48.62566,1708855
112,crisbeto,1928,0.11282,832870,48.73848,1708855
113,sigmavirus24,1899,0.11113,834769,48.84961,1708855
114,isaacs,1868,0.10931,836637,48.95892,1708855
115,indexzero,1853,0.10844,838490,49.06736,1708855
116,tmds,1843,0.10785,840333,49.17521,1708855
117,markelog,1829,0.10703,842162,49.28224,1708855
118,eerhardt,1826,0.10686,843988,49.38909,1708855
119,gibson042,1815,0.10621,845803,49.49531,1708855
120,joshfree,1808,0.10580,847611,49.60111,1708855
121,mjackson,1686,0.09866,849297,49.69977,1708855
122,DataTables,1685,0.09860,850982,49.79837,1708855
123,tmshort,1682,0.09843,852664,49.89680,1708855
124,rkirov,1600,0.09363,854264,49.99043,1708855
125,am11,1592,0.09316,855856,50.08359,1708855
126,rspilker,1571,0.09193,857427,50.17553,1708855
127,cgdecker,1566,0.09164,858993,50.26717,1708855
128,terrajobst,1564,0.09152,860557,50.35869,1708855
129,kapunahelewong,1556,0.09106,862113,50.44975,1708855
130,trueadm,1512,0.08848,863625,50.53823,1708855
131,szeiger,1511,0.08842,865136,50.62665,1708855
132,mprobst,1473,0.08620,866609,50.71285,1708855
133,pjanotti,1467,0.08585,868076,50.79869,1708855
134,JoostK,1457,0.08526,869533,50.88395,1708855
135,yjbanov,1452,0.08497,870985,50.96892,1708855
136,filipesilva,1430,0.08368,872415,51.05261,1708855
137,marwahaha,1405,0.08222,873820,51.13482,1708855
138,KrzysztofCwalina,1398,0.08181,875218,51.21663,1708855
139,nschonni,1381,0.08081,876599,51.29745,1708855
140,MattGal,1372,0.08029,877971,51.37774,1708855
141,jelbourn,1365,0.07988,879336,51.45761,1708855
142,tmat,1339,0.07836,880675,51.53597,1708855
143,kkirsche,1337,0.07824,882012,51.61421,1708855
144,kennethreitz,1332,0.07795,883344,51.69216,1708855
145,juliemr,1320,0.07724,884664,51.76940,1708855
146,jbedard,1293,0.07566,885957,51.84507,1708855
147,alan-agius4,1262,0.07385,887219,51.91892,1708855
148,jbogarthyde,1235,0.07227,888454,51.99119,1708855
149,caitp,1231,0.07204,889685,52.06322,1708855
150,GrabYourPitchforks,1191,0.06970,890876,52.13292,1708855
151,maggiepint,1189,0.06958,892065,52.20250,1708855
152,maryamariyan,1189,0.06958,893254,52.27208,1708855
153,jzaefferer,1186,0.06940,894440,52.34148,1708855
154,kegluneq,1178,0.06894,895618,52.41042,1708855
155,corivera,1152,0.06741,896770,52.47783,1708855
156,Qix-,1149,0.06724,897919,52.54507,1708855
157,chcosta,1137,0.06654,899056,52.61160,1708855
158,rzwitserloot,1117,0.06537,900173,52.67697,1708855
159,hueniverse,1109,0.06490,901282,52.74187,1708855
160,ceki,1076,0.06297,902358,52.80483,1708855
161,rmkerr,1071,0.06267,903429,52.86750,1708855
162,AlexGhiondea,1064,0.06226,904493,52.92977,1708855
163,flarnie,1037,0.06068,905530,52.99045,1708855
164,kouvel,1026,0.06004,906556,53.05049,1708855
165,calvinmetcalf,1022,0.05981,907578,53.11030,1708855
166,ericeil,1003,0.05869,908581,53.16899,1708855
167,vancem,990,0.05793,909571,53.22693,1708855
168,broofa,986,0.05770,910557,53.28463,1708855
169,gdi2290,974,0.05700,911531,53.34162,1708855
170,dagood,969,0.05670,912500,53.39833,1708855
171,Aweary,963,0.05635,913463,53.45468,1708855
172,mde,961,0.05624,914424,53.51092,1708855
173,nateabele,960,0.05618,915384,53.56710,1708855
174,mcollina,934,0.05466,916318,53.62175,1708855
175,ekasper,927,0.05425,917245,53.67600,1708855
176,bartdesmet,920,0.05384,918165,53.72984,1708855
177,bardiharborow,918,0.05372,919083,53.78356,1708855
178,dwijnand,904,0.05290,919987,53.83646,1708855
179,pgavlin,898,0.05255,920885,53.88901,1708855
180,gkhanna79,893,0.05226,921778,53.94126,1708855
181,rejas,890,0.05208,922668,53.99335,1708855
182,robmadole,883,0.05167,923551,54.04502,1708855
183,maxbeatty,877,0.05132,924428,54.09634,1708855
184,filipnavara,874,0.05115,925302,54.14748,1708855
185,davidben,861,0.05038,926163,54.19787,1708855
186,huanwu,861,0.05038,927024,54.24825,1708855
187,vijaykota,854,0.04997,927878,54.29823,1708855
188,wesleycho,843,0.04933,928721,54.34756,1708855
189,analog-nico,839,0.04910,929560,54.39666,1708855
190,mikkelbu,828,0.04845,930388,54.44511,1708855
191,jonschlinkert,823,0.04816,931211,54.49327,1708855
192,necolas,823,0.04816,932034,54.54143,1708855
193,kyliau,815,0.04769,932849,54.58913,1708855
194,janvorli,789,0.04617,933638,54.63530,1708855
195,gregmagolan,777,0.04547,934415,54.68077,1708855
196,chenkie,762,0.04459,935177,54.72536,1708855
197,davegandy,762,0.04459,935939,54.76995,1708855
198,DDvO,759,0.04442,936698,54.81436,1708855
199,PascalSchumacher,738,0.04319,937436,54.85755,1708855
200,ronshapiro,737,0.04313,938173,54.90068,1708855
201,benouat,715,0.04184,938888,54.94252,1708855
202,akoeplinger,710,0.04155,939598,54.98407,1708855
203,atscott,710,0.04155,940308,55.02562,1708855
204,morganbr,709,0.04149,941017,55.06711,1708855
205,jonathantneal,703,0.04114,941720,55.10824,1708855
206,ziluvatar,702,0.04108,942422,55.14933,1708855
207,JakeWharton,701,0.04102,943123,55.19035,1708855
208,sophiebits,696,0.04073,943819,55.23108,1708855
209,alexperovich,688,0.04026,944507,55.27134,1708855
210,pallavit,685,0.04009,945192,55.31142,1708855
211,t8m,673,0.03938,945865,55.35081,1708855
212,vjeux,644,0.03769,946509,55.38849,1708855
213,julienrf,640,0.03745,947149,55.42594,1708855
214,garydgregory,639,0.03739,947788,55.46334,1708855
215,mconnew,638,0.03733,948426,55.50067,1708855
216,kapilash,631,0.03693,949057,55.53760,1708855
217,phated,621,0.03634,949678,55.57394,1708855
218,ryanflorence,621,0.03634,950299,55.61028,1708855
219,marijnh,614,0.03593,950913,55.64621,1708855
220,diesalbla,607,0.03552,951520,55.68173,1708855
221,qmfrederik,580,0.03394,952100,55.71567,1708855
222,Petermarcu,570,0.03336,952670,55.74902,1708855
223,buyaa-n,565,0.03306,953235,55.78209,1708855
224,TimothyGu,562,0.03289,953797,55.81498,1708855
225,sameb,557,0.03259,954354,55.84757,1708855
226,kluever,547,0.03201,954901,55.87958,1708855
227,dwmw2,539,0.03154,955440,55.91112,1708855
228,hansl,537,0.03142,955977,55.94255,1708855
229,sdmaclea,534,0.03125,956511,55.97380,1708855
230,swankjesse,530,0.03101,957041,56.00481,1708855
231,lowasser,529,0.03096,957570,56.03577,1708855
232,sharwell,519,0.03037,958089,56.06614,1708855
233,brianrob,518,0.03031,958607,56.09645,1708855
234,AArnott,514,0.03008,959121,56.12653,1708855
235,jashkenas,510,0.02984,959631,56.15637,1708855
236,captbaritone,502,0.02938,960133,56.18575,1708855
237,layomia,499,0.02920,960632,56.21495,1708855
238,khdang,495,0.02897,961127,56.24392,1708855
239,ryanseddon,485,0.02838,961612,56.27230,1708855
240,caleblloyd,478,0.02797,962090,56.30027,1708855
241,britter,475,0.02780,962565,56.32807,1708855
242,geleems,475,0.02780,963040,56.35586,1708855
243,jfromaniello,473,0.02768,963513,56.38354,1708855
244,ok2c,473,0.02768,963986,56.41122,1708855
245,karajas,462,0.02704,964448,56.43826,1708855
246,lmolkova,456,0.02668,964904,56.46494,1708855
247,talbs,455,0.02663,965359,56.49157,1708855
248,MichalStrehovsky,454,0.02657,965813,56.51814,1708855
249,nexdrew,448,0.02622,966261,56.54435,1708855
250,chkal,438,0.02563,966699,56.56998,1708855
251,kevinb9n,436,0.02551,967135,56.59550,1708855
252,feross,432,0.02528,967567,56.62078,1708855
253,bendrucker,415,0.02429,967982,56.64506,1708855
254,mikeal,410,0.02399,968392,56.66906,1708855
255,cston,408,0.02388,968800,56.69293,1708855
256,NE-SmallTown,403,0.02358,969203,56.71651,1708855
257,koba04,397,0.02323,969600,56.73975,1708855
258,p-steuer,376,0.02200,969976,56.76175,1708855
259,josephperrott,375,0.02194,970351,56.78369,1708855
260,coliff,370,0.02165,970721,56.80535,1708855
261,ashtuchkin,361,0.02113,971082,56.82647,1708855
262,shrutigarg,360,0.02107,971442,56.84754,1708855
263,AaronRobinsonMSFT,356,0.02083,971798,56.86837,1708855
264,maririos,354,0.02072,972152,56.88909,1708855
265,jaredhanson,348,0.02036,972500,56.90945,1708855
266,jhendrixMSFT,339,0.01984,972839,56.92929,1708855
267,spericas,337,0.01972,973176,56.94901,1708855
268,smarter,311,0.01820,973487,56.96721,1708855
269,kinow,301,0.01761,973788,56.98482,1708855
270,luqunl,301,0.01761,974089,57.00244,1708855
271,mgechev,301,0.01761,974390,57.02005,1708855
272,maxrimue,288,0.01685,974678,57.03690,1708855
273,adamsitnik,278,0.01627,974956,57.05317,1708855
274,gunnarmorling,273,0.01598,975229,57.06915,1708855
275,tintoy,272,0.01592,975501,57.08507,1708855
276,fiigii,271,0.01586,975772,57.10092,1708855
277,SimenB,271,0.01586,976043,57.11678,1708855
278,jaredpar,264,0.01545,976307,57.13223,1708855
279,kkurni,260,0.01521,976567,57.14745,1708855
280,JedWatson,259,0.01516,976826,57.16260,1708855
281,RJPercival,259,0.01516,977085,57.17776,1708855
282,juliangruber,256,0.01498,977341,57.19274,1708855
283,icfantv,254,0.01486,977595,57.20760,1708855
284,xuwei-k,254,0.01486,977849,57.22247,1708855
285,venkat-raman251,252,0.01475,978101,57.23721,1708855
286,davkean,250,0.01463,978351,57.25184,1708855
287,rajansingh10,243,0.01422,978594,57.26606,1708855
288,mikem8361,241,0.01410,978835,57.28017,1708855
289,andrewseguin,238,0.01393,979073,57.29409,1708855
290,richlander,236,0.01381,979309,57.30791,1708855
291,sebbASF,234,0.01369,979543,57.32160,1708855
292,arekinath,231,0.01352,979774,57.33512,1708855
293,tomato42,229,0.01340,980003,57.34852,1708855
294,omajid,222,0.01299,980225,57.36151,1708855
295,mmalerba,218,0.01276,980443,57.37427,1708855
296,ramarag,217,0.01270,980660,57.38696,1708855
297,twsouthwick,215,0.01258,980875,57.39955,1708855
298,chirayuk,209,0.01223,981084,57.41178,1708855
299,kasiabulat,209,0.01223,981293,57.42401,1708855
300,mgravell,209,0.01223,981502,57.43624,1708855
301,Diego-Perez-Botero,202,0.01182,981704,57.44806,1708855
302,rahku,201,0.01176,981905,57.45982,1708855
303,ellenaua,199,0.01165,982104,57.47146,1708855
304,fbasso,199,0.01165,982303,57.48311,1708855
305,bep,196,0.01147,982499,57.49458,1708855
306,ronaldtse,196,0.01147,982695,57.50605,1708855
307,DrewScoggins,193,0.01129,982888,57.51734,1708855
308,Eilon,193,0.01129,983081,57.52864,1708855
309,graingert,192,0.01124,983273,57.53987,1708855
310,AndyAyersMS,189,0.01106,983462,57.55093,1708855
311,jrtom,188,0.01100,983650,57.56193,1708855
312,SGuyGe,180,0.01053,983830,57.57247,1708855
313,rjamet,176,0.01030,984006,57.58277,1708855
314,hqueue,175,0.01024,984181,57.59301,1708855
315,Daniel15,173,0.01012,984354,57.60313,1708855
316,jkoritzinsky,168,0.00983,984522,57.61296,1708855
317,blowdart,165,0.00966,984687,57.62262,1708855
318,felixfbecker,165,0.00966,984852,57.63227,1708855
319,netdpb,163,0.00954,985015,57.64181,1708855
320,jimcarley,162,0.00948,985177,57.65129,1708855
321,jorive,161,0.00942,985338,57.66071,1708855
322,naamunds,160,0.00936,985498,57.67008,1708855
323,noahfalk,158,0.00925,985656,57.67932,1708855
324,SedarG,158,0.00925,985814,57.68857,1708855
325,smile21prc,158,0.00925,985972,57.69782,1708855
326,cartermp,154,0.00901,986126,57.70683,1708855
327,dimo414,154,0.00901,986280,57.71584,1708855
328,simo5,153,0.00895,986433,57.72479,1708855
329,que-etc,152,0.00889,986585,57.73369,1708855
330,dsgouda,151,0.00884,986736,57.74252,1708855
331,hramos,143,0.00837,986879,57.75089,1708855
332,leo,143,0.00837,987022,57.75926,1708855
333,adiaaida,142,0.00831,987164,57.76757,1708855
334,baulig,142,0.00831,987306,57.77588,1708855
335,andschwa,141,0.00825,987447,57.78413,1708855
336,tatsuhiro-t,135,0.00790,987582,57.79203,1708855
337,mairaw,133,0.00778,987715,57.79981,1708855
338,AntonLapounov,131,0.00767,987846,57.80748,1708855
339,sebastienros,131,0.00767,987977,57.81515,1708855
340,Krinkle,129,0.00755,988106,57.82269,1708855
341,Akretsch,126,0.00737,988232,57.83007,1708855
342,divdavem,126,0.00737,988358,57.83744,1708855
343,jansupol,126,0.00737,988484,57.84481,1708855
344,davidmakepeace,124,0.00726,988608,57.85207,1708855
345,glebm,123,0.00720,988731,57.85927,1708855
346,tunniclm,122,0.00714,988853,57.86641,1708855
347,JohnTortugo,121,0.00708,988974,57.87349,1708855
348,nglorioso,121,0.00708,989095,57.88057,1708855
349,alex,120,0.00702,989215,57.88759,1708855
350,vitek-karas,120,0.00702,989335,57.89461,1708855
351,Lausselloic,117,0.00685,989452,57.90146,1708855
352,StephenBonikowsky,116,0.00679,989568,57.90825,1708855
353,hseok-oh,115,0.00673,989683,57.91498,1708855
354,lontis,114,0.00667,989797,57.92165,1708855
355,josguil,110,0.00644,989907,57.92809,1708855
356,jcagme,109,0.00638,990016,57.93446,1708855
357,tiran,109,0.00638,990125,57.94084,1708855
358,BruceForstall,108,0.00632,990233,57.94716,1708855
359,KKhurin,108,0.00632,990341,57.95348,1708855
360,netomi,106,0.00620,990447,57.95969,1708855
361,cwe1ss,105,0.00614,990552,57.96583,1708855
362,chtompki,104,0.00609,990656,57.97192,1708855
363,Artazor,103,0.00603,990759,57.97794,1708855
364,hann013,103,0.00603,990862,57.98397,1708855
365,stevelinsell,103,0.00603,990965,57.99000,1708855
366,adityamandaleeka,102,0.00597,991067,57.99597,1708855
367,jmrodri,102,0.00597,991169,58.00194,1708855
368,kunalspathak,102,0.00597,991271,58.00791,1708855
369,YingP99,102,0.00597,991373,58.01387,1708855
370,leecow,101,0.00591,991474,58.01979,1708855
371,JustinBeckwith,99,0.00579,991573,58.02558,1708855
372,nslottow,98,0.00573,991671,58.03131,1708855
373,BrennanConroy,97,0.00568,991768,58.03699,1708855
374,jeffschwMSFT,97,0.00568,991865,58.04267,1708855
375,jsoref,95,0.00556,991960,58.04823,1708855
376,jyoungyun,95,0.00556,992055,58.05378,1708855
377,dsplaisted,94,0.00550,992149,58.05929,1708855
378,RReverser,94,0.00550,992243,58.06479,1708855
379,agocke,92,0.00538,992335,58.07017,1708855
380,mureinik,91,0.00533,992426,58.07549,1708855
381,swgillespie,90,0.00527,992516,58.08076,1708855
382,jcrugzz,89,0.00521,992605,58.08597,1708855
383,lajones,89,0.00521,992694,58.09118,1708855
384,dcwuser,88,0.00515,992782,58.09633,1708855
385,gregw,86,0.00503,992868,58.10136,1708855
386,crummel,84,0.00492,992952,58.10628,1708855
387,jon-oracle,84,0.00492,993036,58.11119,1708855
388,tinayuangao,84,0.00492,993120,58.11611,1708855
389,ruippeixotog,82,0.00480,993202,58.12091,1708855
390,davidwrighton,81,0.00474,993283,58.12565,1708855
391,iamjasonp,81,0.00474,993364,58.13039,1708855
392,jcdickinson,81,0.00474,993445,58.13513,1708855
393,jskeet,81,0.00474,993526,58.13987,1708855
394,chlowell,80,0.00468,993606,58.14455,1708855
395,gbalykov,80,0.00468,993686,58.14923,1708855
396,roncain,80,0.00468,993766,58.15391,1708855
397,JimboWei,79,0.00462,993845,58.15853,1708855
398,bloodyowl,77,0.00451,993922,58.16304,1708855
399,Atry,74,0.00433,993996,58.16737,1708855
400,pharring,74,0.00433,994070,58.17170,1708855
401,awaterma,73,0.00427,994143,58.17597,1708855
402,chonton,73,0.00427,994216,58.18024,1708855
403,evqna,73,0.00427,994289,58.18452,1708855
404,PeterDaveHello,73,0.00427,994362,58.18879,1708855
405,robdodson,73,0.00427,994435,58.19306,1708855
406,sam-github,72,0.00421,994507,58.19727,1708855
407,Sridhar-MS,72,0.00421,994579,58.20149,1708855
408,mjrousos,71,0.00415,994650,58.20564,1708855
409,cheenamalhotra,69,0.00404,994719,58.20968,1708855
410,gafter,69,0.00404,994788,58.21372,1708855
411,pgovind,69,0.00404,994857,58.21775,1708855
412,reaperhulk,69,0.00404,994926,58.22179,1708855
413,yoshuawuyts,69,0.00404,994995,58.22583,1708855
414,josalem,68,0.00398,995063,58.22981,1708855
415,leemgs,68,0.00398,995131,58.23379,1708855
416,monkindey,68,0.00398,995199,58.23777,1708855
417,swaroop-sridhar,68,0.00398,995267,58.24175,1708855
418,zertosh,67,0.00392,995334,58.24567,1708855
419,Chrisboh,66,0.00386,995400,58.24953,1708855
420,markt-asf,66,0.00386,995466,58.25339,1708855
421,SteveL-MSFT,66,0.00386,995532,58.25725,1708855
422,wateret,66,0.00386,995598,58.26112,1708855
423,dstufft,65,0.00380,995663,58.26492,1708855
424,leebyron,65,0.00380,995728,58.26872,1708855
425,rainersigwald,65,0.00380,995793,58.27253,1708855
426,Haroenv,64,0.00375,995857,58.27627,1708855
427,jamesgeorge007,64,0.00375,995921,58.28002,1708855
428,AlfredoMS,63,0.00369,995984,58.28370,1708855
429,briansmith,63,0.00369,996047,58.28739,1708855
430,kevinburke,63,0.00369,996110,58.29108,1708855
431,Lekensteyn,63,0.00369,996173,58.29476,1708855
432,olalonde,63,0.00369,996236,58.29845,1708855
433,qizhanMS,63,0.00369,996299,58.30214,1708855
434,ChadNedzlek,62,0.00363,996361,58.30577,1708855
435,haf,62,0.00363,996423,58.30939,1708855
436,aeijdenberg,61,0.00357,996484,58.31296,1708855
437,epeli,61,0.00357,996545,58.31653,1708855
438,pprindeville,61,0.00357,996606,58.32010,1708855
439,vladak,60,0.00351,996666,58.32361,1708855
440,edevil,59,0.00345,996725,58.32707,1708855
441,MichaelSimons,59,0.00345,996784,58.33052,1708855
442,stash-sfdc,57,0.00334,996841,58.33386,1708855
443,agrandi,56,0.00328,996897,58.33713,1708855
444,Jozkee,56,0.00328,996953,58.34041,1708855
445,SergeyKanzhelev,56,0.00328,997009,58.34369,1708855
446,erozenfeld,55,0.00322,997064,58.34690,1708855
447,orta,55,0.00322,997119,58.35012,1708855
448,bjjones,54,0.00316,997173,58.35328,1708855
449,krosenvold,54,0.00316,997227,58.35644,1708855
450,stevenbrix,54,0.00316,997281,58.35960,1708855
451,agl,53,0.00310,997334,58.36270,1708855
452,davmason,53,0.00310,997387,58.36581,1708855
453,dsblv,53,0.00310,997440,58.36891,1708855
454,frozencemetery,53,0.00310,997493,58.37201,1708855
455,notrab,53,0.00310,997546,58.37511,1708855
456,bshannon,52,0.00304,997598,58.37815,1708855
457,gabrielschulhof,52,0.00304,997650,58.38120,1708855
458,goderbauer,52,0.00304,997702,58.38424,1708855
459,AlekseyTs,51,0.00298,997753,58.38722,1708855
460,CodingFabian,51,0.00298,997804,58.39021,1708855
461,riarenas,51,0.00298,997855,58.39319,1708855
462,Lxiamail,50,0.00293,997905,58.39612,1708855
463,mpeylo,50,0.00293,997955,58.39904,1708855
464,michael-o,49,0.00287,998004,58.40191,1708855
465,ravimeda,49,0.00287,998053,58.40478,1708855
466,thomas-mcdonald,49,0.00287,998102,58.40765,1708855
467,tquerec,49,0.00287,998151,58.41051,1708855
468,daxian-dbw,48,0.00281,998199,58.41332,1708855
469,just-boris,48,0.00281,998247,58.41613,1708855
470,specio,48,0.00281,998295,58.41894,1708855
471,billwert,47,0.00275,998342,58.42169,1708855
472,ciz,47,0.00275,998389,58.42444,1708855
473,dseefeld,47,0.00275,998436,58.42719,1708855
474,stuartwdouglas,47,0.00275,998483,58.42994,1708855
475,jayaram-intel,45,0.00263,998528,58.43258,1708855
476,KyleAMathews,45,0.00263,998573,58.43521,1708855
477,fritx,44,0.00257,998617,58.43778,1708855
478,lpereira,44,0.00257,998661,58.44036,1708855
479,moozzyk,44,0.00257,998705,58.44293,1708855
480,nbilling,44,0.00257,998749,58.44551,1708855
481,brahmnes,43,0.00252,998792,58.44803,1708855
482,IlyaBiryukov,43,0.00252,998835,58.45054,1708855
483,imcarolwang,43,0.00252,998878,58.45306,1708855
484,lukesandberg,43,0.00252,998921,58.45557,1708855
485,martinheidegger,43,0.00252,998964,58.45809,1708855
486,MattWhilden,43,0.00252,999007,58.46061,1708855
487,asoldano,42,0.00246,999049,58.46306,1708855
488,JounQin,42,0.00246,999091,58.46552,1708855
489,tarikulsabbir,42,0.00246,999133,58.46798,1708855
490,waywardgeek,42,0.00246,999175,58.47044,1708855
491,zbjornson,42,0.00246,999217,58.47290,1708855
492,333fred,41,0.00240,999258,58.47529,1708855
493,ofrobots,41,0.00240,999299,58.47769,1708855
494,sywhang,41,0.00240,999340,58.48009,1708855
495,t-8ch,40,0.00234,999380,58.48243,1708855
496,DnlHarvey,39,0.00228,999419,58.48472,1708855
497,echesakovMSFT,39,0.00228,999458,58.48700,1708855
498,elharo,39,0.00228,999497,58.48928,1708855
499,meteorcloudy,39,0.00228,999536,58.49156,1708855
500,tgriesser,39,0.00228,999575,58.49385,1708855
501,trevorlinton,39,0.00228,999614,58.49613,1708855
502,mschoudry,38,0.00222,999652,58.49835,1708855
503,Huachao,37,0.00217,999689,58.50052,1708855
504,nymanjens,37,0.00217,999726,58.50268,1708855
505,csvn,36,0.00211,999762,58.50479,1708855
506,ide,36,0.00211,999798,58.50689,1708855
507,jashook,36,0.00211,999834,58.50900,1708855
508,sfackler,36,0.00211,999870,58.51111,1708855
509,calebmer,35,0.00205,999905,58.51316,1708855
510,ericelliott,35,0.00205,999940,58.51520,1708855
511,kenneth-reitz,35,0.00205,999975,58.51725,1708855
512,bmeurer,34,0.00199,1000009,58.51924,1708855
513,gregg-miskelly,34,0.00199,1000043,58.52123,1708855
514,langpavel,34,0.00199,1000077,58.52322,1708855
515,LokeshN,34,0.00199,1000111,58.52521,1708855
516,reda-alaoui,34,0.00199,1000145,58.52720,1708855
517,vslinko,34,0.00199,1000179,58.52919,1708855
518,Dmitri-Botcharnikov,33,0.00193,1000212,58.53112,1708855
519,Eddman,33,0.00193,1000245,58.53305,1708855
520,kachkaev,33,0.00193,1000278,58.53498,1708855
521,mrmlnc,33,0.00193,1000311,58.53692,1708855
522,nertzy,33,0.00193,1000344,58.53885,1708855
523,steelbrain,33,0.00193,1000377,58.54078,1708855
524,chunseoklee,32,0.00187,1000409,58.54265,1708855
525,cshung,32,0.00187,1000441,58.54452,1708855
526,edmorley,32,0.00187,1000473,58.54640,1708855
527,ghatwala,32,0.00187,1000505,58.54827,1708855
528,shrah,32,0.00187,1000537,58.55014,1708855
529,thomasmey,32,0.00187,1000569,58.55201,1708855
530,AmazingJaze,31,0.00181,1000600,58.55383,1708855
531,rahulkotecha,31,0.00181,1000631,58.55564,1708855
532,cortopy,30,0.00176,1000661,58.55740,1708855
533,dreddy-work,30,0.00176,1000691,58.55915,1708855
534,hoyMS,30,0.00176,1000721,58.56091,1708855
535,kgoldman,30,0.00176,1000751,58.56266,1708855
536,mcandre,30,0.00176,1000781,58.56442,1708855
537,ScrapCodes,30,0.00176,1000811,58.56617,1708855
538,eamonnmcmanus,29,0.00170,1000840,58.56787,1708855
539,erikerlandson,29,0.00170,1000869,58.56957,1708855
540,JunTaoLuo,29,0.00170,1000898,58.57127,1708855
541,koto,29,0.00170,1000927,58.57296,1708855
542,ricokahler,29,0.00170,1000956,58.57466,1708855
543,felixbuenemann,28,0.00164,1000984,58.57630,1708855
544,Freyert,28,0.00164,1001012,58.57794,1708855
545,grooverdan,28,0.00164,1001040,58.57958,1708855
546,jakkdu,28,0.00164,1001068,58.58121,1708855
547,jtattermusch,28,0.00164,1001096,58.58285,1708855
548,jvz,28,0.00164,1001124,58.58449,1708855
549,krotscheck,28,0.00164,1001152,58.58613,1708855
550,LoicMahieu,28,0.00164,1001180,58.58777,1708855
551,lucenticus,28,0.00164,1001208,58.58941,1708855
552,motiz88,28,0.00164,1001236,58.59104,1708855
553,mrpre,28,0.00164,1001264,58.59268,1708855
554,ruiaraujo,28,0.00164,1001292,58.59432,1708855
555,sjsinju,28,0.00164,1001320,58.59596,1708855
556,wincent,28,0.00164,1001348,58.59760,1708855
557,adorokhine,27,0.00158,1001375,58.59918,1708855
558,dciccale,27,0.00158,1001402,58.60076,1708855
559,fredsa,27,0.00158,1001429,58.60234,1708855
560,jeremycline,27,0.00158,1001456,58.60392,1708855
561,josephsavona,27,0.00158,1001483,58.60550,1708855
562,YongseopKim,27,0.00158,1001510,58.60708,1708855
563,A-And,26,0.00152,1001536,58.60860,1708855
564,jonfortescue,26,0.00152,1001562,58.61012,1708855
565,Pothulapati,26,0.00152,1001588,58.61164,1708855
566,sjanuary,26,0.00152,1001614,58.61316,1708855
567,dminkovsky,25,0.00146,1001639,58.61463,1708855
568,ebourg,25,0.00146,1001664,58.61609,1708855
569,gitter-badger,25,0.00146,1001689,58.61755,1708855
570,Globegitter,25,0.00146,1001714,58.61902,1708855
571,huntc,25,0.00146,1001739,58.62048,1708855
572,ilovett,25,0.00146,1001764,58.62194,1708855
573,JensRantil,25,0.00146,1001789,58.62341,1708855
574,JohnVillalovos,25,0.00146,1001814,58.62487,1708855
575,nickdesaulniers,25,0.00146,1001839,58.62633,1708855
576,pra85,25,0.00146,1001864,58.62779,1708855
577,rgbkrk,25,0.00146,1001889,58.62926,1708855
578,seanshpark,25,0.00146,1001914,58.63072,1708855
579,tbroadley,25,0.00146,1001939,58.63218,1708855
580,terinjokes,25,0.00146,1001964,58.63365,1708855
581,TimLovellSmith,25,0.00146,1001989,58.63511,1708855
582,cjihrig,24,0.00140,1002013,58.63651,1708855
583,ericsoderberghp,24,0.00140,1002037,58.63792,1708855
584,matthauck,24,0.00140,1002061,58.63932,1708855
585,mike-marcacci,24,0.00140,1002085,58.64073,1708855
586,rmannibucau,24,0.00140,1002109,58.64213,1708855
587,tcurdt,24,0.00140,1002133,58.64354,1708855
588,v-yanbgu,24,0.00140,1002157,58.64494,1708855
589,AloisMahdal,23,0.00135,1002180,58.64629,1708855
590,bimargulies,23,0.00135,1002203,58.64763,1708855
591,cgruber,23,0.00135,1002226,58.64898,1708855
592,jozefizso,23,0.00135,1002249,58.65032,1708855
593,kevinsimper,23,0.00135,1002272,58.65167,1708855
594,kolodny,23,0.00135,1002295,58.65302,1708855
595,borekb,22,0.00129,1002317,58.65430,1708855
596,dead-horse,22,0.00129,1002339,58.65559,1708855
597,dpursehouse,22,0.00129,1002361,58.65688,1708855
598,Gregoirevda,22,0.00129,1002383,58.65817,1708855
599,leidegre,22,0.00129,1002405,58.65945,1708855
600,MaximRouiller,22,0.00129,1002427,58.66074,1708855
601,omeid,22,0.00129,1002449,58.66203,1708855
602,raboof,22,0.00129,1002471,58.66332,1708855
603,rwinch,22,0.00129,1002493,58.66460,1708855
604,sheerun,22,0.00129,1002515,58.66589,1708855
605,stone-li,22,0.00129,1002537,58.66718,1708855
606,Vanuan,22,0.00129,1002559,58.66847,1708855
607,adob,21,0.00123,1002580,58.66969,1708855
608,chentsulin,21,0.00123,1002601,58.67092,1708855
609,christianhuening,21,0.00123,1002622,58.67215,1708855
610,gsans,21,0.00123,1002643,58.67338,1708855
611,IvanGoncharov,21,0.00123,1002664,58.67461,1708855
612,KuraFire,21,0.00123,1002685,58.67584,1708855
613,rikles,21,0.00123,1002706,58.67707,1708855
614,ScottSWu,21,0.00123,1002727,58.67830,1708855
615,skfd,21,0.00123,1002748,58.67953,1708855
616,tiziano88,21,0.00123,1002769,58.68075,1708855
617,vlajos,21,0.00123,1002790,58.68198,1708855
618,aditya-shankar,20,0.00117,1002810,58.68315,1708855
619,danielnorberg,20,0.00117,1002830,58.68432,1708855
620,dongjoon-hyun,20,0.00117,1002850,58.68549,1708855
621,EdwardBetts,20,0.00117,1002870,58.68666,1708855
622,ExFlo,20,0.00117,1002890,58.68783,1708855
623,Jokero,20,0.00117,1002910,58.68901,1708855
624,lersek,20,0.00117,1002930,58.69018,1708855
625,monkey-mas,20,0.00117,1002950,58.69135,1708855
626,nikolas,20,0.00117,1002970,58.69252,1708855
627,noscripter,20,0.00117,1002990,58.69369,1708855
628,sschuberth,20,0.00117,1003010,58.69486,1708855
629,YourDeveloperFriend,20,0.00117,1003030,58.69603,1708855
630,zorrorffm,20,0.00117,1003050,58.69720,1708855
631,bkniffler,19,0.00111,1003069,58.69831,1708855
632,ido-ran,19,0.00111,1003088,58.69942,1708855
633,jochenw,19,0.00111,1003107,58.70053,1708855
634,jwilk,19,0.00111,1003126,58.70165,1708855
635,marlon360,19,0.00111,1003145,58.70276,1708855
636,meenie,19,0.00111,1003164,58.70387,1708855
637,rmg,19,0.00111,1003183,58.70498,1708855
638,robphoenix,19,0.00111,1003202,58.70609,1708855
639,startswithaj,19,0.00111,1003221,58.70720,1708855
640,victorhurdugaci,19,0.00111,1003240,58.70832,1708855
641,watson,19,0.00111,1003259,58.70943,1708855
642,bruno-garcia,18,0.00105,1003277,58.71048,1708855
643,brycecr,18,0.00105,1003295,58.71153,1708855
644,cesarandreu,18,0.00105,1003313,58.71259,1708855
645,davido,18,0.00105,1003331,58.71364,1708855
646,egor-n,18,0.00105,1003349,58.71469,1708855
647,feloy,18,0.00105,1003367,58.71575,1708855
648,hzamani,18,0.00105,1003385,58.71680,1708855
649,isnotinvain,18,0.00105,1003403,58.71785,1708855
650,MLoughry,18,0.00105,1003421,58.71891,1708855
651,nateq314,18,0.00105,1003439,58.71996,1708855
652,ppham27,18,0.00105,1003457,58.72101,1708855
653,slintes,18,0.00105,1003475,58.72207,1708855
654,avkonst,17,0.00099,1003492,58.72306,1708855
655,baer,17,0.00099,1003509,58.72406,1708855
656,brad4d,17,0.00099,1003526,58.72505,1708855
657,cushon,17,0.00099,1003543,58.72605,1708855
658,deki,17,0.00099,1003560,58.72704,1708855
659,gabelevi,17,0.00099,1003577,58.72804,1708855
660,github-cygwin,17,0.00099,1003594,58.72903,1708855
661,jameskyle,17,0.00099,1003611,58.73003,1708855
662,Kingwl,17,0.00099,1003628,58.73102,1708855
663,mixed,17,0.00099,1003645,58.73202,1708855
664,msmorgan,17,0.00099,1003662,58.73301,1708855
665,simonua,17,0.00099,1003679,58.73401,1708855
666,snakefoot,17,0.00099,1003696,58.73500,1708855
667,srawlins,17,0.00099,1003713,58.73600,1708855
668,sunandabalu,17,0.00099,1003730,58.73699,1708855
669,wuweiweiwu,17,0.00099,1003747,58.73799,1708855
670,zarenner,17,0.00099,1003764,58.73898,1708855
671,andyfleming,16,0.00094,1003780,58.73992,1708855
672,astorije,16,0.00094,1003796,58.74085,1708855
673,client9,16,0.00094,1003812,58.74179,1708855
674,davidmatson,16,0.00094,1003828,58.74273,1708855
675,fh1ch,16,0.00094,1003844,58.74366,1708855
676,gmile,16,0.00094,1003860,58.74460,1708855
677,ineuwirth,16,0.00094,1003876,58.74553,1708855
678,jadekler,16,0.00094,1003892,58.74647,1708855
679,jshoudy11,16,0.00094,1003908,58.74741,1708855
680,LucasSloan,16,0.00094,1003924,58.74834,1708855
681,macrozone,16,0.00094,1003940,58.74928,1708855
682,matthewloring,16,0.00094,1003956,58.75022,1708855
683,MichielDeMey,16,0.00094,1003972,58.75115,1708855
684,npmccallum,16,0.00094,1003988,58.75209,1708855
685,pjfanning,16,0.00094,1004004,58.75302,1708855
686,stuartpb,16,0.00094,1004020,58.75396,1708855
687,tmortagne,16,0.00094,1004036,58.75490,1708855
688,Urigo,16,0.00094,1004052,58.75583,1708855
689,alpencolt,15,0.00088,1004067,58.75671,1708855
690,armujahid,15,0.00088,1004082,58.75759,1708855
691,artem-smotrakov,15,0.00088,1004097,58.75847,1708855
692,benmccann,15,0.00088,1004112,58.75934,1708855
693,cminyard,15,0.00088,1004127,58.76022,1708855
694,CXuesong,15,0.00088,1004142,58.76110,1708855
695,demohi,15,0.00088,1004157,58.76198,1708855
696,eljefedelrodeodeljefe,15,0.00088,1004172,58.76286,1708855
697,ericedens,15,0.00088,1004187,58.76373,1708855
698,Kuroky360,15,0.00088,1004202,58.76461,1708855
699,mebigfatguy,15,0.00088,1004217,58.76549,1708855
700,ryysud,15,0.00088,1004232,58.76637,1708855
701,shimingsg,15,0.00088,1004247,58.76724,1708855
702,StarpTech,15,0.00088,1004262,58.76812,1708855
703,vbauer,15,0.00088,1004277,58.76900,1708855
704,cvle,14,0.00082,1004291,58.76982,1708855
705,delmyers,14,0.00082,1004305,58.77064,1708855
706,ecasilla,14,0.00082,1004319,58.77146,1708855
707,FGRibreau,14,0.00082,1004333,58.77228,1708855
708,gnomeontherun,14,0.00082,1004347,58.77310,1708855
709,gregturn,14,0.00082,1004361,58.77392,1708855
710,hmalphettes,14,0.00082,1004375,58.77474,1708855
711,jhaber,14,0.00082,1004389,58.77555,1708855
712,jimma,14,0.00082,1004403,58.77637,1708855
713,johnjbarton,14,0.00082,1004417,58.77719,1708855
714,KraigWalker,14,0.00082,1004431,58.77801,1708855
715,lyip1992,14,0.00082,1004445,58.77883,1708855
716,mbroz,14,0.00082,1004459,58.77965,1708855
717,nodkz,14,0.00082,1004473,58.78047,1708855
718,pavolloffay,14,0.00082,1004487,58.78129,1708855
719,RameshwarapuSanthosh,14,0.00082,1004501,58.78211,1708855
720,ryanbrandenburg,14,0.00082,1004515,58.78293,1708855
721,simonferquel,14,0.00082,1004529,58.78375,1708855
722,srl295,14,0.00082,1004543,58.78457,1708855
723,vaseker,14,0.00082,1004557,58.78539,1708855
724,adam-26,13,0.00076,1004570,58.78615,1708855
725,aheckmann,13,0.00076,1004583,58.78691,1708855
726,briananderson1222,13,0.00076,1004596,58.78767,1708855
727,BrunoQuaresma,13,0.00076,1004609,58.78843,1708855
728,fourcube,13,0.00076,1004622,58.78919,1708855
729,jermowery,13,0.00076,1004635,58.78995,1708855
730,jin,13,0.00076,1004648,58.79071,1708855
731,kaelig,13,0.00076,1004661,58.79147,1708855
732,kofemann,13,0.00076,1004674,58.79223,1708855
733,lukecwik,13,0.00076,1004687,58.79299,1708855
734,marob,13,0.00076,1004700,58.79375,1708855
735,mbrukman,13,0.00076,1004713,58.79451,1708855
736,mitchellwills,13,0.00076,1004726,58.79528,1708855
737,nvartolomei,13,0.00076,1004739,58.79604,1708855
738,oshalygin,13,0.00076,1004752,58.79680,1708855
739,puradox,13,0.00076,1004765,58.79756,1708855
740,ralphbean,13,0.00076,1004778,58.79832,1708855
741,ravishivt,13,0.00076,1004791,58.79908,1708855
742,rdsubhas,13,0.00076,1004804,58.79984,1708855
743,remram44,13,0.00076,1004817,58.80060,1708855
744,robcresswell,13,0.00076,1004830,58.80136,1708855
745,soulgalore,13,0.00076,1004843,58.80212,1708855
746,spacepluk,13,0.00076,1004856,58.80288,1708855
747,ulisesh,13,0.00076,1004869,58.80364,1708855
748,ahmetb,12,0.00070,1004881,58.80435,1708855
749,anarcat,12,0.00070,1004893,58.80505,1708855
750,arianf,12,0.00070,1004905,58.80575,1708855
751,Awk34,12,0.00070,1004917,58.80645,1708855
752,bgw,12,0.00070,1004929,58.80715,1708855
753,brendankenny,12,0.00070,1004941,58.80786,1708855
754,cclauss,12,0.00070,1004953,58.80856,1708855
755,CoffeeFlux,12,0.00070,1004965,58.80926,1708855
756,davidkarlsen,12,0.00070,1004977,58.80996,1708855
757,dcbrwn,12,0.00070,1004989,58.81067,1708855
758,devknoll,12,0.00070,1005001,58.81137,1708855
759,ericcurtin,12,0.00070,1005013,58.81207,1708855
760,hairyhenderson,12,0.00070,1005025,58.81277,1708855
761,jacobwgillespie,12,0.00070,1005037,58.81347,1708855
762,jakub-bochenski,12,0.00070,1005049,58.81418,1708855
763,jaredcnance,12,0.00070,1005061,58.81488,1708855
764,jeremejevs,12,0.00070,1005073,58.81558,1708855
765,jroper,12,0.00070,1005085,58.81628,1708855
766,karolz-ms,12,0.00070,1005097,58.81699,1708855
767,krmannix,12,0.00070,1005109,58.81769,1708855
768,mertdeg2,12,0.00070,1005121,58.81839,1708855
769,ojhad,12,0.00070,1005133,58.81909,1708855
770,PavelKopyl,12,0.00070,1005145,58.81979,1708855
771,peterhuene,12,0.00070,1005157,58.82050,1708855
772,plaes,12,0.00070,1005169,58.82120,1708855
773,randing89,12,0.00070,1005181,58.82190,1708855
774,richardweinberger,12,0.00070,1005193,58.82260,1708855
775,RinkAttendant6,12,0.00070,1005205,58.82331,1708855
776,samwgoldman,12,0.00070,1005217,58.82401,1708855
777,shiftkey,12,0.00070,1005229,58.82471,1708855
778,alexwlchan,11,0.00064,1005240,58.82535,1708855
779,alistair23,11,0.00064,1005251,58.82600,1708855
780,alokmenghrajani,11,0.00064,1005262,58.82664,1708855
781,amrocs,11,0.00064,1005273,58.82728,1708855
782,astrahov,11,0.00064,1005284,58.82793,1708855
783,bolinfest,11,0.00064,1005295,58.82857,1708855
784,connor4312,11,0.00064,1005306,58.82922,1708855
785,fatcerberus,11,0.00064,1005317,58.82986,1708855
786,fcamblor,11,0.00064,1005328,58.83050,1708855
787,felixonmars,11,0.00064,1005339,58.83115,1708855
788,icholy,11,0.00064,1005350,58.83179,1708855
789,ipuustin,11,0.00064,1005361,58.83243,1708855
790,jgangemi,11,0.00064,1005372,58.83308,1708855
791,jonasfj,11,0.00064,1005383,58.83372,1708855
792,joshuagl,11,0.00064,1005394,58.83437,1708855
793,MarSik,11,0.00064,1005405,58.83501,1708855
794,mhbseal,11,0.00064,1005416,58.83565,1708855
795,moander,11,0.00064,1005427,58.83630,1708855
796,msmeissn,11,0.00064,1005438,58.83694,1708855
797,normj,11,0.00064,1005449,58.83758,1708855
798,silentroach,11,0.00064,1005460,58.83823,1708855
799,thomaspink,11,0.00064,1005471,58.83887,1708855
800,vkvenkat,11,0.00064,1005482,58.83952,1708855
801,ygatesoupe,11,0.00064,1005493,58.84016,1708855
802,AlexZeitler,10,0.00059,1005503,58.84074,1708855
803,anpete,10,0.00059,1005513,58.84133,1708855
804,Bezier89,10,0.00059,1005523,58.84191,1708855
805,cemo,10,0.00059,1005533,58.84250,1708855
806,dgreensp,10,0.00059,1005543,58.84308,1708855
807,dlindenkreuz,10,0.00059,1005553,58.84367,1708855
808,dsyme,10,0.00059,1005563,58.84426,1708855
809,dyladan,10,0.00059,1005573,58.84484,1708855
810,fwbrasil,10,0.00059,1005583,58.84543,1708855
811,glasser,10,0.00059,1005593,58.84601,1708855
812,grant,10,0.00059,1005603,58.84660,1708855
813,hyandell,10,0.00059,1005613,58.84718,1708855
814,jamesward,10,0.00059,1005623,58.84777,1708855
815,jfigus,10,0.00059,1005633,58.84835,1708855
816,joshperry,10,0.00059,1005643,58.84894,1708855
817,kassens,10,0.00059,1005653,58.84952,1708855
818,kaycebasques,10,0.00059,1005663,58.85011,1708855
819,kkm000,10,0.00059,1005673,58.85069,1708855
820,lvarayut,10,0.00059,1005683,58.85128,1708855
821,mdonoughe,10,0.00059,1005693,58.85186,1708855
822,mikesamuel,10,0.00059,1005703,58.85245,1708855
823,pierre-b,10,0.00059,1005713,58.85303,1708855
824,r4j4h,10,0.00059,1005723,58.85362,1708855
825,rdodev,10,0.00059,1005733,58.85420,1708855
826,rictic,10,0.00059,1005743,58.85479,1708855
827,RobertKielty,10,0.00059,1005753,58.85537,1708855
828,ShivanKaul,10,0.00059,1005763,58.85596,1708855
829,sjackman,10,0.00059,1005773,58.85654,1708855
830,sumitbhagwani,10,0.00059,1005783,58.85713,1708855
831,vanessanschmitt,10,0.00059,1005793,58.85771,1708855
832,vladmos,10,0.00059,1005803,58.85830,1708855
833,z3ntu,10,0.00059,1005813,58.85889,1708855
834,ZitaNemeckova,10,0.00059,1005823,58.85947,1708855
835,2rs2ts,9,0.00053,1005832,58.86000,1708855
836,abcfy2,9,0.00053,1005841,58.86052,1708855
837,akupila,9,0.00053,1005850,58.86105,1708855
838,alphonsekurian,9,0.00053,1005859,58.86158,1708855
839,Ana06,9,0.00053,1005868,58.86210,1708855
840,andrenarchy,9,0.00053,1005877,58.86263,1708855
841,carltonf,9,0.00053,1005886,58.86316,1708855
842,cnwhy,9,0.00053,1005895,58.86368,1708855
843,Cryrivers,9,0.00053,1005904,58.86421,1708855
844,davoam,9,0.00053,1005913,58.86474,1708855
845,flozano,9,0.00053,1005922,58.86526,1708855
846,JackOfMostTrades,9,0.00053,1005931,58.86579,1708855
847,jasonkuhrt,9,0.00053,1005940,58.86632,1708855
848,jay98014,9,0.00053,1005949,58.86684,1708855
849,johnlabarge,9,0.00053,1005958,58.86737,1708855
850,jzlxiaohei,9,0.00053,1005967,58.86790,1708855
851,karinazhou,9,0.00053,1005976,58.86842,1708855
852,mairin,9,0.00053,1005985,58.86895,1708855
853,md5,9,0.00053,1005994,58.86948,1708855
854,mhutch,9,0.00053,1006003,58.87000,1708855
855,michaelstaib,9,0.00053,1006012,58.87053,1708855
856,micmro,9,0.00053,1006021,58.87106,1708855
857,morgante,9,0.00053,1006030,58.87158,1708855
858,Naddiseo,9,0.00053,1006039,58.87211,1708855
859,njhill,9,0.00053,1006048,58.87264,1708855
860,olegsu,9,0.00053,1006057,58.87316,1708855
861,shawnhar,9,0.00053,1006066,58.87369,1708855
862,skevy,9,0.00053,1006075,58.87422,1708855
863,slandelle,9,0.00053,1006084,58.87474,1708855
864,slang800,9,0.00053,1006093,58.87527,1708855
865,TAGC,9,0.00053,1006102,58.87580,1708855
866,tbroyer,9,0.00053,1006111,58.87632,1708855
867,torbenh3,9,0.00053,1006120,58.87685,1708855
868,vielmetti,9,0.00053,1006129,58.87738,1708855
869,xiaoshuang-lu,9,0.00053,1006138,58.87790,1708855
870,yarikoptic,9,0.00053,1006147,58.87843,1708855
871,yaroslavya,9,0.00053,1006156,58.87896,1708855
872,aherbert,8,0.00047,1006164,58.87943,1708855
873,blimmer,8,0.00047,1006172,58.87989,1708855
874,bouk,8,0.00047,1006180,58.88036,1708855
875,chrishiestand,8,0.00047,1006188,58.88083,1708855
876,directhex,8,0.00047,1006196,58.88130,1708855
877,DullReferenceException,8,0.00047,1006204,58.88177,1708855
878,ecki,8,0.00047,1006212,58.88223,1708855
879,eddywashere,8,0.00047,1006220,58.88270,1708855
880,epixa,8,0.00047,1006228,58.88317,1708855
881,fabdouglas,8,0.00047,1006236,58.88364,1708855
882,gliptak,8,0.00047,1006244,58.88411,1708855
883,gnoack,8,0.00047,1006252,58.88457,1708855
884,halkeye,8,0.00047,1006260,58.88504,1708855
885,heshamMassoud,8,0.00047,1006268,58.88551,1708855
886,Jakuje,8,0.00047,1006276,58.88598,1708855
887,javabrett,8,0.00047,1006284,58.88645,1708855
888,johngmyers,8,0.00047,1006292,58.88692,1708855
889,jpiccari,8,0.00047,1006300,58.88738,1708855
890,jstarks,8,0.00047,1006308,58.88785,1708855
891,jurca,8,0.00047,1006316,58.88832,1708855
892,kmala,8,0.00047,1006324,58.88879,1708855
893,ksophocleous,8,0.00047,1006332,58.88926,1708855
894,lsiudut,8,0.00047,1006340,58.88972,1708855
895,marciopuga,8,0.00047,1006348,58.89019,1708855
896,mariusschulz,8,0.00047,1006356,58.89066,1708855
897,masterfung,8,0.00047,1006364,58.89113,1708855
898,mausch,8,0.00047,1006372,58.89160,1708855
899,mrennie,8,0.00047,1006380,58.89207,1708855
900,nadiatk,8,0.00047,1006388,58.89253,1708855
901,neosab,8,0.00047,1006396,58.89300,1708855
902,nickgrealy,8,0.00047,1006404,58.89347,1708855
903,nurse,8,0.00047,1006412,58.89394,1708855
904,otaviojava,8,0.00047,1006420,58.89441,1708855
905,perezd,8,0.00047,1006428,58.89487,1708855
906,Petrukha,8,0.00047,1006436,58.89534,1708855
907,pietern,8,0.00047,1006444,58.89581,1708855
908,ralfhandl,8,0.00047,1006452,58.89628,1708855
909,rochdev,8,0.00047,1006460,58.89675,1708855
910,sajeetharan,8,0.00047,1006468,58.89721,1708855
911,southpolesteve,8,0.00047,1006476,58.89768,1708855
912,stain,8,0.00047,1006484,58.89815,1708855
913,starpit,8,0.00047,1006492,58.89862,1708855
914,StephenMolloy,8,0.00047,1006500,58.89909,1708855
915,teohhanhui,8,0.00047,1006508,58.89956,1708855
916,theganyo,8,0.00047,1006516,58.90002,1708855
917,themez,8,0.00047,1006524,58.90049,1708855
918,thomasdarimont,8,0.00047,1006532,58.90096,1708855
919,thomaswelton,8,0.00047,1006540,58.90143,1708855
920,tIGO,8,0.00047,1006548,58.90190,1708855
921,timeimp,8,0.00047,1006556,58.90236,1708855
922,Tomas-Kraus,8,0.00047,1006564,58.90283,1708855
923,wikier,8,0.00047,1006572,58.90330,1708855
924,wking,8,0.00047,1006580,58.90377,1708855
925,wub,8,0.00047,1006588,58.90424,1708855
926,zeke,8,0.00047,1006596,58.90471,1708855
927,zx2c4,8,0.00047,1006604,58.90517,1708855
928,ademuri,7,0.00041,1006611,58.90558,1708855
929,alexellis,7,0.00041,1006618,58.90599,1708855
930,andrebrait,7,0.00041,1006625,58.90640,1708855
931,b0ri5,7,0.00041,1006632,58.90681,1708855
932,benjie,7,0.00041,1006639,58.90722,1708855
933,blueyed,7,0.00041,1006646,58.90763,1708855
934,bolu,7,0.00041,1006653,58.90804,1708855
935,bz2,7,0.00041,1006660,58.90845,1708855
936,Cito,7,0.00041,1006667,58.90886,1708855
937,cournape,7,0.00041,1006674,58.90927,1708855
938,DamonGant,7,0.00041,1006681,58.90968,1708855
939,danielwertheim,7,0.00041,1006688,58.91009,1708855
940,daxtens,7,0.00041,1006695,58.91050,1708855
941,deitch,7,0.00041,1006702,58.91091,1708855
942,dimaqq,7,0.00041,1006709,58.91132,1708855
943,dlech,7,0.00041,1006716,58.91173,1708855
944,dmjones,7,0.00041,1006723,58.91214,1708855
945,dnozay,7,0.00041,1006730,58.91255,1708855
946,Dominator008,7,0.00041,1006737,58.91296,1708855
947,dveeden,7,0.00041,1006744,58.91337,1708855
948,edenlee1212,7,0.00041,1006751,58.91378,1708855
949,evolvah,7,0.00041,1006758,58.91419,1708855
950,floreks,7,0.00041,1006765,58.91459,1708855
951,frosas,7,0.00041,1006772,58.91500,1708855
952,fson,7,0.00041,1006779,58.91541,1708855
953,goostleek,7,0.00041,1006786,58.91582,1708855
954,hpurmann,7,0.00041,1006793,58.91623,1708855
955,hypery2k,7,0.00041,1006800,58.91664,1708855
956,iemejia,7,0.00041,1006807,58.91705,1708855
957,jamesr73,7,0.00041,1006814,58.91746,1708855
958,jefferai,7,0.00041,1006821,58.91787,1708855
959,jiria,7,0.00041,1006828,58.91828,1708855
960,JordanP,7,0.00041,1006835,58.91869,1708855
961,jwuliger,7,0.00041,1006842,58.91910,1708855
962,kaptajnen,7,0.00041,1006849,58.91951,1708855
963,kpaxqin,7,0.00041,1006856,58.91992,1708855
964,myungjoo,7,0.00041,1006863,58.92033,1708855
965,Parent5446,7,0.00041,1006870,58.92074,1708855
966,paulmon,7,0.00041,1006877,58.92115,1708855
967,pvanderlinden,7,0.00041,1006884,58.92156,1708855
968,sethpollack,7,0.00041,1006891,58.92197,1708855
969,sixlettervariables,7,0.00041,1006898,58.92238,1708855
970,soimy,7,0.00041,1006905,58.92279,1708855
971,Sovietaced,7,0.00041,1006912,58.92320,1708855
972,sputnik13,7,0.00041,1006919,58.92361,1708855
973,stieler-it,7,0.00041,1006926,58.92402,1708855
974,syrnick,7,0.00041,1006933,58.92443,1708855
975,tamird,7,0.00041,1006940,58.92484,1708855
976,tanaka-takayoshi,7,0.00041,1006947,58.92525,1708855
977,tealtail,7,0.00041,1006954,58.92565,1708855
978,tfarina,7,0.00041,1006961,58.92606,1708855
979,thedrow,7,0.00041,1006968,58.92647,1708855
980,thomassuckow,7,0.00041,1006975,58.92688,1708855
981,tomgeorge,7,0.00041,1006982,58.92729,1708855
982,torvitas,7,0.00041,1006989,58.92770,1708855
983,viniciusls,7,0.00041,1006996,58.92811,1708855
984,vorburger,7,0.00041,1007003,58.92852,1708855
985,wadahiro,7,0.00041,1007010,58.92893,1708855
986,Wilfred,7,0.00041,1007017,58.92934,1708855
987,xerofoify,7,0.00041,1007024,58.92975,1708855
988,Yeti-or,7,0.00041,1007031,58.93016,1708855
989,zg,7,0.00041,1007038,58.93057,1708855
990,zhaozhiming,7,0.00041,1007045,58.93098,1708855
991,a86c6f7964,6,0.00035,1007051,58.93133,1708855
992,acarl005,6,0.00035,1007057,58.93168,1708855
993,agentgonzo,6,0.00035,1007063,58.93203,1708855
994,alexkli,6,0.00035,1007069,58.93238,1708855
995,al-k21,6,0.00035,1007075,58.93274,1708855
996,ankon,6,0.00035,1007081,58.93309,1708855
997,aroc,6,0.00035,1007087,58.93344,1708855
998,askhalil,6,0.00035,1007093,58.93379,1708855
999,bjori,6,0.00035,1007099,58.93414,1708855
1000,chelsiocrypto,6,0.00035,1007105,58.93449,1708855
1001,CindyXing,6,0.00035,1007111,58.93484,1708855
1002,coryfklein,6,0.00035,1007117,58.93519,1708855
1003,darcyadams,6,0.00035,1007123,58.93554,1708855
1004,dcbeckett,6,0.00035,1007129,58.93590,1708855
1005,discostu105,6,0.00035,1007135,58.93625,1708855
1006,djyde,6,0.00035,1007141,58.93660,1708855
1007,dsoprea,6,0.00035,1007147,58.93695,1708855
1008,elgalu,6,0.00035,1007153,58.93730,1708855
1009,enaqx,6,0.00035,1007159,58.93765,1708855
1010,Evangelink,6,0.00035,1007165,58.93800,1708855
1011,farazfazli,6,0.00035,1007171,58.93835,1708855
1012,frasertweedale,6,0.00035,1007177,58.93870,1708855
1013,gesellix,6,0.00035,1007183,58.93906,1708855
1014,guenhter,6,0.00035,1007189,58.93941,1708855
1015,Havner,6,0.00035,1007195,58.93976,1708855
1016,hotpxl,6,0.00035,1007201,58.94011,1708855
1017,jamielennox,6,0.00035,1007207,58.94046,1708855
1018,jglick,6,0.00035,1007213,58.94081,1708855
1019,jiafu1115,6,0.00035,1007219,58.94116,1708855
1020,jldec,6,0.00035,1007225,58.94151,1708855
1021,jloisel,6,0.00035,1007231,58.94186,1708855
1022,juanpablo-santos,6,0.00035,1007237,58.94222,1708855
1023,KindDragon,6,0.00035,1007243,58.94257,1708855
1024,klippx,6,0.00035,1007249,58.94292,1708855
1025,Kuqd,6,0.00035,1007255,58.94327,1708855
1026,larsks,6,0.00035,1007261,58.94362,1708855
1027,LinuxSuRen,6,0.00035,1007267,58.94397,1708855
1028,marcbachmann,6,0.00035,1007273,58.94432,1708855
1029,marians,6,0.00035,1007279,58.94467,1708855
1030,mgedmin,6,0.00035,1007285,58.94502,1708855
1031,mnadeem,6,0.00035,1007291,58.94538,1708855
1032,nacx,6,0.00035,1007297,58.94573,1708855
1033,nddipiazza,6,0.00035,1007303,58.94608,1708855
1034,ndelangen,6,0.00035,1007309,58.94643,1708855
1035,nevetS,6,0.00035,1007315,58.94678,1708855
1036,northtyphoon,6,0.00035,1007321,58.94713,1708855
1037,perlun,6,0.00035,1007327,58.94748,1708855
1038,qizha,6,0.00035,1007333,58.94783,1708855
1039,radarhere,6,0.00035,1007339,58.94818,1708855
1040,rafaelsales,6,0.00035,1007345,58.94854,1708855
1041,robey,6,0.00035,1007351,58.94889,1708855
1042,sanoursa,6,0.00035,1007357,58.94924,1708855
1043,SkReD,6,0.00035,1007363,58.94959,1708855
1044,sourabhmodi,6,0.00035,1007369,58.94994,1708855
1045,Starefossen,6,0.00035,1007375,58.95029,1708855
1046,sufuf3,6,0.00035,1007381,58.95064,1708855
1047,tokuhirom,6,0.00035,1007387,58.95099,1708855
1048,trxcllnt,6,0.00035,1007393,58.95134,1708855
1049,tsabirgaliev,6,0.00035,1007399,58.95170,1708855
1050,ttencate,6,0.00035,1007405,58.95205,1708855
1051,tycho,6,0.00035,1007411,58.95240,1708855
1052,waynebrantley,6,0.00035,1007417,58.95275,1708855
1053,willseeyou,6,0.00035,1007423,58.95310,1708855
1054,XZ-X,6,0.00035,1007429,58.95345,1708855
1055,AdamWill,5,0.00029,1007434,58.95374,1708855
1056,adispring,5,0.00029,1007439,58.95404,1708855
1057,allanchau,5,0.00029,1007444,58.95433,1708855
1058,amadeus,5,0.00029,1007449,58.95462,1708855
1059,anangaur,5,0.00029,1007454,58.95491,1708855
1060,andy-ms,5,0.00029,1007459,58.95521,1708855
1061,anpieber,5,0.00029,1007464,58.95550,1708855
1062,antonblanchard,5,0.00029,1007469,58.95579,1708855
1063,arnaudruffin,5,0.00029,1007474,58.95608,1708855
1064,batrick,5,0.00029,1007479,58.95638,1708855
1065,blia,5,0.00029,1007484,58.95667,1708855
1066,brianwyantora,5,0.00029,1007489,58.95696,1708855
1067,bsyk,5,0.00029,1007494,58.95726,1708855
1068,cemremengu,5,0.00029,1007499,58.95755,1708855
1069,ClementGautier,5,0.00029,1007504,58.95784,1708855
1070,codesuki,5,0.00029,1007509,58.95813,1708855
1071,DanielMSchmidt,5,0.00029,1007514,58.95843,1708855
1072,DanLipsitt,5,0.00029,1007519,58.95872,1708855
1073,daztucker,5,0.00029,1007524,58.95901,1708855
1074,dhensen,5,0.00029,1007529,58.95930,1708855
1075,DmitryKakurin,5,0.00029,1007534,58.95960,1708855
1076,DQNEO,5,0.00029,1007539,58.95989,1708855
1077,evanlucas,5,0.00029,1007544,58.96018,1708855
1078,evnm,5,0.00029,1007549,58.96047,1708855
1079,faascape,5,0.00029,1007554,58.96077,1708855
1080,fhemberger,5,0.00029,1007559,58.96106,1708855
1081,ilovezfs,5,0.00029,1007564,58.96135,1708855
1082,jaytaylor,5,0.00029,1007569,58.96164,1708855
1083,jcruz2us,5,0.00029,1007574,58.96194,1708855
1084,jenlampton,5,0.00029,1007579,58.96223,1708855
1085,jlavallee,5,0.00029,1007584,58.96252,1708855
1086,kaylangan,5,0.00029,1007589,58.96281,1708855
1087,kfenner,5,0.00029,1007594,58.96311,1708855
1088,Kornel,5,0.00029,1007599,58.96340,1708855
1089,kstanger,5,0.00029,1007604,58.96369,1708855
1090,lander2k2,5,0.00029,1007609,58.96398,1708855
1091,leimaohui,5,0.00029,1007614,58.96428,1708855
1092,ligurio,5,0.00029,1007619,58.96457,1708855
1093,localheinz,5,0.00029,1007624,58.96486,1708855
1094,lumag,5,0.00029,1007629,58.96516,1708855
1095,mad-gooze,5,0.00029,1007634,58.96545,1708855
1096,mafagafogigante,5,0.00029,1007639,58.96574,1708855
1097,mar-kolya,5,0.00029,1007644,58.96603,1708855
1098,MatthewDavidCampbell,5,0.00029,1007649,58.96633,1708855
1099,mgalgs,5,0.00029,1007654,58.96662,1708855
1100,mlorbetske,5,0.00029,1007659,58.96691,1708855
1101,mtgibbs,5,0.00029,1007664,58.96720,1708855
1102,nicky-zs,5,0.00029,1007669,58.96750,1708855
1103,notxcain,5,0.00029,1007674,58.96779,1708855
1104,oxlay,5,0.00029,1007679,58.96808,1708855
1105,pavlin99th,5,0.00029,1007684,58.96837,1708855
1106,pgr0ss,5,0.00029,1007689,58.96867,1708855
1107,plappermaul,5,0.00029,1007694,58.96896,1708855
1108,ppKrauss,5,0.00029,1007699,58.96925,1708855
1109,pracucci,5,0.00029,1007704,58.96954,1708855
1110,PunKeel,5,0.00029,1007709,58.96984,1708855
1111,rockwotj,5,0.00029,1007714,58.97013,1708855
1112,saponifi3d,5,0.00029,1007719,58.97042,1708855
1113,scottmarlow,5,0.00029,1007724,58.97071,1708855
1114,seans3,5,0.00029,1007729,58.97101,1708855
1115,senivam,5,0.00029,1007734,58.97130,1708855
1116,sergiomcalzada,5,0.00029,1007739,58.97159,1708855
1117,slickplaid,5,0.00029,1007744,58.97188,1708855
1118,ssbarnea,5,0.00029,1007749,58.97218,1708855
1119,steven-zou,5,0.00029,1007754,58.97247,1708855
1120,Strajk,5,0.00029,1007759,58.97276,1708855
1121,sweiss-google,5,0.00029,1007764,58.97306,1708855
1122,tan9,5,0.00029,1007769,58.97335,1708855
1123,techtonik,5,0.00029,1007774,58.97364,1708855
1124,tweksteen,5,0.00029,1007779,58.97393,1708855
1125,vanmierlo,5,0.00029,1007784,58.97423,1708855
1126,Vimal-Raghubir,5,0.00029,1007789,58.97452,1708855
1127,vinayvishal,5,0.00029,1007794,58.97481,1708855
1128,vincentbernat,5,0.00029,1007799,58.97510,1708855
1129,vincentwoo,5,0.00029,1007804,58.97540,1708855
1130,whitlockjc,5,0.00029,1007809,58.97569,1708855
1131,xizhao,5,0.00029,1007814,58.97598,1708855
1132,ykzts,5,0.00029,1007819,58.97627,1708855
1133,ymlbright,5,0.00029,1007824,58.97657,1708855
1134,ystarlongzi,5,0.00029,1007829,58.97686,1708855
1135,aaronp24,4,0.00023,1007833,58.97709,1708855
1136,abernix,4,0.00023,1007837,58.97733,1708855
1137,aeharding,4,0.00023,1007841,58.97756,1708855
1138,agwells,4,0.00023,1007845,58.97780,1708855
1139,akx,4,0.00023,1007849,58.97803,1708855
1140,albertvaka,4,0.00023,1007853,58.97826,1708855
1141,alexanderrtaylor,4,0.00023,1007857,58.97850,1708855
1142,apaatsio,4,0.00023,1007861,58.97873,1708855
1143,arpit-nagar,4,0.00023,1007865,58.97897,1708855
1144,arthurschreiber,4,0.00023,1007869,58.97920,1708855
1145,asilvas,4,0.00023,1007873,58.97943,1708855
1146,AsturaPhoenix,4,0.00023,1007877,58.97967,1708855
1147,aterreno,4,0.00023,1007881,58.97990,1708855
1148,aviau,4,0.00023,1007885,58.98014,1708855
1149,benc-uk,4,0.00023,1007889,58.98037,1708855
1150,benjdlambert,4,0.00023,1007893,58.98060,1708855
1151,berendt,4,0.00023,1007897,58.98084,1708855
1152,berkerpeksag,4,0.00023,1007901,58.98107,1708855
1153,biblesyme,4,0.00023,1007905,58.98131,1708855
1154,bodewig,4,0.00023,1007909,58.98154,1708855
1155,bryant1410,4,0.00023,1007913,58.98177,1708855
1156,bsideup,4,0.00023,1007917,58.98201,1708855
1157,buzden,4,0.00023,1007921,58.98224,1708855
1158,c9s,4,0.00023,1007925,58.98248,1708855
1159,cakine,4,0.00023,1007929,58.98271,1708855
1160,carlosjgp,4,0.00023,1007933,58.98294,1708855
1161,Carreau,4,0.00023,1007937,58.98318,1708855
1162,cgrushko,4,0.00023,1007941,58.98341,1708855
1163,charleswhchan,4,0.00023,1007945,58.98365,1708855
1164,christophetd,4,0.00023,1007949,58.98388,1708855
1165,cjolif,4,0.00023,1007953,58.98412,1708855
1166,coderanger,4,0.00023,1007957,58.98435,1708855
1167,colus001,4,0.00023,1007961,58.98458,1708855
1168,coreybutler,4,0.00023,1007965,58.98482,1708855
1169,crccheck,4,0.00023,1007969,58.98505,1708855
1170,csutherl,4,0.00023,1007973,58.98529,1708855
1171,danechitoaie,4,0.00023,1007977,58.98552,1708855
1172,darshanj,4,0.00023,1007981,58.98575,1708855
1173,darthtrevino,4,0.00023,1007985,58.98599,1708855
1174,davidstanke,4,0.00023,1007989,58.98622,1708855
1175,dmandelin,4,0.00023,1007993,58.98646,1708855
1176,dolftax,4,0.00023,1007997,58.98669,1708855
1177,donaldchai,4,0.00023,1008001,58.98692,1708855
1178,dothebart,4,0.00023,1008005,58.98716,1708855
1179,EcutDavid,4,0.00023,1008009,58.98739,1708855
1180,edtan,4,0.00023,1008013,58.98763,1708855
1181,ekimber,4,0.00023,1008017,58.98786,1708855
1182,ensonic,4,0.00023,1008021,58.98809,1708855
1183,EricEdens,4,0.00023,1008025,58.98833,1708855
1184,ErikBean,4,0.00023,1008029,58.98856,1708855
1185,Fizzadar,4,0.00023,1008033,58.98880,1708855
1186,frewsxcv,4,0.00023,1008037,58.98903,1708855
1187,galenandrew,4,0.00023,1008041,58.98926,1708855
1188,gaplo917,4,0.00023,1008045,58.98950,1708855
1189,gdelhumeau,4,0.00023,1008049,58.98973,1708855
1190,gjcarneiro,4,0.00023,1008053,58.98997,1708855
1191,harobed,4,0.00023,1008057,58.99020,1708855
1192,harshavardhana,4,0.00023,1008061,58.99044,1708855
1193,Hronom,4,0.00023,1008065,58.99067,1708855
1194,inlined,4,0.00023,1008069,58.99090,1708855
1195,iredelmeier,4,0.00023,1008073,58.99114,1708855
1196,itajaja,4,0.00023,1008077,58.99137,1708855
1197,itamarst,4,0.00023,1008081,58.99161,1708855
1198,japf,4,0.00023,1008085,58.99184,1708855
1199,jdom,4,0.00023,1008089,58.99207,1708855
1200,jeffmahoney,4,0.00023,1008093,58.99231,1708855
1201,jhgg,4,0.00023,1008097,58.99254,1708855
1202,joaoasrosa,4,0.00023,1008101,58.99278,1708855
1203,johnlinp,4,0.00023,1008105,58.99301,1708855
1204,JongHeonChoi,4,0.00023,1008109,58.99324,1708855
1205,kevgliss,4,0.00023,1008113,58.99348,1708855
1206,keyan,4,0.00023,1008117,58.99371,1708855
1207,leewinder,4,0.00023,1008121,58.99395,1708855
1208,Lewiscowles1986,4,0.00023,1008125,58.99418,1708855
1209,lifubang,4,0.00023,1008129,58.99441,1708855
1210,mark-rushakoff,4,0.00023,1008133,58.99465,1708855
1211,mayani,4,0.00023,1008137,58.99488,1708855
1212,mcumings,4,0.00023,1008141,58.99512,1708855
1213,metaskills,4,0.00023,1008145,58.99535,1708855
1214,mgrachev,4,0.00023,1008149,58.99558,1708855
1215,mhdawson,4,0.00023,1008153,58.99582,1708855
1216,mikol,4,0.00023,1008157,58.99605,1708855
1217,mindw,4,0.00023,1008161,58.99629,1708855
1218,mosesn,4,0.00023,1008165,58.99652,1708855
1219,mosesoak,4,0.00023,1008169,58.99676,1708855
1220,mxl,4,0.00023,1008173,58.99699,1708855
1221,nasht00,4,0.00023,1008177,58.99722,1708855
1222,netroby,4,0.00023,1008181,58.99746,1708855
1223,nicholaswyoung,4,0.00023,1008185,58.99769,1708855
1224,noackjr,4,0.00023,1008189,58.99793,1708855
1225,odeke-em,4,0.00023,1008193,58.99816,1708855
1226,olivierlemasle,4,0.00023,1008197,58.99839,1708855
1227,olostan,4,0.00023,1008201,58.99863,1708855
1228,pabigot,4,0.00023,1008205,58.99886,1708855
1229,palmerabollo,4,0.00023,1008209,58.99910,1708855
1230,pkubowicz,4,0.00023,1008213,58.99933,1708855
1231,pmouawad,4,0.00023,1008217,58.99956,1708855
1232,rahst12,4,0.00023,1008221,58.99980,1708855
1233,raul-arabaolaza,4,0.00023,1008225,59.00003,1708855
1234,reeceaw,4,0.00023,1008229,59.00027,1708855
1235,ryanwalters,4,0.00023,1008233,59.00050,1708855
1236,s1monw,4,0.00023,1008237,59.00073,1708855
1237,samueltardieu,4,0.00023,1008241,59.00097,1708855
1238,schmidt-sebastian,4,0.00023,1008245,59.00120,1708855
1239,sergeykad,4,0.00023,1008249,59.00144,1708855
1240,shirbr510,4,0.00023,1008253,59.00167,1708855
1241,sileht,4,0.00023,1008257,59.00190,1708855
1242,silhouettes,4,0.00023,1008261,59.00214,1708855
1243,sinkingpoint,4,0.00023,1008265,59.00237,1708855
1244,sinthetix,4,0.00023,1008269,59.00261,1708855
1245,sjoerdtalsma,4,0.00023,1008273,59.00284,1708855
1246,steven-sheehy,4,0.00023,1008277,59.00308,1708855
1247,stubbornella,4,0.00023,1008281,59.00331,1708855
1248,sunilmut,4,0.00023,1008285,59.00354,1708855
1249,svozza,4,0.00023,1008289,59.00378,1708855
1250,sylvestre,4,0.00023,1008293,59.00401,1708855
1251,t1,4,0.00023,1008297,59.00425,1708855
1252,tao12345666333,4,0.00023,1008301,59.00448,1708855
1253,tasanuma,4,0.00023,1008305,59.00471,1708855
1254,tauren,4,0.00023,1008309,59.00495,1708855
1255,tazjin,4,0.00023,1008313,59.00518,1708855
1256,teone,4,0.00023,1008317,59.00542,1708855
1257,thinkerou,4,0.00023,1008321,59.00565,1708855
1258,tkellen,4,0.00023,1008325,59.00588,1708855
1259,trappar,4,0.00023,1008329,59.00612,1708855
1260,travishaagen,4,0.00023,1008333,59.00635,1708855
1261,untoldone,4,0.00023,1008337,59.00659,1708855
1262,vasanthk,4,0.00023,1008341,59.00682,1708855
1263,viirya,4,0.00023,1008345,59.00705,1708855
1264,wfhartford,4,0.00023,1008349,59.00729,1708855
1265,xaka,4,0.00023,1008353,59.00752,1708855
1266,xiaogaozi,4,0.00023,1008357,59.00776,1708855
1267,xnox,4,0.00023,1008361,59.00799,1708855
1268,yselkowitz,4,0.00023,1008365,59.00822,1708855
1269,zaitcev,4,0.00023,1008369,59.00846,1708855
1270,zhjwpku,4,0.00023,1008373,59.00869,1708855
1271,zshamrock,4,0.00023,1008377,59.00893,1708855
1272,ac360,3,0.00018,1008380,59.00910,1708855
1273,acao,3,0.00018,1008383,59.00928,1708855
1274,acdha,3,0.00018,1008386,59.00945,1708855
1275,adamhenson,3,0.00018,1008389,59.00963,1708855
1276,adioss,3,0.00018,1008392,59.00980,1708855
1277,aecolley,3,0.00018,1008395,59.00998,1708855
1278,akauppi,3,0.00018,1008398,59.01016,1708855
1279,aldaris,3,0.00018,1008401,59.01033,1708855
1280,alecharp,3,0.00018,1008404,59.01051,1708855
1281,andrewhowdencom,3,0.00018,1008407,59.01068,1708855
1282,andrewmchen,3,0.00018,1008410,59.01086,1708855
1283,andyli,3,0.00018,1008413,59.01103,1708855
1284,anish,3,0.00018,1008416,59.01121,1708855
1285,anthonyfok,3,0.00018,1008419,59.01138,1708855
1286,anuraaga,3,0.00018,1008422,59.01156,1708855
1287,ardbiesheuvel,3,0.00018,1008425,59.01174,1708855
1288,ash2k,3,0.00018,1008428,59.01191,1708855
1289,asottile,3,0.00018,1008431,59.01209,1708855
1290,avinassh,3,0.00018,1008434,59.01226,1708855
1291,bachp,3,0.00018,1008437,59.01244,1708855
1292,bassrock,3,0.00018,1008440,59.01261,1708855
1293,benjaminapetersen,3,0.00018,1008443,59.01279,1708855
1294,benmoss,3,0.00018,1008446,59.01296,1708855
1295,billpratt,3,0.00018,1008449,59.01314,1708855
1296,blueknob,3,0.00018,1008452,59.01332,1708855
1297,bmwiedemann,3,0.00018,1008455,59.01349,1708855
1298,brendandburns,3,0.00018,1008458,59.01367,1708855
1299,butchyyyy,3,0.00018,1008461,59.01384,1708855
1300,captainbrosset,3,0.00018,1008464,59.01402,1708855
1301,CatTail,3,0.00018,1008467,59.01419,1708855
1302,cben,3,0.00018,1008470,59.01437,1708855
1303,cesartl,3,0.00018,1008473,59.01454,1708855
1304,charleskorn,3,0.00018,1008476,59.01472,1708855
1305,chenziliang,3,0.00018,1008479,59.01490,1708855
1306,choleraehyq,3,0.00018,1008482,59.01507,1708855
1307,chrisdunelm,3,0.00018,1008485,59.01525,1708855
1308,chrishoffman,3,0.00018,1008488,59.01542,1708855
1309,clemens-tolboom,3,0.00018,1008491,59.01560,1708855
1310,cneijenhuis,3,0.00018,1008494,59.01577,1708855
1311,codito,3,0.00018,1008497,59.01595,1708855
1312,dancasey,3,0.00018,1008500,59.01612,1708855
1313,danielkhan,3,0.00018,1008503,59.01630,1708855
1314,dapengzhang0,3,0.00018,1008506,59.01648,1708855
1315,davedoesdev,3,0.00018,1008509,59.01665,1708855
1316,davidbarratt,3,0.00018,1008512,59.01683,1708855
1317,dcuenot,3,0.00018,1008515,59.01700,1708855
1318,DenisKolodin,3,0.00018,1008518,59.01718,1708855
1319,dgarzon,3,0.00018,1008521,59.01735,1708855
1320,dgonzalez,3,0.00018,1008524,59.01753,1708855
1321,Diagoras,3,0.00018,1008527,59.01770,1708855
1322,dimvar,3,0.00018,1008530,59.01788,1708855
1323,diversario,3,0.00018,1008533,59.01806,1708855
1324,divyenduz,3,0.00018,1008536,59.01823,1708855
1325,dmklementiev,3,0.00018,1008539,59.01841,1708855
1326,dodie,3,0.00018,1008542,59.01858,1708855
1327,doshprompt,3,0.00018,1008545,59.01876,1708855
1328,dschaller,3,0.00018,1008548,59.01893,1708855
1329,dsexton,3,0.00018,1008551,59.01911,1708855
1330,dzannotti,3,0.00018,1008554,59.01928,1708855
1331,ebraminio,3,0.00018,1008557,59.01946,1708855
1332,ekuefler,3,0.00018,1008560,59.01964,1708855
1333,elimisteve,3,0.00018,1008563,59.01981,1708855
1334,emaste,3,0.00018,1008566,59.01999,1708855
1335,enexusde,3,0.00018,1008569,59.02016,1708855
1336,Envek,3,0.00018,1008572,59.02034,1708855
1337,foxylion,3,0.00018,1008575,59.02051,1708855
1338,GabrielNicolasAvellaneda,3,0.00018,1008578,59.02069,1708855
1339,gilbode,3,0.00018,1008581,59.02086,1708855
1340,gkdn,3,0.00018,1008584,59.02104,1708855
1341,greenpau,3,0.00018,1008587,59.02122,1708855
1342,guyfedwards,3,0.00018,1008590,59.02139,1708855
1343,gyuho,3,0.00018,1008593,59.02157,1708855
1344,hashar,3,0.00018,1008596,59.02174,1708855
1345,hiyosi,3,0.00018,1008599,59.02192,1708855
1346,HongGit,3,0.00018,1008602,59.02209,1708855
1347,htuch,3,0.00018,1008605,59.02227,1708855
1348,hynek,3,0.00018,1008608,59.02244,1708855
1349,iawia002,3,0.00018,1008611,59.02262,1708855
1350,IlyaSemenov,3,0.00018,1008614,59.02280,1708855
1351,infrastation,3,0.00018,1008617,59.02297,1708855
1352,ingvagabund,3,0.00018,1008620,59.02315,1708855
1353,ivansenic,3,0.00018,1008623,59.02332,1708855
1354,IvanVergiliev,3,0.00018,1008626,59.02350,1708855
1355,J5,3,0.00018,1008629,59.02367,1708855
1356,JackDanger,3,0.00018,1008632,59.02385,1708855
1357,jamacku,3,0.00018,1008635,59.02402,1708855
1358,JaysonRaymond,3,0.00018,1008638,59.02420,1708855
1359,jcwilson,3,0.00018,1008641,59.02438,1708855
1360,jeffposnick,3,0.00018,1008644,59.02455,1708855
1361,jengelh,3,0.00018,1008647,59.02473,1708855
1362,jezdez,3,0.00018,1008650,59.02490,1708855
1363,jhmanson,3,0.00018,1008653,59.02508,1708855
1364,joehni,3,0.00018,1008656,59.02525,1708855
1365,johnou,3,0.00018,1008659,59.02543,1708855
1366,johnrees,3,0.00018,1008662,59.02560,1708855
1367,JonasVautherin,3,0.00018,1008665,59.02578,1708855
1368,josegonzalez,3,0.00018,1008668,59.02596,1708855
1369,jrbenito,3,0.00018,1008671,59.02613,1708855
1370,jstoja,3,0.00018,1008674,59.02631,1708855
1371,jsuchenia,3,0.00018,1008677,59.02648,1708855
1372,jt143,3,0.00018,1008680,59.02666,1708855
1373,jtblin,3,0.00018,1008683,59.02683,1708855
1374,jterry75,3,0.00018,1008686,59.02701,1708855
1375,jtkukunas,3,0.00018,1008689,59.02718,1708855
1376,julianvmodesto,3,0.00018,1008692,59.02736,1708855
1377,jurobystricky,3,0.00018,1008695,59.02754,1708855
1378,kabir,3,0.00018,1008698,59.02771,1708855
1379,Kaijun,3,0.00018,1008701,59.02789,1708855
1380,kandros,3,0.00018,1008704,59.02806,1708855
1381,kevinawoo,3,0.00018,1008707,59.02824,1708855
1382,kevin-david,3,0.00018,1008710,59.02841,1708855
1383,kevinoliver,3,0.00018,1008713,59.02859,1708855
1384,kisvegabor,3,0.00018,1008716,59.02876,1708855
1385,ktdreyer,3,0.00018,1008719,59.02894,1708855
1386,ktsaou,3,0.00018,1008722,59.02912,1708855
1387,kvz,3,0.00018,1008725,59.02929,1708855
1388,kyakan,3,0.00018,1008728,59.02947,1708855
1389,kybetter,3,0.00018,1008731,59.02964,1708855
1390,kyschouv,3,0.00018,1008734,59.02982,1708855
1391,lakruzz,3,0.00018,1008737,59.02999,1708855
1392,Le0Michine,3,0.00018,1008740,59.03017,1708855
1393,LeoColomb,3,0.00018,1008743,59.03034,1708855
1394,leth,3,0.00018,1008746,59.03052,1708855
1395,lfaraone,3,0.00018,1008749,59.03070,1708855
1396,lgfa29,3,0.00018,1008752,59.03087,1708855
1397,Limess,3,0.00018,1008755,59.03105,1708855
1398,lloydde,3,0.00018,1008758,59.03122,1708855
1399,lorrin,3,0.00018,1008761,59.03140,1708855
1400,magnayn,3,0.00018,1008764,59.03157,1708855
1401,maitesin,3,0.00018,1008767,59.03175,1708855
1402,marc-guenther,3,0.00018,1008770,59.03192,1708855
1403,mark007,3,0.00018,1008773,59.03210,1708855
1404,mastertinner,3,0.00018,1008776,59.03228,1708855
1405,mattnworb,3,0.00018,1008779,59.03245,1708855
1406,maxibanki,3,0.00018,1008782,59.03263,1708855
1407,mfriedenhagen,3,0.00018,1008785,59.03280,1708855
1408,mgadda,3,0.00018,1008788,59.03298,1708855
1409,mgeisler,3,0.00018,1008791,59.03315,1708855
1410,mhils,3,0.00018,1008794,59.03333,1708855
1411,michael-k,3,0.00018,1008797,59.03350,1708855
1412,mike-rogers,3,0.00018,1008800,59.03368,1708855
1413,Mizux,3,0.00018,1008803,59.03386,1708855
1414,morficus,3,0.00018,1008806,59.03403,1708855
1415,mpg,3,0.00018,1008809,59.03421,1708855
1416,msabramo,3,0.00018,1008812,59.03438,1708855
1417,mynameistechno,3,0.00018,1008815,59.03456,1708855
1418,nathan-osman,3,0.00018,1008818,59.03473,1708855
1419,nickleefly,3,0.00018,1008821,59.03491,1708855
1420,nlowe,3,0.00018,1008824,59.03508,1708855
1421,NothingEverHappens,3,0.00018,1008827,59.03526,1708855
1422,oscerd,3,0.00018,1008830,59.03544,1708855
1423,paralin,3,0.00018,1008833,59.03561,1708855
1424,paulduffin,3,0.00018,1008836,59.03579,1708855
1425,pavelchuchma,3,0.00018,1008839,59.03596,1708855
1426,p-bakker,3,0.00018,1008842,59.03614,1708855
1427,perryao,3,0.00018,1008845,59.03631,1708855
1428,pevik,3,0.00018,1008848,59.03649,1708855
1429,Philmod,3,0.00018,1008851,59.03666,1708855
1430,phvu,3,0.00018,1008854,59.03684,1708855
1431,PierreFritsch,3,0.00018,1008857,59.03702,1708855
1432,PiotrSikora,3,0.00018,1008860,59.03719,1708855
1433,pmeerw,3,0.00018,1008863,59.03737,1708855
1434,ptbrowne,3,0.00018,1008866,59.03754,1708855
1435,redixin,3,0.00018,1008869,59.03772,1708855
1436,rerickson1,3,0.00018,1008872,59.03789,1708855
1437,RobRoseKnows,3,0.00018,1008875,59.03807,1708855
1438,RochesterinNYC,3,0.00018,1008878,59.03824,1708855
1439,roidelapluie,3,0.00018,1008881,59.03842,1708855
1440,rossigee,3,0.00018,1008884,59.03860,1708855
1441,russgray,3,0.00018,1008887,59.03877,1708855
1442,rwillmer,3,0.00018,1008890,59.03895,1708855
1443,sargun,3,0.00018,1008893,59.03912,1708855
1444,scjody,3,0.00018,1008896,59.03930,1708855
1445,seanf,3,0.00018,1008899,59.03947,1708855
1446,sebastianroesch,3,0.00018,1008902,59.03965,1708855
1447,sigorilla,3,0.00018,1008905,59.03982,1708855
1448,Sky161,3,0.00018,1008908,59.04000,1708855
1449,sofuture,3,0.00018,1008911,59.04018,1708855
1450,stephenjust,3,0.00018,1008914,59.04035,1708855
1451,stevekuznetsov,3,0.00018,1008917,59.04053,1708855
1452,stonexer,3,0.00018,1008920,59.04070,1708855
1453,Stono,3,0.00018,1008923,59.04088,1708855
1454,StuartHarris,3,0.00018,1008926,59.04105,1708855
1455,stuart-mclaren,3,0.00018,1008929,59.04123,1708855
1456,tadas-subonis,3,0.00018,1008932,59.04140,1708855
1457,taylorwood,3,0.00018,1008935,59.04158,1708855
1458,tbodt,3,0.00018,1008938,59.04176,1708855
1459,tedsuo,3,0.00018,1008941,59.04193,1708855
1460,teresy,3,0.00018,1008944,59.04211,1708855
1461,tgxworld,3,0.00018,1008947,59.04228,1708855
1462,TobiX,3,0.00018,1008950,59.04246,1708855
1463,tombuildsstuff,3,0.00018,1008953,59.04263,1708855
1464,trshafer,3,0.00018,1008956,59.04281,1708855
1465,tuananh,3,0.00018,1008959,59.04298,1708855
1466,tuannvm,3,0.00018,1008962,59.04316,1708855
1467,vapier,3,0.00018,1008965,59.04334,1708855
1468,vickychijwani,3,0.00018,1008968,59.04351,1708855
1469,vitorarins,3,0.00018,1008971,59.04369,1708855
1470,wheleph,3,0.00018,1008974,59.04386,1708855
1471,wongmjane,3,0.00018,1008977,59.04404,1708855
1472,wryun,3,0.00018,1008980,59.04421,1708855
1473,wsargent,3,0.00018,1008983,59.04439,1708855
1474,xeor,3,0.00018,1008986,59.04456,1708855
1475,XVincentX,3,0.00018,1008989,59.04474,1708855
1476,yacaovsnc,3,0.00018,1008992,59.04492,1708855
1477,yibuyisheng,3,0.00018,1008995,59.04509,1708855
1478,yochem,3,0.00018,1008998,59.04527,1708855
1479,zdw,3,0.00018,1009001,59.04544,1708855
1480,zhangyi089,3,0.00018,1009004,59.04562,1708855
1481,aashish-ak,2,0.00012,1009006,59.04574,1708855
1482,abitrolly,2,0.00012,1009008,59.04585,1708855
1483,achew22,2,0.00012,1009010,59.04597,1708855
1484,Ajido,2,0.00012,1009012,59.04609,1708855
1485,ajschlosser,2,0.00012,1009014,59.04620,1708855
1486,aknuds1,2,0.00012,1009016,59.04632,1708855
1487,aliok,2,0.00012,1009018,59.04644,1708855
1488,Aloren,2,0.00012,1009020,59.04655,1708855
1489,amacneil,2,0.00012,1009022,59.04667,1708855
1490,andersk,2,0.00012,1009024,59.04679,1708855
1491,andi-bigswitch,2,0.00012,1009026,59.04691,1708855
1492,andrerom,2,0.00012,1009028,59.04702,1708855
1493,AnneTheAgile,2,0.00012,1009030,59.04714,1708855
1494,ApsOps,2,0.00012,1009032,59.04726,1708855
1495,arliang,2,0.00012,1009034,59.04737,1708855
1496,arvinio,2,0.00012,1009036,59.04749,1708855
1497,bbrowning,2,0.00012,1009038,59.04761,1708855
1498,benjamminj,2,0.00012,1009040,59.04772,1708855
1499,billytrend,2,0.00012,1009042,59.04784,1708855
1500,BinaryDevil,2,0.00012,1009044,59.04796,1708855
1501,bluesliverx,2,0.00012,1009046,59.04808,1708855
1502,brantburnett,2,0.00012,1009048,59.04819,1708855
1503,brantlk,2,0.00012,1009050,59.04831,1708855
1504,bryanlarsen,2,0.00012,1009052,59.04843,1708855
1505,caarlos0,2,0.00012,1009054,59.04854,1708855
1506,caike,2,0.00012,1009056,59.04866,1708855
1507,campionfellin,2,0.00012,1009058,59.04878,1708855
1508,Capstan,2,0.00012,1009060,59.04890,1708855
1509,carlsverre,2,0.00012,1009062,59.04901,1708855
1510,ccamacho,2,0.00012,1009064,59.04913,1708855
1511,Cellule,2,0.00012,1009066,59.04925,1708855
1512,chaintng,2,0.00012,1009068,59.04936,1708855
1513,charly37,2,0.00012,1009070,59.04948,1708855
1514,chibicode,2,0.00012,1009072,59.04960,1708855
1515,christopher-s-hall,2,0.00012,1009074,59.04971,1708855
1516,cijothomas,2,0.00012,1009076,59.04983,1708855
1517,cirocosta,2,0.00012,1009078,59.04995,1708855
1518,clemensv,2,0.00012,1009080,59.05007,1708855
1519,cmoulliard,2,0.00012,1009082,59.05018,1708855
1520,colachg,2,0.00012,1009084,59.05030,1708855
1521,crazytan,2,0.00012,1009086,59.05042,1708855
1522,csantanapr,2,0.00012,1009088,59.05053,1708855
1523,cstyan,2,0.00012,1009090,59.05065,1708855
1524,ctubbsii,2,0.00012,1009092,59.05077,1708855
1525,culmat,2,0.00012,1009094,59.05088,1708855
1526,damienbiggs,2,0.00012,1009096,59.05100,1708855
1527,darrinholst,2,0.00012,1009098,59.05112,1708855
1528,deedubs,2,0.00012,1009100,59.05124,1708855
1529,deepaksood619,2,0.00012,1009102,59.05135,1708855
1530,deinspanjer,2,0.00012,1009104,59.05147,1708855
1531,denismakogon,2,0.00012,1009106,59.05159,1708855
1532,DerDakon,2,0.00012,1009108,59.05170,1708855
1533,digioak,2,0.00012,1009110,59.05182,1708855
1534,dimitropoulos,2,0.00012,1009112,59.05194,1708855
1535,DirtYiCE,2,0.00012,1009114,59.05206,1708855
1536,dmathieu,2,0.00012,1009116,59.05217,1708855
1537,domesticmouse,2,0.00012,1009118,59.05229,1708855
1538,dtaniwaki,2,0.00012,1009120,59.05241,1708855
1539,dunglas,2,0.00012,1009122,59.05252,1708855
1540,duxinxiao,2,0.00012,1009124,59.05264,1708855
1541,egeland,2,0.00012,1009126,59.05276,1708855
1542,ejc3,2,0.00012,1009128,59.05287,1708855
1543,EppO,2,0.00012,1009130,59.05299,1708855
1544,erik777,2,0.00012,1009132,59.05311,1708855
1545,estahn,2,0.00012,1009134,59.05323,1708855
1546,eubnara,2,0.00012,1009136,59.05334,1708855
1547,everett980,2,0.00012,1009138,59.05346,1708855
1548,ferhatelmas,2,0.00012,1009140,59.05358,1708855
1549,figaw,2,0.00012,1009142,59.05369,1708855
1550,flyboarder,2,0.00012,1009144,59.05381,1708855
1551,FrantaM,2,0.00012,1009146,59.05393,1708855
1552,frsyuki,2,0.00012,1009148,59.05404,1708855
1553,gbolo,2,0.00012,1009150,59.05416,1708855
1554,GeorgeSapkin,2,0.00012,1009152,59.05428,1708855
1555,ggreer,2,0.00012,1009154,59.05440,1708855
1556,gigaSproule,2,0.00012,1009156,59.05451,1708855
1557,gk5885,2,0.00012,1009158,59.05463,1708855
1558,glyn,2,0.00012,1009160,59.05475,1708855
1559,harryge00,2,0.00012,1009162,59.05486,1708855
1560,hboutemy,2,0.00012,1009164,59.05498,1708855
1561,henryju,2,0.00012,1009166,59.05510,1708855
1562,iamstolis,2,0.00012,1009168,59.05522,1708855
1563,icereval,2,0.00012,1009170,59.05533,1708855
1564,iest,2,0.00012,1009172,59.05545,1708855
1565,ilgrosso,2,0.00012,1009174,59.05557,1708855
1566,iliul,2,0.00012,1009176,59.05568,1708855
1567,ind1go,2,0.00012,1009178,59.05580,1708855
1568,inyee786,2,0.00012,1009180,59.05592,1708855
1569,iwinux,2,0.00012,1009182,59.05603,1708855
1570,J7mbo,2,0.00012,1009184,59.05615,1708855
1571,jackielii,2,0.00012,1009186,59.05627,1708855
1572,jakebolam,2,0.00012,1009188,59.05639,1708855
1573,jamiehodge,2,0.00012,1009190,59.05650,1708855
1574,Janario,2,0.00012,1009192,59.05662,1708855
1575,Jens-G,2,0.00012,1009194,59.05674,1708855
1576,jgiles,2,0.00012,1009196,59.05685,1708855
1577,jimrollenhagen,2,0.00012,1009198,59.05697,1708855
1578,jkandasa,2,0.00012,1009200,59.05709,1708855
1579,jlinton,2,0.00012,1009202,59.05720,1708855
1580,johanneswuerbach,2,0.00012,1009204,59.05732,1708855
1581,joshgav,2,0.00012,1009206,59.05744,1708855
1582,jparise,2,0.00012,1009208,59.05756,1708855
1583,jpbetz,2,0.00012,1009210,59.05767,1708855
1584,jpoon,2,0.00012,1009212,59.05779,1708855
1585,jrsquared,2,0.00012,1009214,59.05791,1708855
1586,jwhitcraft,2,0.00012,1009216,59.05802,1708855
1587,kans,2,0.00012,1009218,59.05814,1708855
1588,karataliu,2,0.00012,1009220,59.05826,1708855
1589,keeganwitt,2,0.00012,1009222,59.05838,1708855
1590,kellycampbell,2,0.00012,1009224,59.05849,1708855
1591,kenperkins,2,0.00012,1009226,59.05861,1708855
1592,kgyrtkirk,2,0.00012,1009228,59.05873,1708855
1593,kirk91,2,0.00012,1009230,59.05884,1708855
1594,kjin,2,0.00012,1009232,59.05896,1708855
1595,klonos,2,0.00012,1009234,59.05908,1708855
1596,klopfdreh,2,0.00012,1009236,59.05919,1708855
1597,kraj,2,0.00012,1009238,59.05931,1708855
1598,kwasimensah,2,0.00012,1009240,59.05943,1708855
1599,laszlocsomor,2,0.00012,1009242,59.05955,1708855
1600,lenage,2,0.00012,1009244,59.05966,1708855
1601,leodido,2,0.00012,1009246,59.05978,1708855
1602,lionelvillard,2,0.00012,1009248,59.05990,1708855
1603,listrophy,2,0.00012,1009250,59.06001,1708855
1604,llimllib,2,0.00012,1009252,59.06013,1708855
1605,lmcarreiro,2,0.00012,1009254,59.06025,1708855
1606,longsleep,2,0.00012,1009256,59.06036,1708855
1607,mafrosis,2,0.00012,1009258,59.06048,1708855
1608,magnolia-k,2,0.00012,1009260,59.06060,1708855
1609,marshallbrekka,2,0.00012,1009262,59.06072,1708855
1610,MartinNowak,2,0.00012,1009264,59.06083,1708855
1611,martinpitt,2,0.00012,1009266,59.06095,1708855
1612,martyanov,2,0.00012,1009268,59.06107,1708855
1613,mathstuf,2,0.00012,1009270,59.06118,1708855
1614,maxg,2,0.00012,1009272,59.06130,1708855
1615,mblair,2,0.00012,1009274,59.06142,1708855
1616,mcoolive,2,0.00012,1009276,59.06154,1708855
1617,messense,2,0.00012,1009278,59.06165,1708855
1618,michaeljohnbennett,2,0.00012,1009280,59.06177,1708855
1619,mikesir87,2,0.00012,1009282,59.06189,1708855
1620,mina86,2,0.00012,1009284,59.06200,1708855
1621,moonchanyong,2,0.00012,1009286,59.06212,1708855
1622,morganfainberg,2,0.00012,1009288,59.06224,1708855
1623,msprotz,2,0.00012,1009290,59.06235,1708855
1624,mucahitkurt,2,0.00012,1009292,59.06247,1708855
1625,Nabellaleen,2,0.00012,1009294,59.06259,1708855
1626,NamPNQ,2,0.00012,1009296,59.06271,1708855
1627,naveensrinivasan,2,0.00012,1009298,59.06282,1708855
1628,nbeckman,2,0.00012,1009300,59.06294,1708855
1629,nealef,2,0.00012,1009302,59.06306,1708855
1630,niik,2,0.00012,1009304,59.06317,1708855
1631,nikai3d,2,0.00012,1009306,59.06329,1708855
1632,Ninir,2,0.00012,1009308,59.06341,1708855
1633,nlopezgi,2,0.00012,1009310,59.06352,1708855
1634,nullstyle,2,0.00012,1009312,59.06364,1708855
1635,nzthiago,2,0.00012,1009314,59.06376,1708855
1636,ohadlevy,2,0.00012,1009316,59.06388,1708855
1637,okkez,2,0.00012,1009318,59.06399,1708855
1638,olleolleolle,2,0.00012,1009320,59.06411,1708855
1639,omerzach,2,0.00012,1009322,59.06423,1708855
1640,otavio,2,0.00012,1009324,59.06434,1708855
1641,parkr,2,0.00012,1009326,59.06446,1708855
1642,paulgmiller,2,0.00012,1009328,59.06458,1708855
1643,paultiplady,2,0.00012,1009330,59.06470,1708855
1644,pdudits,2,0.00012,1009332,59.06481,1708855
1645,pengx17,2,0.00012,1009334,59.06493,1708855
1646,petercgrant,2,0.00012,1009336,59.06505,1708855
1647,pfsmorigo,2,0.00012,1009338,59.06516,1708855
1648,pgadige,2,0.00012,1009340,59.06528,1708855
1649,pierreozoux,2,0.00012,1009342,59.06540,1708855
1650,pingunaut,2,0.00012,1009344,59.06551,1708855
1651,pmarks-net,2,0.00012,1009346,59.06563,1708855
1652,pulse00,2,0.00012,1009348,59.06575,1708855
1653,pushrax,2,0.00012,1009350,59.06587,1708855
1654,qar,2,0.00012,1009352,59.06598,1708855
1655,RajivPrab-Google,2,0.00012,1009354,59.06610,1708855
1656,rdrgmnzs,2,0.00012,1009356,59.06622,1708855
1657,resker,2,0.00012,1009358,59.06633,1708855
1658,retrohacker,2,0.00012,1009360,59.06645,1708855
1659,rhencke,2,0.00012,1009362,59.06657,1708855
1660,rohanpai,2,0.00012,1009364,59.06669,1708855
1661,samridh90,2,0.00012,1009366,59.06680,1708855
1662,samuelkarp,2,0.00012,1009368,59.06692,1708855
1663,samv,2,0.00012,1009370,59.06704,1708855
1664,saschagrunert,2,0.00012,1009372,59.06715,1708855
1665,scboffspring,2,0.00012,1009374,59.06727,1708855
1666,schickling,2,0.00012,1009376,59.06739,1708855
1667,scothis,2,0.00012,1009378,59.06750,1708855
1668,seh,2,0.00012,1009380,59.06762,1708855
1669,semion1956,2,0.00012,1009382,59.06774,1708855
1670,sharonvardi,2,0.00012,1009384,59.06786,1708855
1671,shauns,2,0.00012,1009386,59.06797,1708855
1672,shichao-an,2,0.00012,1009388,59.06809,1708855
1673,shicks,2,0.00012,1009390,59.06821,1708855
1674,shirdrn,2,0.00012,1009392,59.06832,1708855
1675,shubheksha,2,0.00012,1009394,59.06844,1708855
1676,silasb,2,0.00012,1009396,59.06856,1708855
1677,simonbrandhof,2,0.00012,1009398,59.06867,1708855
1678,sinstein,2,0.00012,1009400,59.06879,1708855
1679,sjug,2,0.00012,1009402,59.06891,1708855
1680,sjungwirth,2,0.00012,1009404,59.06903,1708855
1681,songsong182,2,0.00012,1009406,59.06914,1708855
1682,sosiouxme,2,0.00012,1009408,59.06926,1708855
1683,spen,2,0.00012,1009410,59.06938,1708855
1684,stephenjannin,2,0.00012,1009412,59.06949,1708855
1685,StevenACoffman,2,0.00012,1009414,59.06961,1708855
1686,stevewhims,2,0.00012,1009416,59.06973,1708855
1687,stkelley,2,0.00012,1009418,59.06985,1708855
1688,stubailo,2,0.00012,1009420,59.06996,1708855
1689,SurferJeffAtGoogle,2,0.00012,1009422,59.07008,1708855
1690,syndbg,2,0.00012,1009424,59.07020,1708855
1691,tangiel,2,0.00012,1009426,59.07031,1708855
1692,testingbot,2,0.00012,1009428,59.07043,1708855
1693,TFenby,2,0.00012,1009430,59.07055,1708855
1694,thardeck,2,0.00012,1009432,59.07066,1708855
1695,TimvdLippe,2,0.00012,1009434,59.07078,1708855
1696,tklauser,2,0.00012,1009436,59.07090,1708855
1697,tmm1,2,0.00012,1009438,59.07102,1708855
1698,tomasbjerre,2,0.00012,1009440,59.07113,1708855
1699,tomgco,2,0.00012,1009442,59.07125,1708855
1700,tomkerkhove,2,0.00012,1009444,59.07137,1708855
1701,tsl0922,2,0.00012,1009446,59.07148,1708855
1702,twKrash,2,0.00012,1009448,59.07160,1708855
1703,tylerlong,2,0.00012,1009450,59.07172,1708855
1704,vania-pooh,2,0.00012,1009452,59.07183,1708855
1705,vbuslov,2,0.00012,1009454,59.07195,1708855
1706,vvidic,2,0.00012,1009456,59.07207,1708855
1707,wilk,2,0.00012,1009458,59.07219,1708855
1708,wohali,2,0.00012,1009460,59.07230,1708855
1709,wonseop,2,0.00012,1009462,59.07242,1708855
1710,wyllys66,2,0.00012,1009464,59.07254,1708855
1711,xfxyjwf,2,0.00012,1009466,59.07265,1708855
1712,yaxia,2,0.00012,1009468,59.07277,1708855
1713,yeputons,2,0.00012,1009470,59.07289,1708855
1714,yhirano55,2,0.00012,1009472,59.07301,1708855
1715,yhwang,2,0.00012,1009474,59.07312,1708855
1716,yurrriq,2,0.00012,1009476,59.07324,1708855
1717,zaverucha,2,0.00012,1009478,59.07336,1708855
1718,zhiliangxu,2,0.00012,1009480,59.07347,1708855
1719,15characterlimi,1,0.00006,1009481,59.07353,1708855
1720,1st1,1,0.00006,1009482,59.07359,1708855
1721,2color,1,0.00006,1009483,59.07365,1708855
1722,a8m,1,0.00006,1009484,59.07371,1708855
1723,aalexand,1,0.00006,1009485,59.07377,1708855
1724,abergmann,1,0.00006,1009486,59.07382,1708855
1725,abucodonosor,1,0.00006,1009487,59.07388,1708855
1726,achermes,1,0.00006,1009488,59.07394,1708855
1727,acomagu,1,0.00006,1009489,59.07400,1708855
1728,AdamMajer,1,0.00006,1009490,59.07406,1708855
1729,adrianmoisey,1,0.00006,1009491,59.07412,1708855
1730,ahmadalli,1,0.00006,1009492,59.07418,1708855
1731,akervern,1,0.00006,1009493,59.07423,1708855
1732,alecmerdler,1,0.00006,1009494,59.07429,1708855
1733,alenkacz,1,0.00006,1009495,59.07435,1708855
1734,alexandrebodin,1,0.00006,1009496,59.07441,1708855
1735,alexcasalboni,1,0.00006,1009497,59.07447,1708855
1736,Alexendoo,1,0.00006,1009498,59.07453,1708855
1737,alexmt,1,0.00006,1009499,59.07459,1708855
1738,alexvicegrab,1,0.00006,1009500,59.07464,1708855
1739,alfirin,1,0.00006,1009501,59.07470,1708855
1740,alokrajiv,1,0.00006,1009502,59.07476,1708855
1741,alonl,1,0.00006,1009503,59.07482,1708855
1742,alpeb,1,0.00006,1009504,59.07488,1708855
1743,alvgarvilla,1,0.00006,1009505,59.07494,1708855
1744,anacrolix,1,0.00006,1009506,59.07499,1708855
1745,anagrius,1,0.00006,1009507,59.07505,1708855
1746,anandkumarpatel,1,0.00006,1009508,59.07511,1708855
1747,andrewsomething,1,0.00006,1009509,59.07517,1708855
1748,andreykaipov,1,0.00006,1009510,59.07523,1708855
1749,AngelosP,1,0.00006,1009511,59.07529,1708855
1750,annarozin,1,0.00006,1009512,59.07535,1708855
1751,answer1991,1,0.00006,1009513,59.07540,1708855
1752,apaprocki,1,0.00006,1009514,59.07546,1708855
1753,arapov,1,0.00006,1009515,59.07552,1708855
1754,arghya88,1,0.00006,1009516,59.07558,1708855
1755,ArieShout,1,0.00006,1009517,59.07564,1708855
1756,arunkjn,1,0.00006,1009518,59.07570,1708855
1757,arunvelsriram,1,0.00006,1009519,59.07576,1708855
1758,aschepis,1,0.00006,1009520,59.07581,1708855
1759,aspiers,1,0.00006,1009521,59.07587,1708855
1760,atomantic,1,0.00006,1009522,59.07593,1708855
1761,atombender,1,0.00006,1009523,59.07599,1708855
1762,Autophagy,1,0.00006,1009524,59.07605,1708855
1763,avarabyeu,1,0.00006,1009525,59.07611,1708855
1764,avoinea,1,0.00006,1009526,59.07617,1708855
1765,avranju,1,0.00006,1009527,59.07622,1708855
1766,batmat,1,0.00006,1009528,59.07628,1708855
1767,Bege13mot,1,0.00006,1009529,59.07634,1708855
1768,benbalter,1,0.00006,1009530,59.07640,1708855
1769,BenderV,1,0.00006,1009531,59.07646,1708855
1770,benoitf,1,0.00006,1009532,59.07652,1708855
1771,ben-st,1,0.00006,1009533,59.07657,1708855
1772,bentmann,1,0.00006,1009534,59.07663,1708855
1773,bezda,1,0.00006,1009535,59.07669,1708855
1774,bhcopeland,1,0.00006,1009536,59.07675,1708855
1775,biglovisa,1,0.00006,1009537,59.07681,1708855
1776,bnjbvr,1,0.00006,1009538,59.07687,1708855
1777,bobintornado,1,0.00006,1009539,59.07693,1708855
1778,bobmshannon,1,0.00006,1009540,59.07698,1708855
1779,boeboe,1,0.00006,1009541,59.07704,1708855
1780,bonifaido,1,0.00006,1009542,59.07710,1708855
1781,bradydowling,1,0.00006,1009543,59.07716,1708855
1782,brandonh-msft,1,0.00006,1009544,59.07722,1708855
1783,breeswish,1,0.00006,1009545,59.07728,1708855
1784,brendanashworth,1,0.00006,1009546,59.07734,1708855
1785,brettjacobson,1,0.00006,1009547,59.07739,1708855
1786,bthelen,1,0.00006,1009548,59.07745,1708855
1787,budhrg,1,0.00006,1009549,59.07751,1708855
1788,burkeholland,1,0.00006,1009550,59.07757,1708855
1789,BusyJay,1,0.00006,1009551,59.07763,1708855
1790,cburmeister,1,0.00006,1009552,59.07769,1708855
1791,cdown,1,0.00006,1009553,59.07775,1708855
1792,cedriclam,1,0.00006,1009554,59.07780,1708855
1793,cehoffman,1,0.00006,1009555,59.07786,1708855
1794,cengiz-demir,1,0.00006,1009556,59.07792,1708855
1795,centic9,1,0.00006,1009557,59.07798,1708855
1796,cfieber,1,0.00006,1009558,59.07804,1708855
1797,cfs-pure,1,0.00006,1009559,59.07810,1708855
1798,chancez,1,0.00006,1009560,59.07815,1708855
1799,chandresh-pancholi,1,0.00006,1009561,59.07821,1708855
1800,Chen-Gang,1,0.00006,1009562,59.07827,1708855
1801,chenrui333,1,0.00006,1009563,59.07833,1708855
1802,chirino,1,0.00006,1009564,59.07839,1708855
1803,chmouel,1,0.00006,1009565,59.07845,1708855
1804,chriskuehl,1,0.00006,1009566,59.07851,1708855
1805,chrisoverzero,1,0.00006,1009567,59.07856,1708855
1806,chris-rock,1,0.00006,1009568,59.07862,1708855
1807,chrisseto,1,0.00006,1009569,59.07868,1708855
1808,chris-short,1,0.00006,1009570,59.07874,1708855
1809,chuckbutler,1,0.00006,1009571,59.07880,1708855
1810,chwarr,1,0.00006,1009572,59.07886,1708855
1811,cjshawMIT,1,0.00006,1009573,59.07892,1708855
1812,ckross01,1,0.00006,1009574,59.07897,1708855
1813,cleac,1,0.00006,1009575,59.07903,1708855
1814,clguimanMSFT,1,0.00006,1009576,59.07909,1708855
1815,cndpzc,1,0.00006,1009577,59.07915,1708855
1816,collinpeters,1,0.00006,1009578,59.07921,1708855
1817,Colstuwjx,1,0.00006,1009579,59.07927,1708855
1818,cpointner,1,0.00006,1009580,59.07933,1708855
1819,craigsmitham,1,0.00006,1009581,59.07938,1708855
1820,curi0usJack,1,0.00006,1009582,59.07944,1708855
1821,cybergrind,1,0.00006,1009583,59.07950,1708855
1822,dalanmiller,1,0.00006,1009584,59.07956,1708855
1823,daniel-beck,1,0.00006,1009585,59.07962,1708855
1824,daniel-kun,1,0.00006,1009586,59.07968,1708855
1825,danielmbarlow,1,0.00006,1009587,59.07973,1708855
1826,dankohn,1,0.00006,1009588,59.07979,1708855
1827,darioblanco,1,0.00006,1009589,59.07985,1708855
1828,davejamesmiller,1,0.00006,1009590,59.07991,1708855
1829,daviburg,1,0.00006,1009591,59.07997,1708855
1830,davidcelis,1,0.00006,1009592,59.08003,1708855
1831,davidmichaelkarr,1,0.00006,1009593,59.08009,1708855
1832,DazWilkin,1,0.00006,1009594,59.08014,1708855
1833,dbarlett,1,0.00006,1009595,59.08020,1708855
1834,dblock,1,0.00006,1009596,59.08026,1708855
1835,dbussink,1,0.00006,1009597,59.08032,1708855
1836,dcbw,1,0.00006,1009598,59.08038,1708855
1837,dconnelly,1,0.00006,1009599,59.08044,1708855
1838,dcoraboeuf,1,0.00006,1009600,59.08050,1708855
1839,deiwin,1,0.00006,1009601,59.08055,1708855
1840,dennis-benzinger-hybris,1,0.00006,1009602,59.08061,1708855
1841,Derbeth,1,0.00006,1009603,59.08067,1708855
1842,derekperkins,1,0.00006,1009604,59.08073,1708855
1843,derpierre65,1,0.00006,1009605,59.08079,1708855
1844,d-e-s-o,1,0.00006,1009606,59.08085,1708855
1845,devlance,1,0.00006,1009607,59.08091,1708855
1846,dfredell,1,0.00006,1009608,59.08096,1708855
1847,dgem,1,0.00006,1009609,59.08102,1708855
1848,dillonburns,1,0.00006,1009610,59.08108,1708855
1849,dims,1,0.00006,1009611,59.08114,1708855
1850,dingwilson,1,0.00006,1009612,59.08120,1708855
1851,diogogmt,1,0.00006,1009613,59.08126,1708855
1852,dipak-pawar,1,0.00006,1009614,59.08131,1708855
1853,dishantgniit,1,0.00006,1009615,59.08137,1708855
1854,displague,1,0.00006,1009616,59.08143,1708855
1855,diwu1989,1,0.00006,1009617,59.08149,1708855
1856,dlebed,1,0.00006,1009618,59.08155,1708855
1857,dmsimard,1,0.00006,1009619,59.08161,1708855
1858,dorav,1,0.00006,1009620,59.08167,1708855
1859,dosire,1,0.00006,1009621,59.08172,1708855
1860,dpurrington,1,0.00006,1009622,59.08178,1708855
1861,drdamour,1,0.00006,1009623,59.08184,1708855
1862,drusellers,1,0.00006,1009624,59.08190,1708855
1863,dsyer,1,0.00006,1009625,59.08196,1708855
1864,dvorak42,1,0.00006,1009626,59.08202,1708855
1865,dy-dx,1,0.00006,1009627,59.08208,1708855
1866,dzimine,1,0.00006,1009628,59.08213,1708855
1867,eaftan,1,0.00006,1009629,59.08219,1708855
1868,earlbread,1,0.00006,1009630,59.08225,1708855
1869,ejamesc,1,0.00006,1009631,59.08231,1708855
1870,ejoerns,1,0.00006,1009632,59.08237,1708855
1871,ejona86,1,0.00006,1009633,59.08243,1708855
1872,ekarlso,1,0.00006,1009634,59.08249,1708855
1873,ekoome,1,0.00006,1009635,59.08254,1708855
1874,ElfoLiNk,1,0.00006,1009636,59.08260,1708855
1875,emaildanwilson,1,0.00006,1009637,59.08266,1708855
1876,erain,1,0.00006,1009638,59.08272,1708855
1877,ericwb,1,0.00006,1009639,59.08278,1708855
1878,etsauer,1,0.00006,1009640,59.08284,1708855
1879,everett-toews,1,0.00006,1009641,59.08289,1708855
1880,fasaxc,1,0.00006,1009642,59.08295,1708855
1881,Felixzz,1,0.00006,1009643,59.08301,1708855
1882,ferantivero,1,0.00006,1009644,59.08307,1708855
1883,flakerimi,1,0.00006,1009645,59.08313,1708855
1884,four43,1,0.00006,1009646,59.08319,1708855
1885,francescoinfante,1,0.00006,1009647,59.08325,1708855
1886,Francisco-Gamino,1,0.00006,1009648,59.08330,1708855
1887,frankgreco,1,0.00006,1009649,59.08336,1708855
1888,fungi,1,0.00006,1009650,59.08342,1708855
1889,gabel,1,0.00006,1009651,59.08348,1708855
1890,gabikliot,1,0.00006,1009652,59.08354,1708855
1891,gabrfarina,1,0.00006,1009653,59.08360,1708855
1892,gam-phon,1,0.00006,1009654,59.08366,1708855
1893,garyiwu,1,0.00006,1009655,59.08371,1708855
1894,gaziqbal,1,0.00006,1009656,59.08377,1708855
1895,gbraad,1,0.00006,1009657,59.08383,1708855
1896,gdeangel,1,0.00006,1009658,59.08389,1708855
1897,gdubya,1,0.00006,1009659,59.08395,1708855
1898,georgecrawford,1,0.00006,1009660,59.08401,1708855
1899,ggarnier,1,0.00006,1009661,59.08407,1708855
1900,glaubitz,1,0.00006,1009662,59.08412,1708855
1901,goldshtn,1,0.00006,1009663,59.08418,1708855
1902,golonzovsky,1,0.00006,1009664,59.08424,1708855
1903,gonzojive,1,0.00006,1009665,59.08430,1708855
1904,grosser,1,0.00006,1009666,59.08436,1708855
1905,guoshimin,1,0.00006,1009667,59.08442,1708855
1906,haberman,1,0.00006,1009668,59.08447,1708855
1907,hach-que,1,0.00006,1009669,59.08453,1708855
1908,HackToday,1,0.00006,1009670,59.08459,1708855
1909,hakan42,1,0.00006,1009671,59.08465,1708855
1910,harai,1,0.00006,1009672,59.08471,1708855
1911,haxorz,1,0.00006,1009673,59.08477,1708855
1912,hjacobs,1,0.00006,1009674,59.08483,1708855
1913,hoffin,1,0.00006,1009675,59.08488,1708855
1914,huikang,1,0.00006,1009676,59.08494,1708855
1915,ianlancetaylor,1,0.00006,1009677,59.08500,1708855
1916,igalic,1,0.00006,1009678,59.08506,1708855
1917,ihac,1,0.00006,1009679,59.08512,1708855
1918,ikatson,1,0.00006,1009680,59.08518,1708855
1919,iphands,1,0.00006,1009681,59.08524,1708855
1920,irissmann,1,0.00006,1009682,59.08529,1708855
1921,isyun,1,0.00006,1009683,59.08535,1708855
1922,itsavvy-ankur,1,0.00006,1009684,59.08541,1708855
1923,Ivanwangcy,1,0.00006,1009685,59.08547,1708855
1924,j14s,1,0.00006,1009686,59.08553,1708855
1925,JackFish,1,0.00006,1009687,59.08559,1708855
1926,jacmet,1,0.00006,1009688,59.08565,1708855
1927,JacquesPerrault,1,0.00006,1009689,59.08570,1708855
1928,jakon89,1,0.00006,1009690,59.08576,1708855
1929,jamland,1,0.00006,1009691,59.08582,1708855
1930,JasonLinMS,1,0.00006,1009692,59.08588,1708855
1931,javeme,1,0.00006,1009693,59.08594,1708855
1932,jbaruch,1,0.00006,1009694,59.08600,1708855
1933,jcoeltjen,1,0.00006,1009695,59.08605,1708855
1934,jd,1,0.00006,1009696,59.08611,1708855
1935,jeffrey4l,1,0.00006,1009697,59.08617,1708855
1936,JeffRMoore,1,0.00006,1009698,59.08623,1708855
1937,jeroenvisser101,1,0.00006,1009699,59.08629,1708855
1938,jessica-dl,1,0.00006,1009700,59.08635,1708855
1939,jgkamat,1,0.00006,1009701,59.08641,1708855
1940,jhorwit2,1,0.00006,1009702,59.08646,1708855
1941,jiangzhuo,1,0.00006,1009703,59.08652,1708855
1942,jmagnusson,1,0.00006,1009704,59.08658,1708855
1943,jmervine,1,0.00006,1009705,59.08664,1708855
1944,jmini,1,0.00006,1009706,59.08670,1708855
1945,joanrieu,1,0.00006,1009707,59.08676,1708855
1946,joelschopp,1,0.00006,1009708,59.08682,1708855
1947,johnaoss,1,0.00006,1009709,59.08687,1708855
1948,johnzheng1975,1,0.00006,1009710,59.08693,1708855
1949,JonnyIncognito,1,0.00006,1009711,59.08699,1708855
1950,jonyonson,1,0.00006,1009712,59.08705,1708855
1951,joschi,1,0.00006,1009713,59.08711,1708855
1952,jpeterson88,1,0.00006,1009714,59.08717,1708855
1953,jpreese,1,0.00006,1009715,59.08723,1708855
1954,JRBANCEL,1,0.00006,1009716,59.08728,1708855
1955,jrn,1,0.00006,1009717,59.08734,1708855
1956,jsyrjala,1,0.00006,1009718,59.08740,1708855
1957,julian-klode,1,0.00006,1009719,59.08746,1708855
1958,justcla,1,0.00006,1009720,59.08752,1708855
1959,jyane,1,0.00006,1009721,59.08758,1708855
1960,k1988,1,0.00006,1009722,59.08763,1708855
1961,kamaln7,1,0.00006,1009723,59.08769,1708855
1962,karlkfi,1,0.00006,1009724,59.08775,1708855
1963,kenegozi,1,0.00006,1009725,59.08781,1708855
1964,kghost,1,0.00006,1009726,59.08787,1708855
1965,kikyous,1,0.00006,1009727,59.08793,1708855
1966,kilink,1,0.00006,1009728,59.08799,1708855
1967,kirkthompson,1,0.00006,1009729,59.08804,1708855
1968,komamitsu,1,0.00006,1009730,59.08810,1708855
1969,konryd,1,0.00006,1009731,59.08816,1708855
1970,kool79,1,0.00006,1009732,59.08822,1708855
1971,KostyaSha,1,0.00006,1009733,59.08828,1708855
1972,krasnoukhov,1,0.00006,1009734,59.08834,1708855
1973,kriskowal,1,0.00006,1009735,59.08840,1708855
1974,kuhlenh,1,0.00006,1009736,59.08845,1708855
1975,larrys,1,0.00006,1009737,59.08851,1708855
1976,laurawalker,1,0.00006,1009738,59.08857,1708855
1977,laurentlb,1,0.00006,1009739,59.08863,1708855
1978,leighmcculloch,1,0.00006,1009740,59.08869,1708855
1979,leitao,1,0.00006,1009741,59.08875,1708855
1980,leseb,1,0.00006,1009742,59.08881,1708855
1981,lexholden,1,0.00006,1009743,59.08886,1708855
1982,limscoder,1,0.00006,1009744,59.08892,1708855
1983,lindner,1,0.00006,1009745,59.08898,1708855
1984,lizrice,1,0.00006,1009746,59.08904,1708855
1985,lostick,1,0.00006,1009747,59.08910,1708855
1986,ludokx,1,0.00006,1009748,59.08916,1708855
1987,luizcarraro,1,0.00006,1009749,59.08921,1708855
1988,lyda,1,0.00006,1009750,59.08927,1708855
1989,machaval,1,0.00006,1009751,59.08933,1708855
1990,maciaszczykm,1,0.00006,1009752,59.08939,1708855
1991,makdharma,1,0.00006,1009753,59.08945,1708855
1992,malaporte,1,0.00006,1009754,59.08951,1708855
1993,manolo,1,0.00006,1009755,59.08957,1708855
1994,marcelbirkner,1,0.00006,1009756,59.08962,1708855
1995,marcosnils,1,0.00006,1009757,59.08968,1708855
1996,markgibaud,1,0.00006,1009758,59.08974,1708855
1997,martijnwalraven,1,0.00006,1009759,59.08980,1708855
1998,marwanad,1,0.00006,1009760,59.08986,1708855
1999,maryshak1996,1,0.00006,1009761,59.08992,1708855
2000,Masquerade0097,1,0.00006,1009762,59.08998,1708855
2001,maugusto-cit,1,0.00006,1009763,59.09003,1708855
2002,maxenglander,1,0.00006,1009764,59.09009,1708855
2003,mazzy89,1,0.00006,1009765,59.09015,1708855
2004,mbabker,1,0.00006,1009766,59.09021,1708855
2005,mbearup,1,0.00006,1009767,59.09027,1708855
2006,mbonaci,1,0.00006,1009768,59.09033,1708855
2007,mbrevoort,1,0.00006,1009769,59.09039,1708855
2008,mdcanham,1,0.00006,1009770,59.09044,1708855
2009,merge,1,0.00006,1009771,59.09050,1708855
2010,metmajer,1,0.00006,1009772,59.09056,1708855
2011,michaelklishin,1,0.00006,1009773,59.09062,1708855
2012,michaelolbrich,1,0.00006,1009774,59.09068,1708855
2013,mickep76,1,0.00006,1009775,59.09074,1708855
2014,MikeGoldsmith,1,0.00006,1009776,59.09079,1708855
2015,mikesplain,1,0.00006,1009777,59.09085,1708855
2016,mindscratch,1,0.00006,1009778,59.09091,1708855
2017,mirosval,1,0.00006,1009779,59.09097,1708855
2018,mitchlloyd,1,0.00006,1009780,59.09103,1708855
2019,mkobit,1,0.00006,1009781,59.09109,1708855
2020,mkulke,1,0.00006,1009782,59.09115,1708855
2021,monday0rsunday,1,0.00006,1009783,59.09120,1708855
2022,monners,1,0.00006,1009784,59.09126,1708855
2023,mook-as,1,0.00006,1009785,59.09132,1708855
2024,msiebuhr,1,0.00006,1009786,59.09138,1708855
2025,msolomon,1,0.00006,1009787,59.09144,1708855
2026,msrb,1,0.00006,1009788,59.09150,1708855
2027,mtwo,1,0.00006,1009789,59.09156,1708855
2028,mxpv,1,0.00006,1009790,59.09161,1708855
2029,ncopa,1,0.00006,1009791,59.09167,1708855
2030,nertim,1,0.00006,1009792,59.09173,1708855
2031,nfalco79,1,0.00006,1009793,59.09179,1708855
2032,nickygerritsen,1,0.00006,1009794,59.09185,1708855
2033,NicolasT,1,0.00006,1009795,59.09191,1708855
2034,nikolay-fedotov,1,0.00006,1009796,59.09197,1708855
2035,nlamirault,1,0.00006,1009797,59.09202,1708855
2036,nnordrum,1,0.00006,1009798,59.09208,1708855
2037,Noamyoungerm,1,0.00006,1009799,59.09214,1708855
2038,nodo,1,0.00006,1009800,59.09220,1708855
2039,noqcks,1,0.00006,1009801,59.09226,1708855
2040,notslang,1,0.00006,1009802,59.09232,1708855
2041,octete,1,0.00006,1009803,59.09237,1708855
2042,odedpeer,1,0.00006,1009804,59.09243,1708855
2043,ohookins,1,0.00006,1009805,59.09249,1708855
2044,OlafSzmidt,1,0.00006,1009806,59.09255,1708855
2045,olamy,1,0.00006,1009807,59.09261,1708855
2046,OMMHOA,1,0.00006,1009808,59.09267,1708855
2047,opinali,1,0.00006,1009809,59.09273,1708855
2048,orlandohohmeier,1,0.00006,1009810,59.09278,1708855
2049,p8952,1,0.00006,1009811,59.09284,1708855
2050,pablochacin,1,0.00006,1009812,59.09290,1708855
2051,pascalandy,1,0.00006,1009813,59.09296,1708855
2052,patelrit,1,0.00006,1009814,59.09302,1708855
2053,PatrickLang,1,0.00006,1009815,59.09308,1708855
2054,paultyng,1,0.00006,1009816,59.09314,1708855
2055,pcbailey,1,0.00006,1009817,59.09319,1708855
2056,pclinger,1,0.00006,1009818,59.09325,1708855
2057,pesama,1,0.00006,1009819,59.09331,1708855
2058,petervandenabeele,1,0.00006,1009820,59.09337,1708855
2059,petrvandrovec,1,0.00006,1009821,59.09343,1708855
2060,pfalcon,1,0.00006,1009822,59.09349,1708855
2061,philipbjorge,1,0.00006,1009823,59.09355,1708855
2062,php-coder,1,0.00006,1009824,59.09360,1708855
2063,phuonghuynh,1,0.00006,1009825,59.09366,1708855
2064,pierrebeaucamp,1,0.00006,1009826,59.09372,1708855
2065,pluttrell,1,0.00006,1009827,59.09378,1708855
2066,porridge,1,0.00006,1009828,59.09384,1708855
2067,posquit0,1,0.00006,1009829,59.09390,1708855
2068,prabhu43,1,0.00006,1009830,59.09395,1708855
2069,PRDinesh,1,0.00006,1009831,59.09401,1708855
2070,priley86,1,0.00006,1009832,59.09407,1708855
2071,prometheanfire,1,0.00006,1009833,59.09413,1708855
2072,psteitz,1,0.00006,1009834,59.09419,1708855
2073,qinix,1,0.00006,1009835,59.09425,1708855
2074,quidryan,1,0.00006,1009836,59.09431,1708855
2075,radu-matei,1,0.00006,1009837,59.09436,1708855
2076,randomvariable,1,0.00006,1009838,59.09442,1708855
2077,ras0219-msft,1,0.00006,1009839,59.09448,1708855
2078,RashmicaG,1,0.00006,1009840,59.09454,1708855
2079,raviqqe,1,0.00006,1009841,59.09460,1708855
2080,rbarazzutti,1,0.00006,1009842,59.09466,1708855
2081,rcoh,1,0.00006,1009843,59.09472,1708855
2082,reimertz,1,0.00006,1009844,59.09477,1708855
2083,reubn,1,0.00006,1009845,59.09483,1708855
2084,Richardinho,1,0.00006,1009846,59.09489,1708855
2085,richerlariviere,1,0.00006,1009847,59.09495,1708855
2086,rickard-von-essen,1,0.00006,1009848,59.09501,1708855
2087,rinokadijk,1,0.00006,1009849,59.09507,1708855
2088,rlubke,1,0.00006,1009850,59.09513,1708855
2089,rmmh,1,0.00006,1009851,59.09518,1708855
2090,robermorales,1,0.00006,1009852,59.09524,1708855
2091,roidayan,1,0.00006,1009853,59.09530,1708855
2092,rpothier,1,0.00006,1009854,59.09536,1708855
2093,rpristopan,1,0.00006,1009855,59.09542,1708855
2094,runcom,1,0.00006,1009856,59.09548,1708855
2095,ryanpetrello,1,0.00006,1009857,59.09553,1708855
2096,ryanwalls,1,0.00006,1009858,59.09559,1708855
2097,saada,1,0.00006,1009859,59.09565,1708855
2098,sagikazarmark,1,0.00006,1009860,59.09571,1708855
2099,sakshamsharma,1,0.00006,1009861,59.09577,1708855
2100,salehe,1,0.00006,1009862,59.09583,1708855
2101,samueltbrown,1,0.00006,1009863,59.09589,1708855
2102,sbstjn,1,0.00006,1009864,59.09594,1708855
2103,schatekar,1,0.00006,1009865,59.09600,1708855
2104,scherler,1,0.00006,1009866,59.09606,1708855
2105,ScottyBauer,1,0.00006,1009867,59.09612,1708855
2106,sdague,1,0.00006,1009868,59.09618,1708855
2107,sean-,1,0.00006,1009869,59.09624,1708855
2108,seaneagan,1,0.00006,1009870,59.09630,1708855
2109,sebastian-philipp,1,0.00006,1009871,59.09635,1708855
2110,seemethere,1,0.00006,1009872,59.09641,1708855
2111,segrax,1,0.00006,1009873,59.09647,1708855
2112,SEJeff,1,0.00006,1009874,59.09653,1708855
2113,serbrech,1,0.00006,1009875,59.09659,1708855
2114,seth-priya,1,0.00006,1009876,59.09665,1708855
2115,sghall,1,0.00006,1009877,59.09671,1708855
2116,Sharpie,1,0.00006,1009878,59.09676,1708855
2117,shawnps,1,0.00006,1009879,59.09682,1708855
2118,shaxbee,1,0.00006,1009880,59.09688,1708855
2119,ShenJack,1,0.00006,1009881,59.09694,1708855
2120,shin-,1,0.00006,1009882,59.09700,1708855
2121,Shrugs,1,0.00006,1009883,59.09706,1708855
2122,siavashs,1,0.00006,1009884,59.09711,1708855
2123,sidnei,1,0.00006,1009885,59.09717,1708855
2124,Simon-Li,1,0.00006,1009886,59.09723,1708855
2125,snowsky,1,0.00006,1009887,59.09729,1708855
2126,solsson,1,0.00006,1009888,59.09735,1708855
2127,sorenh,1,0.00006,1009889,59.09741,1708855
2128,sourcesoft,1,0.00006,1009890,59.09747,1708855
2129,srijs,1,0.00006,1009891,59.09752,1708855
2130,stapelberg,1,0.00006,1009892,59.09758,1708855
2131,Stavrus,1,0.00006,1009893,59.09764,1708855
2132,stefanhendriks,1,0.00006,1009894,59.09770,1708855
2133,stepancheg,1,0.00006,1009895,59.09776,1708855
2134,stephenway,1,0.00006,1009896,59.09782,1708855
2135,stevemcquaid,1,0.00006,1009897,59.09788,1708855
2136,stkevintan,1,0.00006,1009898,59.09793,1708855
2137,stmcginnis,1,0.00006,1009899,59.09799,1708855
2138,SummerWish,1,0.00006,1009900,59.09805,1708855
2139,superbrothers,1,0.00006,1009901,59.09811,1708855
2140,superhighfives,1,0.00006,1009902,59.09817,1708855
2141,superlaziness,1,0.00006,1009903,59.09823,1708855
2142,suryagaddipati,1,0.00006,1009904,59.09829,1708855
2143,suside,1,0.00006,1009905,59.09834,1708855
2144,suwatch,1,0.00006,1009906,59.09840,1708855
2145,svenefftinge,1,0.00006,1009907,59.09846,1708855
2146,sylwit,1,0.00006,1009908,59.09852,1708855
2147,sym3tri,1,0.00006,1009909,59.09858,1708855
2148,t3chnoboy,1,0.00006,1009910,59.09864,1708855
2149,Tahler,1,0.00006,1009911,59.09869,1708855
2150,tcyrus,1,0.00006,1009912,59.09875,1708855
2151,techdragon,1,0.00006,1009913,59.09881,1708855
2152,tedli,1,0.00006,1009914,59.09887,1708855
2153,tedmiston,1,0.00006,1009915,59.09893,1708855
2154,thebeebs,1,0.00006,1009916,59.09899,1708855
2155,thomaschaaf,1,0.00006,1009917,59.09905,1708855
2156,thuey,1,0.00006,1009918,59.09910,1708855
2157,tianhuil,1,0.00006,1009919,59.09916,1708855
2158,timrchavez,1,0.00006,1009920,59.09922,1708855
2159,tjbenton,1,0.00006,1009921,59.09928,1708855
2160,t-miyake,1,0.00006,1009922,59.09934,1708855
2161,tobilarscheid,1,0.00006,1009923,59.09940,1708855
2162,tomwganem,1,0.00006,1009924,59.09946,1708855
2163,tonybaroneee,1,0.00006,1009925,59.09951,1708855
2164,tonycapone,1,0.00006,1009926,59.09957,1708855
2165,tothandras,1,0.00006,1009927,59.09963,1708855
2166,tpounds,1,0.00006,1009928,59.09969,1708855
2167,tr33house,1,0.00006,1009929,59.09975,1708855
2168,treeder,1,0.00006,1009930,59.09981,1708855
2169,treyhyde,1,0.00006,1009931,59.09987,1708855
2170,trofi,1,0.00006,1009932,59.09992,1708855
2171,tslater,1,0.00006,1009933,59.09998,1708855
2172,tsufiev,1,0.00006,1009934,59.10004,1708855
2173,TsuyoshiUshio,1,0.00006,1009935,59.10010,1708855
2174,turb,1,0.00006,1009936,59.10016,1708855
2175,TurboTim,1,0.00006,1009937,59.10022,1708855
2176,typingduck,1,0.00006,1009938,59.10027,1708855
2177,umayr,1,0.00006,1009939,59.10033,1708855
2178,uzilan,1,0.00006,1009940,59.10039,1708855
2179,vadimeisenbergibm,1,0.00006,1009941,59.10045,1708855
2180,veblush,1,0.00006,1009942,59.10051,1708855
2181,victorboissiere,1,0.00006,1009943,59.10057,1708855
2182,vietj,1,0.00006,1009944,59.10063,1708855
2183,vijayrkn,1,0.00006,1009945,59.10068,1708855
2184,vitalyisaev2,1,0.00006,1009946,59.10074,1708855
2185,vongohren,1,0.00006,1009947,59.10080,1708855
2186,vstinner,1,0.00006,1009948,59.10086,1708855
2187,watashiSHUN,1,0.00006,1009949,59.10092,1708855
2188,wbrefvem,1,0.00006,1009950,59.10098,1708855
2189,WGautier,1,0.00006,1009951,59.10104,1708855
2190,wolfgangGoedel,1,0.00006,1009952,59.10109,1708855
2191,wolfs,1,0.00006,1009953,59.10115,1708855
2192,WonyoungChoi,1,0.00006,1009954,59.10121,1708855
2193,woosley,1,0.00006,1009955,59.10127,1708855
2194,workmaster2n,1,0.00006,1009956,59.10133,1708855
2195,wu-sheng,1,0.00006,1009957,59.10139,1708855
2196,x1957,1,0.00006,1009958,59.10145,1708855
2197,xerial,1,0.00006,1009959,59.10150,1708855
2198,xinyanmsft,1,0.00006,1009960,59.10156,1708855
2199,yadoer,1,0.00006,1009961,59.10162,1708855
2200,yanyixing,1,0.00006,1009962,59.10168,1708855
2201,yaojingguo,1,0.00006,1009963,59.10174,1708855
2202,yaronr,1,0.00006,1009964,59.10180,1708855
2203,yissachar,1,0.00006,1009965,59.10185,1708855
2204,yourcelf,1,0.00006,1009966,59.10191,1708855
2205,yowakita,1,0.00006,1009967,59.10197,1708855
2206,ytan29,1,0.00006,1009968,59.10203,1708855
2207,yury,1,0.00006,1009969,59.10209,1708855
2208,zcwang,1,0.00006,1009970,59.10215,1708855
2209,zhe,1,0.00006,1009971,59.10221,1708855
2210,zhexuany,1,0.00006,1009972,59.10226,1708855
2211,zhuscat,1,0.00006,1009973,59.10232,1708855
2212,ZZITE,1,0.00006,1009974,59.10238,1708855
