rank_number,actor,events,percent,cumulative_sum,cumulative_percent,all_events
1,matthiashanel,299,1.34916,299,1.34916,22162
2,lparis,43,0.19403,342,1.54318,22162
3,ronag,34,0.15342,376,1.69660,22162
4,sfrooster,34,0.15342,410,1.85001,22162
5,rigtorp,23,0.10378,433,1.95379,22162
6,jasper-d,21,0.09476,454,2.04855,22162
7,stjepang,20,0.09024,474,2.13880,22162
8,juandiegopalomino,18,0.08122,492,2.22002,22162
9,wutkemtt,18,0.08122,510,2.30124,22162
10,peng-w,16,0.07220,526,2.37343,22162
11,tpihl,15,0.06768,541,2.44112,22162
12,jgaskins,14,0.06317,555,2.50429,22162
13,madgrenadier,14,0.06317,569,2.56746,22162
14,unisqu,14,0.06317,583,2.63063,22162
15,biskit,13,0.05866,596,2.68929,22162
16,MartinForReal,13,0.05866,609,2.74795,22162
17,mmanna-sapfgl,13,0.05866,622,2.80661,22162
18,nuss-justin,13,0.05866,635,2.86526,22162
19,s-shin,13,0.05866,648,2.92392,22162
20,film42,12,0.05415,660,2.97807,22162
21,harold-toledo,12,0.05415,672,3.03222,22162
22,pananton,11,0.04963,683,3.08185,22162
23,zhaoyao91,11,0.04963,694,3.13149,22162
24,AaronFriel,9,0.04061,703,3.17210,22162
25,arekkas,9,0.04061,712,3.21271,22162
26,guilherme-santos,9,0.04061,721,3.25332,22162
27,jmptrader,9,0.04061,730,3.29393,22162
28,MaruHyl,9,0.04061,739,3.33454,22162
29,Ryner51,9,0.04061,748,3.37515,22162
30,sujitn,9,0.04061,757,3.41576,22162
31,0taste,8,0.03610,765,3.45185,22162
32,jebbench,8,0.03610,773,3.48795,22162
33,nithinkd-geon,8,0.03610,781,3.52405,22162
34,rafw,8,0.03610,789,3.56015,22162
35,SkinnySackboy,8,0.03610,797,3.59625,22162
36,tegk,8,0.03610,805,3.63234,22162
37,YoninL,8,0.03610,813,3.66844,22162
38,asafyish,7,0.03159,820,3.70003,22162
39,avatarneil,7,0.03159,827,3.73161,22162
40,ayaya118,7,0.03159,834,3.76320,22162
41,basti1302,7,0.03159,841,3.79478,22162
42,bkim54,7,0.03159,848,3.82637,22162
43,CarloWakefield,7,0.03159,855,3.85796,22162
44,DeployChef,7,0.03159,862,3.88954,22162
45,joeblew99,7,0.03159,869,3.92113,22162
46,mackeyja92,7,0.03159,876,3.95271,22162
47,Manuri,7,0.03159,883,3.98430,22162
48,sebastien-curutchet,7,0.03159,890,4.01588,22162
49,shohi,7,0.03159,897,4.04747,22162
50,tamnm,7,0.03159,904,4.07905,22162
51,ThomasVestergaard,7,0.03159,911,4.11064,22162
52,xzzh999,7,0.03159,918,4.14223,22162
53,aforward,6,0.02707,924,4.16930,22162
54,bfoxstudio,6,0.02707,930,4.19637,22162
55,brianshannan,6,0.02707,936,4.22345,22162
56,brianshannan-wf,6,0.02707,942,4.25052,22162
57,CaptainYarb,6,0.02707,948,4.27759,22162
58,cee-dub,6,0.02707,954,4.30467,22162
59,chilly,6,0.02707,960,4.33174,22162
60,edam,6,0.02707,966,4.35881,22162
61,gedw99,6,0.02707,972,4.38589,22162
62,ishbir,6,0.02707,978,4.41296,22162
63,jason-magnetic-io,6,0.02707,984,4.44003,22162
64,jfathman,6,0.02707,990,4.46711,22162
65,kirooha,6,0.02707,996,4.49418,22162
66,leenux,6,0.02707,1002,4.52125,22162
67,lipengyuntian,6,0.02707,1008,4.54833,22162
68,maruqu,6,0.02707,1014,4.57540,22162
69,Mr7Sir,6,0.02707,1020,4.60247,22162
70,robertfreund,6,0.02707,1026,4.62955,22162
71,Sergey-Terekhin,6,0.02707,1032,4.65662,22162
72,shanurrahman,6,0.02707,1038,4.68369,22162
73,streetlist,6,0.02707,1044,4.71077,22162
74,timboudreau,6,0.02707,1050,4.73784,22162
75,wrightleft,6,0.02707,1056,4.76491,22162
76,yuce,6,0.02707,1062,4.79199,22162
77,azrle,5,0.02256,1067,4.81455,22162
78,baconalot,5,0.02256,1072,4.83711,22162
79,bruth,5,0.02256,1077,4.85967,22162
80,Cingulara,5,0.02256,1082,4.88223,22162
81,cmfatih,5,0.02256,1087,4.90479,22162
82,cpani,5,0.02256,1092,4.92735,22162
83,davidkemper,5,0.02256,1097,4.94991,22162
84,ekoeryanto,5,0.02256,1102,4.97248,22162
85,FarhanSajid1,5,0.02256,1107,4.99504,22162
86,flowerinthenight,5,0.02256,1112,5.01760,22162
87,gertcuykens,5,0.02256,1117,5.04016,22162
88,heijiu,5,0.02256,1122,5.06272,22162
89,igoberman,5,0.02256,1127,5.08528,22162
90,Imaskar,5,0.02256,1132,5.10784,22162
91,itn3000,5,0.02256,1137,5.13040,22162
92,Jagatjot,5,0.02256,1142,5.15296,22162
93,kthomas,5,0.02256,1147,5.17553,22162
94,kylos101,5,0.02256,1152,5.19809,22162
95,maksimenko-stanislav,5,0.02256,1157,5.22065,22162
96,meiswjn,5,0.02256,1162,5.24321,22162
97,mennanov,5,0.02256,1167,5.26577,22162
98,natiki,5,0.02256,1172,5.28833,22162
99,nickcarenza,5,0.02256,1177,5.31089,22162
100,nussjustin,5,0.02256,1182,5.33345,22162
101,purple4reina,5,0.02256,1187,5.35601,22162
102,pysiekytel,5,0.02256,1192,5.37858,22162
103,ramasa,5,0.02256,1197,5.40114,22162
104,rchenzheng,5,0.02256,1202,5.42370,22162
105,s921102002,5,0.02256,1207,5.44626,22162
106,sateffen,5,0.02256,1212,5.46882,22162
107,senzacionale,5,0.02256,1217,5.49138,22162
108,shaunc,5,0.02256,1222,5.51394,22162
109,steventanwc,5,0.02256,1227,5.53650,22162
110,wanlinus,5,0.02256,1232,5.55907,22162
111,xorgy,5,0.02256,1237,5.58163,22162
112,zackws,5,0.02256,1242,5.60419,22162
113,Aavon,4,0.01805,1246,5.62224,22162
114,acro5piano,4,0.01805,1250,5.64029,22162
115,alanyeung95,4,0.01805,1254,5.65833,22162
116,alexpantyukhin,4,0.01805,1258,5.67638,22162
117,altSoftLLC,4,0.01805,1262,5.69443,22162
118,arden,4,0.01805,1266,5.71248,22162
119,asterite,4,0.01805,1270,5.73053,22162
120,belevtsev,4,0.01805,1274,5.74858,22162
121,blazedd,4,0.01805,1278,5.76663,22162
122,camp-007,4,0.01805,1282,5.78468,22162
123,chiaolun,4,0.01805,1286,5.80273,22162
124,cOckTHell,4,0.01805,1290,5.82077,22162
125,coffeefedora,4,0.01805,1294,5.83882,22162
126,custa,4,0.01805,1298,5.85687,22162
127,CycoPH,4,0.01805,1302,5.87492,22162
128,czlbaiyi,4,0.01805,1306,5.89297,22162
129,dioptre,4,0.01805,1310,5.91102,22162
130,dlabey,4,0.01805,1314,5.92907,22162
131,dmpriso,4,0.01805,1318,5.94712,22162
132,doshyt,4,0.01805,1322,5.96517,22162
133,drauch,4,0.01805,1326,5.98321,22162
134,GingerMoon,4,0.01805,1330,6.00126,22162
135,gitchander,4,0.01805,1334,6.01931,22162
136,hidai,4,0.01805,1338,6.03736,22162
137,hsinhoyeh,4,0.01805,1342,6.05541,22162
138,ievgen-kolomiiets,4,0.01805,1346,6.07346,22162
139,ingosus,4,0.01805,1350,6.09151,22162
140,jirenius,4,0.01805,1354,6.10956,22162
141,jjp91,4,0.01805,1358,6.12761,22162
142,jmwilkinson,4,0.01805,1362,6.14565,22162
143,JulianZhao,4,0.01805,1366,6.16370,22162
144,KauzClay,4,0.01805,1370,6.18175,22162
145,Kazmirchuk,4,0.01805,1374,6.19980,22162
146,Ketharan,4,0.01805,1378,6.21785,22162
147,Kikimora,4,0.01805,1382,6.23590,22162
148,KoryNunn,4,0.01805,1386,6.25395,22162
149,lorenzoisidori21,4,0.01805,1390,6.27200,22162
150,lukaf,4,0.01805,1394,6.29005,22162
151,m4ce,4,0.01805,1398,6.30809,22162
152,mctully,4,0.01805,1402,6.32614,22162
153,mdevan,4,0.01805,1406,6.34419,22162
154,minhnt95,4,0.01805,1410,6.36224,22162
155,monopollly,4,0.01805,1414,6.38029,22162
156,moon-bits,4,0.01805,1418,6.39834,22162
157,nuhamind2,4,0.01805,1422,6.41639,22162
158,pedrouid,4,0.01805,1426,6.43444,22162
159,peterwald,4,0.01805,1430,6.45249,22162
160,phynias,4,0.01805,1434,6.47054,22162
161,RedShift1,4,0.01805,1438,6.48858,22162
162,reidlai,4,0.01805,1442,6.50663,22162
163,savaki,4,0.01805,1446,6.52468,22162
164,selstam,4,0.01805,1450,6.54273,22162
165,shaiaTradair,4,0.01805,1454,6.56078,22162
166,shanna,4,0.01805,1458,6.57883,22162
167,sujeshthekkepatt,4,0.01805,1462,6.59688,22162
168,tomponline,4,0.01805,1466,6.61493,22162
169,viktorm77,4,0.01805,1470,6.63298,22162
170,vpol,4,0.01805,1474,6.65102,22162
171,wanjunlei,4,0.01805,1478,6.66907,22162
172,xiaomi-tc,4,0.01805,1482,6.68712,22162
173,yireyun,4,0.01805,1486,6.70517,22162
174,zombiecong,4,0.01805,1490,6.72322,22162
175,3asm,3,0.01354,1493,6.73676,22162
176,6ecuk,3,0.01354,1496,6.75029,22162
177,abacaj,3,0.01354,1499,6.76383,22162
178,alexanderinochkin,3,0.01354,1502,6.77737,22162
179,alifpay,3,0.01354,1505,6.79090,22162
180,andyl,3,0.01354,1508,6.80444,22162
181,aratz-lasa,3,0.01354,1511,6.81798,22162
182,arminbuerkle,3,0.01354,1514,6.83151,22162
183,artyomturkin,3,0.01354,1517,6.84505,22162
184,asbapat,3,0.01354,1520,6.85859,22162
185,asdonation,3,0.01354,1523,6.87212,22162
186,baoyachi,3,0.01354,1526,6.88566,22162
187,blelump,3,0.01354,1529,6.89920,22162
188,BrannonKing,3,0.01354,1532,6.91273,22162
189,Britvich,3,0.01354,1535,6.92627,22162
190,byazrail,3,0.01354,1538,6.93981,22162
191,charles-d-burton,3,0.01354,1541,6.95334,22162
192,chendo,3,0.01354,1544,6.96688,22162
193,ChenYida,3,0.01354,1547,6.98042,22162
194,cjbhaines,3,0.01354,1550,6.99395,22162
195,ckim0419,3,0.01354,1553,7.00749,22162
196,CKing,3,0.01354,1556,7.02103,22162
197,codmajik,3,0.01354,1559,7.03456,22162
198,colek42,3,0.01354,1562,7.04810,22162
199,complex64,3,0.01354,1565,7.06164,22162
200,costa,3,0.01354,1568,7.07517,22162
201,crozzy,3,0.01354,1571,7.08871,22162
202,daghb,3,0.01354,1574,7.10225,22162
203,david-hex,3,0.01354,1577,7.11578,22162
204,dbeecham,3,0.01354,1580,7.12932,22162
205,def1oyd,3,0.01354,1583,7.14286,22162
206,delfick,3,0.01354,1586,7.15639,22162
207,derekbekoe,3,0.01354,1589,7.16993,22162
208,devKlausS,3,0.01354,1592,7.18347,22162
209,DoMySon,3,0.01354,1595,7.19700,22162
210,dtoubelis,3,0.01354,1598,7.21054,22162
211,dvasko,3,0.01354,1601,7.22408,22162
212,fmvin,3,0.01354,1604,7.23761,22162
213,gaohuag,3,0.01354,1607,7.25115,22162
214,garrardkitchen,3,0.01354,1610,7.26469,22162
215,gnarea,3,0.01354,1613,7.27822,22162
216,hansonkd,3,0.01354,1616,7.29176,22162
217,haoch,3,0.01354,1619,7.30530,22162
218,harrisa1,3,0.01354,1622,7.31883,22162
219,haseebq,3,0.01354,1625,7.33237,22162
220,hesidoryn,3,0.01354,1628,7.34591,22162
221,highfield,3,0.01354,1631,7.35944,22162
222,holem,3,0.01354,1634,7.37298,22162
223,huangyigui,3,0.01354,1637,7.38652,22162
224,israellot,3,0.01354,1640,7.40005,22162
225,jdoig,3,0.01354,1643,7.41359,22162
226,JnMik,3,0.01354,1646,7.42713,22162
227,jnsone11,3,0.01354,1649,7.44066,22162
228,JohnnyQQQQ,3,0.01354,1652,7.45420,22162
229,johnsusi,3,0.01354,1655,7.46774,22162
230,jupiter,3,0.01354,1658,7.48127,22162
231,kapralius,3,0.01354,1661,7.49481,22162
232,karliky,3,0.01354,1664,7.50835,22162
233,kirill256,3,0.01354,1667,7.52188,22162
234,kkocel,3,0.01354,1670,7.53542,22162
235,KORuL,3,0.01354,1673,7.54896,22162
236,korzhev,3,0.01354,1676,7.56249,22162
237,labsvisual,3,0.01354,1679,7.57603,22162
238,lammel,3,0.01354,1682,7.58957,22162
239,LaurensVergote,3,0.01354,1685,7.60310,22162
240,leifg,3,0.01354,1688,7.61664,22162
241,linux-support,3,0.01354,1691,7.63018,22162
242,lucwillems,3,0.01354,1694,7.64371,22162
243,mareksoluch,3,0.01354,1697,7.65725,22162
244,MateuszPluciennik,3,0.01354,1700,7.67079,22162
245,matti,3,0.01354,1703,7.68432,22162
246,museghost,3,0.01354,1706,7.69786,22162
247,nicogon,3,0.01354,1709,7.71140,22162
248,njern,3,0.01354,1712,7.72493,22162
249,oaStuff,3,0.01354,1715,7.73847,22162
250,oncicaradupopovici,3,0.01354,1718,7.75201,22162
251,opoudjis,3,0.01354,1721,7.76554,22162
252,perrohunter,3,0.01354,1724,7.77908,22162
253,phifty,3,0.01354,1727,7.79262,22162
254,philipfoulkes,3,0.01354,1730,7.80615,22162
255,pivotal-jamil-shamy,3,0.01354,1733,7.81969,22162
256,rafsawicki,3,0.01354,1736,7.83323,22162
257,rajugupta15,3,0.01354,1739,7.84676,22162
258,rakeshv1,3,0.01354,1742,7.86030,22162
259,renanberto,3,0.01354,1745,7.87384,22162
260,ricbartm,3,0.01354,1748,7.88737,22162
261,rockymadden,3,0.01354,1751,7.90091,22162
262,rudyjantz,3,0.01354,1754,7.91445,22162
263,runech,3,0.01354,1757,7.92798,22162
264,ryancurtin,3,0.01354,1760,7.94152,22162
265,rybit,3,0.01354,1763,7.95506,22162
266,sah4ez,3,0.01354,1766,7.96859,22162
267,santo74,3,0.01354,1769,7.98213,22162
268,scunningham,3,0.01354,1772,7.99567,22162
269,ShawnMilo,3,0.01354,1775,8.00920,22162
270,sheenobu,3,0.01354,1778,8.02274,22162
271,shengery,3,0.01354,1781,8.03628,22162
272,smortex,3,0.01354,1784,8.04981,22162
273,ssoroka,3,0.01354,1787,8.06335,22162
274,tharrold,3,0.01354,1790,8.07689,22162
275,The-Alchemist,3,0.01354,1793,8.09043,22162
276,tr8dr,3,0.01354,1796,8.10396,22162
277,tvalletta,3,0.01354,1799,8.11750,22162
278,tw4dl,3,0.01354,1802,8.13104,22162
279,twang2218,3,0.01354,1805,8.14457,22162
280,typusomega,3,0.01354,1808,8.15811,22162
281,uwillis,3,0.01354,1811,8.17165,22162
282,vertti,3,0.01354,1814,8.18518,22162
283,vikram1601,3,0.01354,1817,8.19872,22162
284,vjpr,3,0.01354,1820,8.21226,22162
285,whynowy,3,0.01354,1823,8.22579,22162
286,wjbakker,3,0.01354,1826,8.23933,22162
287,wustrong,3,0.01354,1829,8.25287,22162
288,xianghu1314,3,0.01354,1832,8.26640,22162
289,yavuzyurtbegendi,3,0.01354,1835,8.27994,22162
290,zhaodanwjk,3,0.01354,1838,8.29348,22162
291,znbang,3,0.01354,1841,8.30701,22162
292,zoni,3,0.01354,1844,8.32055,22162
293,zrob,3,0.01354,1847,8.33409,22162
294,06wagon,2,0.00902,1849,8.34311,22162
295,0xflotus,2,0.00902,1851,8.35213,22162
296,2dev2,2,0.00902,1853,8.36116,22162
297,4nte,2,0.00902,1855,8.37018,22162
298,a36233,2,0.00902,1857,8.37921,22162
299,abrandoned,2,0.00902,1859,8.38823,22162
300,Agronis,2,0.00902,1861,8.39726,22162
301,ajoubertza,2,0.00902,1863,8.40628,22162
302,akahan,2,0.00902,1865,8.41531,22162
303,akoenig,2,0.00902,1867,8.42433,22162
304,AlaRuba,2,0.00902,1869,8.43335,22162
305,alexander-klang,2,0.00902,1871,8.44238,22162
306,Amardaya,2,0.00902,1873,8.45140,22162
307,amunhoz,2,0.00902,1875,8.46043,22162
308,AnatoliiPrylutskyi,2,0.00902,1877,8.46945,22162
309,AnatolyKap,2,0.00902,1879,8.47848,22162
310,Ansudeen,2,0.00902,1881,8.48750,22162
311,arajitsamanta,2,0.00902,1883,8.49653,22162
312,arush15june,2,0.00902,1885,8.50555,22162
313,AshfordN,2,0.00902,1887,8.51457,22162
314,asialiugf,2,0.00902,1889,8.52360,22162
315,asnimansari,2,0.00902,1891,8.53262,22162
316,atye,2,0.00902,1893,8.54165,22162
317,avrono,2,0.00902,1895,8.55067,22162
318,bagguley,2,0.00902,1897,8.55970,22162
319,bahatron,2,0.00902,1899,8.56872,22162
320,balamuru,2,0.00902,1901,8.57775,22162
321,barn3y,2,0.00902,1903,8.58677,22162
322,barrachri,2,0.00902,1905,8.59579,22162
323,baygeldin,2,0.00902,1907,8.60482,22162
324,bennyr103,2,0.00902,1909,8.61384,22162
325,bh90210,2,0.00902,1911,8.62287,22162
326,BigJoe01,2,0.00902,1913,8.63189,22162
327,bobthekingofegypt,2,0.00902,1915,8.64092,22162
328,boomfly,2,0.00902,1917,8.64994,22162
329,BruceWangNo1,2,0.00902,1919,8.65897,22162
330,brvith,2,0.00902,1921,8.66799,22162
331,buybackoff,2,0.00902,1923,8.67701,22162
332,CameronAckermanSEL,2,0.00902,1925,8.68604,22162
333,ccqpein,2,0.00902,1927,8.69506,22162
334,ChainGank,2,0.00902,1929,8.70409,22162
335,chenmarko,2,0.00902,1931,8.71311,22162
336,chimirala,2,0.00902,1933,8.72214,22162
337,chowyu08,2,0.00902,1935,8.73116,22162
338,chunytan,2,0.00902,1937,8.74019,22162
339,cjg1990,2,0.00902,1939,8.74921,22162
340,clanstyles,2,0.00902,1941,8.75823,22162
341,codecandy2015,2,0.00902,1943,8.76726,22162
342,codergr,2,0.00902,1945,8.77628,22162
343,codinggg,2,0.00902,1947,8.78531,22162
344,CoffiDev,2,0.00902,1949,8.79433,22162
345,cogmeta,2,0.00902,1951,8.80336,22162
346,composer22,2,0.00902,1953,8.81238,22162
347,coolyrat,2,0.00902,1955,8.82141,22162
348,Corni,2,0.00902,1957,8.83043,22162
349,cosmicnag,2,0.00902,1959,8.83945,22162
350,cosmonawt,2,0.00902,1961,8.84848,22162
351,damarus-qa,2,0.00902,1963,8.85750,22162
352,danielsdeleo,2,0.00902,1965,8.86653,22162
353,danlanxiaohei,2,0.00902,1967,8.87555,22162
354,Darkclainer,2,0.00902,1969,8.88458,22162
355,darrenclark,2,0.00902,1971,8.89360,22162
356,david-gurley,2,0.00902,1973,8.90263,22162
357,davisford,2,0.00902,1975,8.91165,22162
358,dbskccc,2,0.00902,1977,8.92068,22162
359,dc0d,2,0.00902,1979,8.92970,22162
360,deviantmk,2,0.00902,1981,8.93872,22162
361,dhickie,2,0.00902,1983,8.94775,22162
362,digitalnomd,2,0.00902,1985,8.95677,22162
363,dkavraal,2,0.00902,1987,8.96580,22162
364,dkoston,2,0.00902,1989,8.97482,22162
365,dominic-pockit,2,0.00902,1991,8.98385,22162
366,dwaynebradley,2,0.00902,1993,8.99287,22162
367,dxj910804,2,0.00902,1995,9.00190,22162
368,earnric,2,0.00902,1997,9.01092,22162
369,egilsster,2,0.00902,1999,9.01994,22162
370,egoon,2,0.00902,2001,9.02897,22162
371,eigood,2,0.00902,2003,9.03799,22162
372,eisig,2,0.00902,2005,9.04702,22162
373,erikbgithub,2,0.00902,2007,9.05604,22162
374,expelledboy,2,0.00902,2009,9.06507,22162
375,eymkey2,2,0.00902,2011,9.07409,22162
376,fabioyy,2,0.00902,2013,9.08312,22162
377,fajran,2,0.00902,2015,9.09214,22162
378,FengMInng,2,0.00902,2017,9.10116,22162
379,ferdianr,2,0.00902,2019,9.11019,22162
380,feribg,2,0.00902,2021,9.11921,22162
381,firrae,2,0.00902,2023,9.12824,22162
382,FlightToFreedom,2,0.00902,2025,9.13726,22162
383,fosk06,2,0.00902,2027,9.14629,22162
384,friism,2,0.00902,2029,9.15531,22162
385,FSteynberg01,2,0.00902,2031,9.16434,22162
386,fxfactorial,2,0.00902,2033,9.17336,22162
387,gaozhidf,2,0.00902,2035,9.18238,22162
388,gauravpp,2,0.00902,2037,9.19141,22162
389,gfmartins,2,0.00902,2039,9.20043,22162
390,gillesdemey,2,0.00902,2041,9.20946,22162
391,GlurG,2,0.00902,2043,9.21848,22162
392,grbr,2,0.00902,2045,9.22751,22162
393,Greatsamps,2,0.00902,2047,9.23653,22162
394,gtr32x,2,0.00902,2049,9.24556,22162
395,gun1x,2,0.00902,2051,9.25458,22162
396,gunnaringe,2,0.00902,2053,9.26360,22162
397,HannaKraft,2,0.00902,2055,9.27263,22162
398,hendrakwong,2,0.00902,2057,9.28165,22162
399,hsahuntnx,2,0.00902,2059,9.29068,22162
400,huangjunwen,2,0.00902,2061,9.29970,22162
401,hubinix,2,0.00902,2063,9.30873,22162
402,hungrymike,2,0.00902,2065,9.31775,22162
403,hvt,2,0.00902,2067,9.32678,22162
404,ibmendoza,2,0.00902,2069,9.33580,22162
405,IgorKey,2,0.00902,2071,9.34482,22162
406,ikkyuland,2,0.00902,2073,9.35385,22162
407,iliesh,2,0.00902,2075,9.36287,22162
408,illuminati-RV,2,0.00902,2077,9.37190,22162
409,invertigo,2,0.00902,2079,9.38092,22162
410,ipfans,2,0.00902,2081,9.38995,22162
411,ivanperez-mb,2,0.00902,2083,9.39897,22162
412,ivanrodolfo,2,0.00902,2085,9.40800,22162
413,jacktuck,2,0.00902,2087,9.41702,22162
414,james-andrewsmith,2,0.00902,2089,9.42604,22162
415,jamiesonbecker,2,0.00902,2091,9.43507,22162
416,JAndritsch,2,0.00902,2093,9.44409,22162
417,jdolce,2,0.00902,2095,9.45312,22162
418,jdvor,2,0.00902,2097,9.46214,22162
419,jeffkirby,2,0.00902,2099,9.47117,22162
420,jensenbox,2,0.00902,2101,9.48019,22162
421,jeroenrinzema,2,0.00902,2103,9.48922,22162
422,JesusIslam,2,0.00902,2105,9.49824,22162
423,jjcarstens,2,0.00902,2107,9.50726,22162
424,johnsiu2016,2,0.00902,2109,9.51629,22162
425,johnwlockwood,2,0.00902,2111,9.52531,22162
426,johnyborek,2,0.00902,2113,9.53434,22162
427,JoHuang,2,0.00902,2115,9.54336,22162
428,jorispz,2,0.00902,2117,9.55239,22162
429,joshglendenning,2,0.00902,2119,9.56141,22162
430,jprando,2,0.00902,2121,9.57044,22162
431,jpsilvagallino,2,0.00902,2123,9.57946,22162
432,julianbueno,2,0.00902,2125,9.58848,22162
433,kalleep,2,0.00902,2127,9.59751,22162
434,Kannaj,2,0.00902,2129,9.60653,22162
435,kaspertygesen,2,0.00902,2131,9.61556,22162
436,kcarlson2915,2,0.00902,2133,9.62458,22162
437,kethan,2,0.00902,2135,9.63361,22162
438,kiddpt,2,0.00902,2137,9.64263,22162
439,kingkorf,2,0.00902,2139,9.65166,22162
440,kirbyclover,2,0.00902,2141,9.66068,22162
441,kmfk,2,0.00902,2143,9.66970,22162
442,Krule,2,0.00902,2145,9.67873,22162
443,KrzysztofKielce,2,0.00902,2147,9.68775,22162
444,ksachdeva,2,0.00902,2149,9.69678,22162
445,Ksero,2,0.00902,2151,9.70580,22162
446,kuange,2,0.00902,2153,9.71483,22162
447,kurbar,2,0.00902,2155,9.72385,22162
448,kzeoprf22,2,0.00902,2157,9.73288,22162
449,laishzh,2,0.00902,2159,9.74190,22162
450,Lazin,2,0.00902,2161,9.75093,22162
451,Lazyshot,2,0.00902,2163,9.75995,22162
452,leeson1995,2,0.00902,2165,9.76897,22162
453,lemonkey,2,0.00902,2167,9.77800,22162
454,lenovouser,2,0.00902,2169,9.78702,22162
455,lightwinglc,2,0.00902,2171,9.79605,22162
456,ljfuyuan,2,0.00902,2173,9.80507,22162
457,loint,2,0.00902,2175,9.81410,22162
458,longwallstreet,2,0.00902,2177,9.82312,22162
459,loremaps,2,0.00902,2179,9.83215,22162
460,lostz,2,0.00902,2181,9.84117,22162
461,lovew,2,0.00902,2183,9.85019,22162
462,lysakaleksey,2,0.00902,2185,9.85922,22162
463,mabouchalkha,2,0.00902,2187,9.86824,22162
464,mabzd,2,0.00902,2189,9.87727,22162
465,magdkudama,2,0.00902,2191,9.88629,22162
466,ManojGopan,2,0.00902,2193,9.89532,22162
467,mar1ged,2,0.00902,2195,9.90434,22162
468,marcosflobo,2,0.00902,2197,9.91337,22162
469,markuslindenberg,2,0.00902,2199,9.92239,22162
470,marmotini,2,0.00902,2201,9.93141,22162
471,martende,2,0.00902,2203,9.94044,22162
472,MartinLeedotOrg,2,0.00902,2205,9.94946,22162
473,mattharr-is,2,0.00902,2207,9.95849,22162
474,matthewhartstonge,2,0.00902,2209,9.96751,22162
475,meetme2meat,2,0.00902,2211,9.97654,22162
476,meraghi,2,0.00902,2213,9.98556,22162
477,metalwood,2,0.00902,2215,9.99459,22162
478,MichaelErmer,2,0.00902,2217,10.00361,22162
479,mlipovsky,2,0.00902,2219,10.01263,22162
480,MohanGyara,2,0.00902,2221,10.02166,22162
481,moitias,2,0.00902,2223,10.03068,22162
482,mosesBD,2,0.00902,2225,10.03971,22162
483,mrbastian,2,0.00902,2227,10.04873,22162
484,mtancoigne,2,0.00902,2229,10.05776,22162
485,Nargarnd,2,0.00902,2231,10.06678,22162
486,naveedh27,2,0.00902,2233,10.07581,22162
487,ncalibey,2,0.00902,2235,10.08483,22162
488,ndegory,2,0.00902,2237,10.09385,22162
489,nellson,2,0.00902,2239,10.10288,22162
490,neoaggelos,2,0.00902,2241,10.11190,22162
491,nghuyong,2,0.00902,2243,10.12093,22162
492,notbdu,2,0.00902,2245,10.12995,22162
493,nxtbr,2,0.00902,2247,10.13898,22162
494,oblalex,2,0.00902,2249,10.14800,22162
495,ogoun,2,0.00902,2251,10.15703,22162
496,olehcambel,2,0.00902,2253,10.16605,22162
497,olivr70,2,0.00902,2255,10.17507,22162
498,Olshansk,2,0.00902,2257,10.18410,22162
499,omenv,2,0.00902,2259,10.19312,22162
500,PATAPOsha,2,0.00902,2261,10.20215,22162
501,patricio78,2,0.00902,2263,10.21117,22162
502,paulormart,2,0.00902,2265,10.22020,22162
503,pbalash0v,2,0.00902,2267,10.22922,22162
504,PBug90,2,0.00902,2269,10.23825,22162
505,pengux,2,0.00902,2271,10.24727,22162
506,per-ove,2,0.00902,2273,10.25629,22162
507,pikot,2,0.00902,2275,10.26532,22162
508,praynise,2,0.00902,2277,10.27434,22162
509,pritambaral,2,0.00902,2279,10.28337,22162
510,purDgr8,2,0.00902,2281,10.29239,22162
511,qtheya,2,0.00902,2283,10.30142,22162
512,ragizo,2,0.00902,2285,10.31044,22162
513,Ravenwater,2,0.00902,2287,10.31947,22162
514,ray-verys,2,0.00902,2289,10.32849,22162
515,remorses,2,0.00902,2291,10.33751,22162
516,remotegun,2,0.00902,2293,10.34654,22162
517,rfw,2,0.00902,2295,10.35556,22162
518,ritesh4302,2,0.00902,2297,10.36459,22162
519,rohit-ravikoti,2,0.00902,2299,10.37361,22162
520,ronezra3,2,0.00902,2301,10.38264,22162
521,rse,2,0.00902,2303,10.39166,22162
522,ryanfaerman,2,0.00902,2305,10.40069,22162
523,sammy007,2,0.00902,2307,10.40971,22162
524,samstride,2,0.00902,2309,10.41873,22162
525,satishb557,2,0.00902,2311,10.42776,22162
526,sazo,2,0.00902,2313,10.43678,22162
527,scorpion9111,2,0.00902,2315,10.44581,22162
528,setheen,2,0.00902,2317,10.45483,22162
529,shadiakiki1986,2,0.00902,2319,10.46386,22162
530,shaneiseminger,2,0.00902,2321,10.47288,22162
531,shantanubansal,2,0.00902,2323,10.48191,22162
532,shilov,2,0.00902,2325,10.49093,22162
533,simon-miao,2,0.00902,2327,10.49995,22162
534,simonrussell,2,0.00902,2329,10.50898,22162
535,sixeyed,2,0.00902,2331,10.51800,22162
536,skoskav,2,0.00902,2333,10.52703,22162
537,skrusty,2,0.00902,2335,10.53605,22162
538,skyr1der,2,0.00902,2337,10.54508,22162
539,smithwinston,2,0.00902,2339,10.55410,22162
540,sneat,2,0.00902,2341,10.56313,22162
541,squarism,2,0.00902,2343,10.57215,22162
542,stephenprater,2,0.00902,2345,10.58117,22162
543,suever,2,0.00902,2347,10.59020,22162
544,suhothayan,2,0.00902,2349,10.59922,22162
545,swdee,2,0.00902,2351,10.60825,22162
546,te-brevik,2,0.00902,2353,10.61727,22162
547,tehsphinx,2,0.00902,2355,10.62630,22162
548,teivah,2,0.00902,2357,10.63532,22162
549,theduman,2,0.00902,2359,10.64435,22162
550,themartorana,2,0.00902,2361,10.65337,22162
551,thetooth,2,0.00902,2363,10.66240,22162
552,thlu-cobinhood,2,0.00902,2365,10.67142,22162
553,timosellin,2,0.00902,2367,10.68044,22162
554,tjmcarthur,2,0.00902,2369,10.68947,22162
555,tkgreg,2,0.00902,2371,10.69849,22162
556,toddschilling,2,0.00902,2373,10.70752,22162
557,tokheim,2,0.00902,2375,10.71654,22162
558,tomByrer,2,0.00902,2377,10.72557,22162
559,tshev,2,0.00902,2379,10.73459,22162
560,twrobel3,2,0.00902,2381,10.74362,22162
561,UA3MQJ,2,0.00902,2383,10.75264,22162
562,upengs,2,0.00902,2385,10.76166,22162
563,userlocalhost2000,2,0.00902,2387,10.77069,22162
564,vanseverk,2,0.00902,2389,10.77971,22162
565,vasergen,2,0.00902,2391,10.78874,22162
566,videlov,2,0.00902,2393,10.79776,22162
567,vk-coder,2,0.00902,2395,10.80679,22162
568,vl409,2,0.00902,2397,10.81581,22162
569,vm-affekt,2,0.00902,2399,10.82484,22162
570,vramanx,2,0.00902,2401,10.83386,22162
571,vsundupey,2,0.00902,2403,10.84288,22162
572,waffle-iron,2,0.00902,2405,10.85191,22162
573,warmwine,2,0.00902,2407,10.86093,22162
574,wizcas,2,0.00902,2409,10.86996,22162
575,wjzhangcsu,2,0.00902,2411,10.87898,22162
576,WoLfulus,2,0.00902,2413,10.88801,22162
577,xoridius,2,0.00902,2415,10.89703,22162
578,xsellier,2,0.00902,2417,10.90606,22162
579,xy02,2,0.00902,2419,10.91508,22162
580,yanivge,2,0.00902,2421,10.92410,22162
581,yanpozka,2,0.00902,2423,10.93313,22162
582,yehezkielbs,2,0.00902,2425,10.94215,22162
583,yhslln,2,0.00902,2427,10.95118,22162
584,Yugloocamai,2,0.00902,2429,10.96020,22162
585,zamap,2,0.00902,2431,10.96923,22162
586,zhhnzw,2,0.00902,2433,10.97825,22162
587,zhuoqiang,2,0.00902,2435,10.98728,22162
588,zyc801208,2,0.00902,2437,10.99630,22162
589,zzh1414080903218,2,0.00902,2439,11.00532,22162
590,140am,1,0.00451,2440,11.00984,22162
591,23caterpie,1,0.00451,2441,11.01435,22162
592,256dpi,1,0.00451,2442,11.01886,22162
593,2cats,1,0.00451,2443,11.02337,22162
594,aantelov87,1,0.00451,2444,11.02789,22162
595,aashah,1,0.00451,2445,11.03240,22162
596,aaslamin,1,0.00451,2446,11.03691,22162
597,abuisine,1,0.00451,2447,11.04142,22162
598,aby2503,1,0.00451,2448,11.04593,22162
599,acadiant,1,0.00451,2449,11.05045,22162
600,acostaf,1,0.00451,2450,11.05496,22162
601,AcoustickSan,1,0.00451,2451,11.05947,22162
602,adame21,1,0.00451,2452,11.06398,22162
603,AdamKorcz,1,0.00451,2453,11.06850,22162
604,adamples,1,0.00451,2454,11.07301,22162
605,adamrainsby,1,0.00451,2455,11.07752,22162
606,adhithyasrinivasan,1,0.00451,2456,11.08203,22162
607,adrianliechti,1,0.00451,2457,11.08654,22162
608,agnivade,1,0.00451,2458,11.09106,22162
609,ahallock,1,0.00451,2459,11.09557,22162
610,aharol,1,0.00451,2460,11.10008,22162
611,Aiqbal1234,1,0.00451,2461,11.10459,22162
612,ajglenn,1,0.00451,2462,11.10911,22162
613,ajose01,1,0.00451,2463,11.11362,22162
614,akabos,1,0.00451,2464,11.11813,22162
615,akornatskyy,1,0.00451,2465,11.12264,22162
616,alancapc,1,0.00451,2466,11.12715,22162
617,aldenpeterson-wf,1,0.00451,2467,11.13167,22162
618,alec-alpha,1,0.00451,2468,11.13618,22162
619,AlejandroEsquivel,1,0.00451,2469,11.14069,22162
620,aleksmaus,1,0.00451,2470,11.14520,22162
621,AlexandreOuellet,1,0.00451,2471,11.14972,22162
622,alexcetto,1,0.00451,2472,11.15423,22162
623,AlexeyStolyarov,1,0.00451,2473,11.15874,22162
624,aleybovich,1,0.00451,2474,11.16325,22162
625,alheld,1,0.00451,2475,11.16776,22162
626,Alirun,1,0.00451,2476,11.17228,22162
627,alpmdog,1,0.00451,2477,11.17679,22162
628,altmind,1,0.00451,2478,11.18130,22162
629,AmandaHassoun,1,0.00451,2479,11.18581,22162
630,ambientlabs,1,0.00451,2480,11.19033,22162
631,amrnt,1,0.00451,2481,11.19484,22162
632,anastop,1,0.00451,2482,11.19935,22162
633,andragabr,1,0.00451,2483,11.20386,22162
634,andreas-eriksson,1,0.00451,2484,11.20837,22162
635,angeloramarolahy,1,0.00451,2485,11.21289,22162
636,anjelinio,1,0.00451,2486,11.21740,22162
637,antonioaguilar,1,0.00451,2487,11.22191,22162
638,antonkhabaiev,1,0.00451,2488,11.22642,22162
639,anXieTyPB,1,0.00451,2489,11.23094,22162
640,anxinyf,1,0.00451,2490,11.23545,22162
641,aoboturov,1,0.00451,2491,11.23996,22162
642,arnobroekhof,1,0.00451,2492,11.24447,22162
643,arnulfojr,1,0.00451,2493,11.24898,22162
644,Arunold,1,0.00451,2494,11.25350,22162
645,asakaev,1,0.00451,2495,11.25801,22162
646,autodidaddict,1,0.00451,2496,11.26252,22162
647,avinash92c,1,0.00451,2497,11.26703,22162
648,avlasor,1,0.00451,2498,11.27155,22162
649,awdrius,1,0.00451,2499,11.27606,22162
650,azhurbilo,1,0.00451,2500,11.28057,22162
651,baba2k,1,0.00451,2501,11.28508,22162
652,banks,1,0.00451,2502,11.28959,22162
653,Barmaglot123,1,0.00451,2503,11.29411,22162
654,Bartcardi,1,0.00451,2504,11.29862,22162
655,basgys,1,0.00451,2505,11.30313,22162
656,BatiGencho,1,0.00451,2506,11.30764,22162
657,beanhacker,1,0.00451,2507,11.31216,22162
658,beeing,1,0.00451,2508,11.31667,22162
659,Beilmann,1,0.00451,2509,11.32118,22162
660,benjsicam,1,0.00451,2510,11.32569,22162
661,bennettaur,1,0.00451,2511,11.33020,22162
662,bentranter,1,0.00451,2512,11.33472,22162
663,Bernolt,1,0.00451,2513,11.33923,22162
664,beyhan,1,0.00451,2514,11.34374,22162
665,bguiz,1,0.00451,2515,11.34825,22162
666,bitmario,1,0.00451,2516,11.35277,22162
667,blinkinglight,1,0.00451,2517,11.35728,22162
668,blixt,1,0.00451,2518,11.36179,22162
669,blusewang,1,0.00451,2519,11.36630,22162
670,blutack,1,0.00451,2520,11.37081,22162
671,bobbyhubbard,1,0.00451,2521,11.37533,22162
672,bogossdu92,1,0.00451,2522,11.37984,22162
673,boristunity,1,0.00451,2523,11.38435,22162
674,boymaas,1,0.00451,2524,11.38886,22162
675,brandonbodnar-wk,1,0.00451,2525,11.39338,22162
676,breakboyandre,1,0.00451,2526,11.39789,22162
677,brettkail-wk,1,0.00451,2527,11.40240,22162
678,Brianchat,1,0.00451,2528,11.40691,22162
679,brimworks,1,0.00451,2529,11.41142,22162
680,brucewoo,1,0.00451,2530,11.41594,22162
681,buckhx,1,0.00451,2531,11.42045,22162
682,burner-account,1,0.00451,2532,11.42496,22162
683,buzzers,1,0.00451,2533,11.42947,22162
684,c0deaddict,1,0.00451,2534,11.43399,22162
685,camen6ert,1,0.00451,2535,11.43850,22162
686,capri914,1,0.00451,2536,11.44301,22162
687,carwynmoore,1,0.00451,2537,11.44752,22162
688,caskolkm,1,0.00451,2538,11.45204,22162
689,cassiosantos,1,0.00451,2539,11.45655,22162
690,castocolina,1,0.00451,2540,11.46106,22162
691,cavellblood,1,0.00451,2541,11.46557,22162
692,cawoodm,1,0.00451,2542,11.47008,22162
693,cecilwei,1,0.00451,2543,11.47460,22162
694,cesar-devera-movile,1,0.00451,2544,11.47911,22162
695,cgabbadon,1,0.00451,2545,11.48362,22162
696,cgebe,1,0.00451,2546,11.48813,22162
697,cgriggs01,1,0.00451,2547,11.49265,22162
698,chainhead,1,0.00451,2548,11.49716,22162
699,chaitanyav,1,0.00451,2549,11.50167,22162
700,chenxyzl,1,0.00451,2550,11.50618,22162
701,Cherry,1,0.00451,2551,11.51069,22162
702,chmike,1,0.00451,2552,11.51521,22162
703,chris-jansson,1,0.00451,2553,11.51972,22162
704,ChristianSauer,1,0.00451,2554,11.52423,22162
705,chzyer,1,0.00451,2555,11.52874,22162
706,CITnDev,1,0.00451,2556,11.53326,22162
707,cjbottaro,1,0.00451,2557,11.53777,22162
708,ckeeney,1,0.00451,2558,11.54228,22162
709,ClanStyles,1,0.00451,2559,11.54679,22162
710,clementDele,1,0.00451,2560,11.55130,22162
711,cloudever,1,0.00451,2561,11.55582,22162
712,codifierr,1,0.00451,2562,11.56033,22162
713,creinholdsson,1,0.00451,2563,11.56484,22162
714,cv711,1,0.00451,2564,11.56935,22162
715,cvlab,1,0.00451,2565,11.57387,22162
716,Cyperwu,1,0.00451,2566,11.57838,22162
717,Da5-Id,1,0.00451,2567,11.58289,22162
718,DakshMiglani,1,0.00451,2568,11.58740,22162
719,DaleBingham,1,0.00451,2569,11.59191,22162
720,dalu,1,0.00451,2570,11.59643,22162
721,damir-manapov,1,0.00451,2571,11.60094,22162
722,danbopes,1,0.00451,2572,11.60545,22162
723,danieledraganti,1,0.00451,2573,11.60996,22162
724,danielkrainas,1,0.00451,2574,11.61448,22162
725,dankomiocevic,1,0.00451,2575,11.61899,22162
726,dannyyy,1,0.00451,2576,11.62350,22162
727,dariodip,1,0.00451,2577,11.62801,22162
728,darklordddddd,1,0.00451,2578,11.63252,22162
729,DasAng,1,0.00451,2579,11.63704,22162
730,Data-Inquisitor,1,0.00451,2580,11.64155,22162
731,DawnAngel,1,0.00451,2581,11.64606,22162
732,dbardbar,1,0.00451,2582,11.65057,22162
733,deem0n,1,0.00451,2583,11.65509,22162
734,deepeshk12,1,0.00451,2584,11.65960,22162
735,deepj,1,0.00451,2585,11.66411,22162
736,deini,1,0.00451,2586,11.66862,22162
737,deji04,1,0.00451,2587,11.67313,22162
738,dellintosh,1,0.00451,2588,11.67765,22162
739,dennismartensson,1,0.00451,2589,11.68216,22162
740,deployable,1,0.00451,2590,11.68667,22162
741,derfbn,1,0.00451,2591,11.69118,22162
742,deripas,1,0.00451,2592,11.69570,22162
743,dev681999,1,0.00451,2593,11.70021,22162
744,Devnsyde,1,0.00451,2594,11.70472,22162
745,dh1tw,1,0.00451,2595,11.70923,22162
746,didip,1,0.00451,2596,11.71374,22162
747,dieseltravis,1,0.00451,2597,11.71826,22162
748,dijeesh,1,0.00451,2598,11.72277,22162
749,dijitali,1,0.00451,2599,11.72728,22162
750,dimiras,1,0.00451,2600,11.73179,22162
751,djalal,1,0.00451,2601,11.73631,22162
752,dkishere,1,0.00451,2602,11.74082,22162
753,dliebreich,1,0.00451,2603,11.74533,22162
754,dncohen,1,0.00451,2604,11.74984,22162
755,donileo,1,0.00451,2605,11.75435,22162
756,donovansolms,1,0.00451,2606,11.75887,22162
757,dontlaugh,1,0.00451,2607,11.76338,22162
758,doubliez,1,0.00451,2608,11.76789,22162
759,dpryg,1,0.00451,2609,11.77240,22162
760,DrHayt,1,0.00451,2610,11.77692,22162
761,duhmojo,1,0.00451,2611,11.78143,22162
762,dungpa,1,0.00451,2612,11.78594,22162
763,dzen-it,1,0.00451,2613,11.79045,22162
764,EBallou,1,0.00451,2614,11.79496,22162
765,ebekker,1,0.00451,2615,11.79948,22162
766,edufschmidt,1,0.00451,2616,11.80399,22162
767,eelcocramer,1,0.00451,2617,11.80850,22162
768,efmr,1,0.00451,2618,11.81301,22162
769,ehippy,1,0.00451,2619,11.81753,22162
770,ekle,1,0.00451,2620,11.82204,22162
771,elbaro,1,0.00451,2621,11.82655,22162
772,elimist,1,0.00451,2622,11.83106,22162
773,ellis,1,0.00451,2623,11.83557,22162
774,emalovan,1,0.00451,2624,11.84009,22162
775,emcpadden,1,0.00451,2625,11.84460,22162
776,emgre,1,0.00451,2626,11.84911,22162
777,eonicle,1,0.00451,2627,11.85362,22162
778,erhlee-bird,1,0.00451,2628,11.85814,22162
779,ericholiveira,1,0.00451,2629,11.86265,22162
780,etix,1,0.00451,2630,11.86716,22162
781,etrochim,1,0.00451,2631,11.87167,22162
782,eurake,1,0.00451,2632,11.87618,22162
783,evildecay,1,0.00451,2633,11.88070,22162
784,Exile333,1,0.00451,2634,11.88521,22162
785,fadeAce,1,0.00451,2635,11.88972,22162
786,fancycode,1,0.00451,2636,11.89423,22162
787,feverzsj,1,0.00451,2637,11.89875,22162
788,filterfish,1,0.00451,2638,11.90326,22162
789,fischor,1,0.00451,2639,11.90777,22162
790,fishsoulhsv,1,0.00451,2640,11.91228,22162
791,fizzka,1,0.00451,2641,11.91679,22162
792,fjoubert,1,0.00451,2642,11.92131,22162
793,fkazemzadeh,1,0.00451,2643,11.92582,22162
794,FlamesCN,1,0.00451,2644,11.93033,22162
795,foobargeez,1,0.00451,2645,11.93484,22162
796,frolad,1,0.00451,2646,11.93936,22162
797,Galileon,1,0.00451,2647,11.94387,22162
798,ganesh-karthick,1,0.00451,2648,11.94838,22162
799,garfy0886,1,0.00451,2649,11.95289,22162
800,gazoon,1,0.00451,2650,11.95740,22162
801,gbhrdt,1,0.00451,2651,11.96192,22162
802,gdiet,1,0.00451,2652,11.96643,22162
803,geek,1,0.00451,2653,11.97094,22162
804,Geosong,1,0.00451,2654,11.97545,22162
805,Gerg,1,0.00451,2655,11.97997,22162
806,Giancarlo1974,1,0.00451,2656,11.98448,22162
807,gifanonim,1,0.00451,2657,11.98899,22162
808,gitdlam,1,0.00451,2658,11.99350,22162
809,Gizmos777,1,0.00451,2659,11.99801,22162
810,godofgo,1,0.00451,2660,12.00253,22162
811,GoekhanPolat,1,0.00451,2661,12.00704,22162
812,goFrendiAsgard,1,0.00451,2662,12.01155,22162
813,grange74,1,0.00451,2663,12.01606,22162
814,gsngsngsn,1,0.00451,2664,12.02058,22162
815,guangbaowan,1,0.00451,2665,12.02509,22162
816,guanqun,1,0.00451,2666,12.02960,22162
817,Gurah,1,0.00451,2667,12.03411,22162
818,guyj93,1,0.00451,2668,12.03862,22162
819,gzliudan,1,0.00451,2669,12.04314,22162
820,h12w,1,0.00451,2670,12.04765,22162
821,habibutsu,1,0.00451,2671,12.05216,22162
822,hanxinimm,1,0.00451,2672,12.05667,22162
823,hardcoar,1,0.00451,2673,12.06119,22162
824,hariharan-uno,1,0.00451,2674,12.06570,22162
825,haywirez,1,0.00451,2675,12.07021,22162
826,hchienjo,1,0.00451,2676,12.07472,22162
827,HeavyHorst,1,0.00451,2677,12.07923,22162
828,HeChengjun,1,0.00451,2678,12.08375,22162
829,HeineAndersen,1,0.00451,2679,12.08826,22162
830,hellojukay,1,0.00451,2680,12.09277,22162
831,hermesdt,1,0.00451,2681,12.09728,22162
832,hidalgopl,1,0.00451,2682,12.10180,22162
833,hikingmoose,1,0.00451,2683,12.10631,22162
834,himanshusahu06,1,0.00451,2684,12.11082,22162
835,hiqbn,1,0.00451,2685,12.11533,22162
836,Hitesh-Agrawal,1,0.00451,2686,12.11984,22162
837,hotei,1,0.00451,2687,12.12436,22162
838,howardengelhart,1,0.00451,2688,12.12887,22162
839,howkey666,1,0.00451,2689,12.13338,22162
840,hphde,1,0.00451,2690,12.13789,22162
841,hryamzik,1,0.00451,2691,12.14241,22162
842,ianbibby,1,0.00451,2692,12.14692,22162
843,ibrahimuludag,1,0.00451,2693,12.15143,22162
844,icebob,1,0.00451,2694,12.15594,22162
845,ieichen137,1,0.00451,2695,12.16045,22162
846,iggy,1,0.00451,2696,12.16497,22162
847,ikaros,1,0.00451,2697,12.16948,22162
848,ilyashtrikul,1,0.00451,2698,12.17399,22162
849,ilyjs,1,0.00451,2699,12.17850,22162
850,imatefx,1,0.00451,2700,12.18302,22162
851,imrefazekas,1,0.00451,2701,12.18753,22162
852,in2rd,1,0.00451,2702,12.19204,22162
853,injaelee,1,0.00451,2703,12.19655,22162
854,invisibleroads,1,0.00451,2704,12.20106,22162
855,irobert91,1,0.00451,2705,12.20558,22162
856,isaacasensio,1,0.00451,2706,12.21009,22162
857,isamuelson,1,0.00451,2707,12.21460,22162
858,IsmailMarmoush,1,0.00451,2708,12.21911,22162
859,ivankostov,1,0.00451,2709,12.22363,22162
860,ivanovaleksey,1,0.00451,2710,12.22814,22162
861,ivanr,1,0.00451,2711,12.23265,22162
862,jackieluc,1,0.00451,2712,12.23716,22162
863,jadurda,1,0.00451,2713,12.24167,22162
864,jaklithn,1,0.00451,2714,12.24619,22162
865,janmeier,1,0.00451,2715,12.25070,22162
866,JannikZed,1,0.00451,2716,12.25521,22162
867,jaquadro,1,0.00451,2717,12.25972,22162
868,jasonclinx,1,0.00451,2718,12.26424,22162
869,jccardonar,1,0.00451,2719,12.26875,22162
870,jdall,1,0.00451,2720,12.27326,22162
871,JeanMertz,1,0.00451,2721,12.27777,22162
872,jeffrichiefs,1,0.00451,2722,12.28228,22162
873,jeppevammenkristensen,1,0.00451,2723,12.28680,22162
874,Jeraimee,1,0.00451,2724,12.29131,22162
875,jfmatth,1,0.00451,2725,12.29582,22162
876,jimmarino,1,0.00451,2726,12.30033,22162
877,jimmykirk,1,0.00451,2727,12.30485,22162
878,jjangchan,1,0.00451,2728,12.30936,22162
879,jjbubudi,1,0.00451,2729,12.31387,22162
880,jmaister,1,0.00451,2730,12.31838,22162
881,jmventura,1,0.00451,2731,12.32290,22162
882,johanlelan,1,0.00451,2732,12.32741,22162
883,johanstokking,1,0.00451,2733,12.33192,22162
884,jonasi,1,0.00451,2734,12.33643,22162
885,jonaslagoni,1,0.00451,2735,12.34094,22162
886,jonathonfletcher,1,0.00451,2736,12.34546,22162
887,jorisroling,1,0.00451,2737,12.34997,22162
888,joyciep,1,0.00451,2738,12.35448,22162
889,joyhope,1,0.00451,2739,12.35899,22162
890,JRLambertWeave,1,0.00451,2740,12.36351,22162
891,jselleck,1,0.00451,2741,12.36802,22162
892,jstallings,1,0.00451,2742,12.37253,22162
893,jswirl,1,0.00451,2743,12.37704,22162
894,junaidy-johm,1,0.00451,2744,12.38155,22162
895,JuniorCtba,1,0.00451,2745,12.38607,22162
896,justinfx,1,0.00451,2746,12.39058,22162
897,jvrelits,1,0.00451,2747,12.39509,22162
898,jwtodd,1,0.00451,2748,12.39960,22162
899,jyaworski,1,0.00451,2749,12.40412,22162
900,k1ng440,1,0.00451,2750,12.40863,22162
901,kaitlynbrown,1,0.00451,2751,12.41314,22162
902,kamikaze139,1,0.00451,2752,12.41765,22162
903,kantharaod,1,0.00451,2753,12.42216,22162
904,karpotkin,1,0.00451,2754,12.42668,22162
905,karteek-gamooga,1,0.00451,2755,12.43119,22162
906,kasperhhk,1,0.00451,2756,12.43570,22162
907,katemicse,1,0.00451,2757,12.44021,22162
908,kaxap,1,0.00451,2758,12.44473,22162
909,kaya-zekioglu,1,0.00451,2759,12.44924,22162
910,Kazylla,1,0.00451,2760,12.45375,22162
911,KEANO3,1,0.00451,2761,12.45826,22162
912,kevinfrommelt-wf,1,0.00451,2762,12.46277,22162
913,kevinsookocheff-wf,1,0.00451,2763,12.46729,22162
914,kfreiman,1,0.00451,2764,12.47180,22162
915,khera,1,0.00451,2765,12.47631,22162
916,kijanowski,1,0.00451,2766,12.48082,22162
917,klrkdekira,1,0.00451,2767,12.48534,22162
918,kmhagan,1,0.00451,2768,12.48985,22162
919,knfoo,1,0.00451,2769,12.49436,22162
920,kokizzu,1,0.00451,2770,12.49887,22162
921,koltsovb,1,0.00451,2771,12.50338,22162
922,konstantin-Sk,1,0.00451,2772,12.50790,22162
923,KostiantynKopytov,1,0.00451,2773,12.51241,22162
924,kristaxox,1,0.00451,2774,12.51692,22162
925,kristianmandrup,1,0.00451,2775,12.52143,22162
926,krrishnarraj,1,0.00451,2776,12.52595,22162
927,ktamayop,1,0.00451,2777,12.53046,22162
928,kumaritanushree,1,0.00451,2778,12.53497,22162
929,kung-foo,1,0.00451,2779,12.53948,22162
930,kyleroot,1,0.00451,2780,12.54399,22162
931,LafonteFull,1,0.00451,2781,12.54851,22162
932,larskluge,1,0.00451,2782,12.55302,22162
933,lasselukkari,1,0.00451,2783,12.55753,22162
934,lbtrier,1,0.00451,2784,12.56204,22162
935,LeeTroy,1,0.00451,2785,12.56656,22162
936,legg,1,0.00451,2786,12.57107,22162
937,lekoder,1,0.00451,2787,12.57558,22162
938,leolanavo,1,0.00451,2788,12.58009,22162
939,Leondev7,1,0.00451,2789,12.58460,22162
940,liebo,1,0.00451,2790,12.58912,22162
941,liuwangchen,1,0.00451,2791,12.59363,22162
942,livrgst,1,0.00451,2792,12.59814,22162
943,ljfreelancer88,1,0.00451,2793,12.60265,22162
944,lming,1,0.00451,2794,12.60717,22162
945,locactus,1,0.00451,2795,12.61168,22162
946,lonerwolf,1,0.00451,2796,12.61619,22162
947,long25vn,1,0.00451,2797,12.62070,22162
948,longnguyen11288,1,0.00451,2798,12.62521,22162
949,longquan7,1,0.00451,2799,12.62973,22162
950,lovelly,1,0.00451,2800,12.63424,22162
951,lreher,1,0.00451,2801,12.63875,22162
952,lrh3321,1,0.00451,2802,12.64326,22162
953,lucaperico25,1,0.00451,2803,12.64778,22162
954,LucaPericoQohash,1,0.00451,2804,12.65229,22162
955,lucidprogrammer,1,0.00451,2805,12.65680,22162
956,lunne,1,0.00451,2806,12.66131,22162
957,luposky,1,0.00451,2807,12.66582,22162
958,luxl,1,0.00451,2808,12.67034,22162
959,lxcyha,1,0.00451,2809,12.67485,22162
960,lyuyun,1,0.00451,2810,12.67936,22162
961,magiconair,1,0.00451,2811,12.68387,22162
962,maheshmahadevan,1,0.00451,2812,12.68839,22162
963,malloth,1,0.00451,2813,12.69290,22162
964,malvex,1,0.00451,2814,12.69741,22162
965,marcelluseasley,1,0.00451,2815,12.70192,22162
966,MarcGuiot,1,0.00451,2816,12.70643,22162
967,marcoreni,1,0.00451,2817,12.71095,22162
968,marcoroganovic,1,0.00451,2818,12.71546,22162
969,mariomuja,1,0.00451,2819,12.71997,22162
970,markusr,1,0.00451,2820,12.72448,22162
971,marshallwalker,1,0.00451,2821,12.72900,22162
972,MarsWarrior,1,0.00451,2822,12.73351,22162
973,martin-spinks,1,0.00451,2823,12.73802,22162
974,materia2021,1,0.00451,2824,12.74253,22162
975,matt-christiansen-exa,1,0.00451,2825,12.74704,22162
976,maurodelazeri,1,0.00451,2826,12.75156,22162
977,mawelsh,1,0.00451,2827,12.75607,22162
978,maxatome,1,0.00451,2828,12.76058,22162
979,maxb,1,0.00451,2829,12.76509,22162
980,maxired,1,0.00451,2830,12.76961,22162
981,mbaranovski,1,0.00451,2831,12.77412,22162
982,mbecker,1,0.00451,2832,12.77863,22162
983,mberginbh,1,0.00451,2833,12.78314,22162
984,mbgonicus,1,0.00451,2834,12.78765,22162
985,mcnl,1,0.00451,2835,12.79217,22162
986,mdemille,1,0.00451,2836,12.79668,22162
987,meabed,1,0.00451,2837,12.80119,22162
988,meAmidos,1,0.00451,2838,12.80570,22162
989,meinside,1,0.00451,2839,12.81022,22162
990,MelvinK,1,0.00451,2840,12.81473,22162
991,metalog,1,0.00451,2841,12.81924,22162
992,mfaur,1,0.00451,2842,12.82375,22162
993,mfdeux,1,0.00451,2843,12.82826,22162
994,mgodmere,1,0.00451,2844,12.83278,22162
995,mgouline,1,0.00451,2845,12.83729,22162
996,mhp0rtal,1,0.00451,2846,12.84180,22162
997,michaelhood,1,0.00451,2847,12.84631,22162
998,MicheleSemenza,1,0.00451,2848,12.85083,22162
999,michelgokan,1,0.00451,2849,12.85534,22162
1000,MidnightJava,1,0.00451,2850,12.85985,22162
1001,MikeLeonard,1,0.00451,2851,12.86436,22162
1002,mikunalpha,1,0.00451,2852,12.86887,22162
1003,Mikxail,1,0.00451,2853,12.87339,22162
1004,mishraomp,1,0.00451,2854,12.87790,22162
1005,mitchhh22,1,0.00451,2855,12.88241,22162
1006,mjgarton,1,0.00451,2856,12.88692,22162
1007,mkabischev,1,0.00451,2857,12.89144,22162
1008,mkhusro,1,0.00451,2858,12.89595,22162
1009,mkozjak,1,0.00451,2859,12.90046,22162
1010,mm-tfx,1,0.00451,2860,12.90497,22162
1011,molobala,1,0.00451,2861,12.90948,22162
1012,molon,1,0.00451,2862,12.91400,22162
1013,morenocarullo,1,0.00451,2863,12.91851,22162
1014,morozovcookie,1,0.00451,2864,12.92302,22162
1015,morrisio,1,0.00451,2865,12.92753,22162
1016,mosche,1,0.00451,2866,12.93205,22162
1017,mosleim,1,0.00451,2867,12.93656,22162
1018,mpilone,1,0.00451,2868,12.94107,22162
1019,mpodanow,1,0.00451,2869,12.94558,22162
1020,mrkaspa,1,0.00451,2870,12.95009,22162
1021,Murf,1,0.00451,2871,12.95461,22162
1022,Murryy79,1,0.00451,2872,12.95912,22162
1023,mvberg,1,0.00451,2873,12.96363,22162
1024,mwiede,1,0.00451,2874,12.96814,22162
1025,NaerChang2,1,0.00451,2875,12.97266,22162
1026,namxam,1,0.00451,2876,12.97717,22162
1027,NantipatSoftEn,1,0.00451,2877,12.98168,22162
1028,nathanejohnson,1,0.00451,2878,12.98619,22162
1029,nealAR,1,0.00451,2879,12.99070,22162
1030,necdet,1,0.00451,2880,12.99522,22162
1031,Negashev,1,0.00451,2881,12.99973,22162
1032,nemesisqp,1,0.00451,2882,13.00424,22162
1033,nextel,1,0.00451,2883,13.00875,22162
1034,nginxsantos,1,0.00451,2884,13.01327,22162
1035,nguyendangminh,1,0.00451,2885,13.01778,22162
1036,niarbeht,1,0.00451,2886,13.02229,22162
1037,nick-jones,1,0.00451,2887,13.02680,22162
1038,nicknezis,1,0.00451,2888,13.03131,22162
1039,nikore,1,0.00451,2889,13.03583,22162
1040,nineinchnick,1,0.00451,2890,13.04034,22162
1041,Ninerian,1,0.00451,2891,13.04485,22162
1042,ninoles,1,0.00451,2892,13.04936,22162
1043,NissesSenap,1,0.00451,2893,13.05388,22162
1044,noguilty4you,1,0.00451,2894,13.05839,22162
1045,NoICE,1,0.00451,2895,13.06290,22162
1046,nsamala,1,0.00451,2896,13.06741,22162
1047,nseba,1,0.00451,2897,13.07192,22162
1048,nvcnvn,1,0.00451,2898,13.07644,22162
1049,nxsofsys,1,0.00451,2899,13.08095,22162
1050,oaiey,1,0.00451,2900,13.08546,22162
1051,odlex,1,0.00451,2901,13.08997,22162
1052,olgeni,1,0.00451,2902,13.09449,22162
1053,omg,1,0.00451,2903,13.09900,22162
1054,ondrap,1,0.00451,2904,13.10351,22162
1055,ondrejtomcik,1,0.00451,2905,13.10802,22162
1056,OriKerer,1,0.00451,2906,13.11253,22162
1057,oscarvesga,1,0.00451,2907,13.11705,22162
1058,OtaK,1,0.00451,2908,13.12156,22162
1059,owey0312,1,0.00451,2909,13.12607,22162
1060,p1-mmr,1,0.00451,2910,13.13058,22162
1061,pablogamboa,1,0.00451,2911,13.13510,22162
1062,paivagustavo,1,0.00451,2912,13.13961,22162
1063,palsivertsen,1,0.00451,2913,13.14412,22162
1064,pamelin,1,0.00451,2914,13.14863,22162
1065,paravz,1,0.00451,2915,13.15315,22162
1066,parkerkane,1,0.00451,2916,13.15766,22162
1067,pas2k,1,0.00451,2917,13.16217,22162
1068,PaulAcre88,1,0.00451,2918,13.16668,22162
1069,PaulEU,1,0.00451,2919,13.17119,22162
1070,pborges,1,0.00451,2920,13.17571,22162
1071,pcrete,1,0.00451,2921,13.18022,22162
1072,pedrobisp,1,0.00451,2922,13.18473,22162
1073,pepijno,1,0.00451,2923,13.18924,22162
1074,pettero,1,0.00451,2924,13.19376,22162
1075,phzietsman,1,0.00451,2925,13.19827,22162
1076,piotrlipiarz-ef,1,0.00451,2926,13.20278,22162
1077,pkaske,1,0.00451,2927,13.20729,22162
1078,pkoretic,1,0.00451,2928,13.21180,22162
1079,PlatanoBailando,1,0.00451,2929,13.21632,22162
1080,pldubouilh,1,0.00451,2930,13.22083,22162
1081,politician,1,0.00451,2931,13.22534,22162
1082,popaaaandrei,1,0.00451,2932,13.22985,22162
1083,PrajwalNReddy,1,0.00451,2933,13.23437,22162
1084,proc,1,0.00451,2934,13.23888,22162
1085,prochac,1,0.00451,2935,13.24339,22162
1086,prophe05,1,0.00451,2936,13.24790,22162
1087,protheusfr,1,0.00451,2937,13.25241,22162
1088,psbarrales,1,0.00451,2938,13.25693,22162
1089,psylone,1,0.00451,2939,13.26144,22162
1090,puckey,1,0.00451,2940,13.26595,22162
1091,pxue,1,0.00451,2941,13.27046,22162
1092,pyhedgehog,1,0.00451,2942,13.27498,22162
1093,Qhodok,1,0.00451,2943,13.27949,22162
1094,quixoten,1,0.00451,2944,13.28400,22162
1095,RaddadZ,1,0.00451,2945,13.28851,22162
1096,raff,1,0.00451,2946,13.29302,22162
1097,RameshRM,1,0.00451,2947,13.29754,22162
1098,ramlez,1,0.00451,2948,13.30205,22162
1099,rasa-silva,1,0.00451,2949,13.30656,22162
1100,rbboulton,1,0.00451,2950,13.31107,22162
1101,rbucker,1,0.00451,2951,13.31559,22162
1102,rclayton-the-terrible,1,0.00451,2952,13.32010,22162
1103,reinkrul,1,0.00451,2953,13.32461,22162
1104,Reponic,1,0.00451,2954,13.32912,22162
1105,re-vax,1,0.00451,2955,13.33363,22162
1106,rfyiamcool,1,0.00451,2956,13.33815,22162
1107,rhnvrm,1,0.00451,2957,13.34266,22162
1108,Rickkwa,1,0.00451,2958,13.34717,22162
1109,rishikeshbedre,1,0.00451,2959,13.35168,22162
1110,riyadshauk,1,0.00451,2960,13.35620,22162
1111,rjdp,1,0.00451,2961,13.36071,22162
1112,rkuchumov,1,0.00451,2962,13.36522,22162
1113,RobertZFord,1,0.00451,2963,13.36973,22162
1114,robmir44,1,0.00451,2964,13.37424,22162
1115,Rochet2,1,0.00451,2965,13.37876,22162
1116,rogeriofza,1,0.00451,2966,13.38327,22162
1117,roguh,1,0.00451,2967,13.38778,22162
1118,rohitjankar,1,0.00451,2968,13.39229,22162
1119,rohitpal99,1,0.00451,2969,13.39681,22162
1120,rohsaini,1,0.00451,2970,13.40132,22162
1121,roli8200,1,0.00451,2971,13.40583,22162
1122,romainjanvier,1,0.00451,2972,13.41034,22162
1123,RomaOrlov,1,0.00451,2973,13.41485,22162
1124,rpc180,1,0.00451,2974,13.41937,22162
1125,rregout,1,0.00451,2975,13.42388,22162
1126,rrichardson,1,0.00451,2976,13.42839,22162
1127,rudyryk,1,0.00451,2977,13.43290,22162
1128,sam3000,1,0.00451,2978,13.43742,22162
1129,santiviglione,1,0.00451,2979,13.44193,22162
1130,sasha-s,1,0.00451,2980,13.44644,22162
1131,sax,1,0.00451,2981,13.45095,22162
1132,schicks,1,0.00451,2982,13.45546,22162
1133,sdwolfe32,1,0.00451,2983,13.45998,22162
1134,seb168,1,0.00451,2984,13.46449,22162
1135,seregaSLM,1,0.00451,2985,13.46900,22162
1136,sergeykolychev,1,0.00451,2986,13.47351,22162
1137,sfxworks,1,0.00451,2987,13.47803,22162
1138,sgoldsm,1,0.00451,2988,13.48254,22162
1139,Shadowfaxenator,1,0.00451,2989,13.48705,22162
1140,ShahNewazKhan,1,0.00451,2990,13.49156,22162
1141,s-h-a-m-a-n,1,0.00451,2991,13.49607,22162
1142,shaunpersad,1,0.00451,2992,13.50059,22162
1143,shedar,1,0.00451,2993,13.50510,22162
1144,shoshykr,1,0.00451,2994,13.50961,22162
1145,shu7734,1,0.00451,2995,13.51412,22162
1146,sibblegp,1,0.00451,2996,13.51864,22162
1147,SiddiqueAhmad,1,0.00451,2997,13.52315,22162
1148,SidGrundfos,1,0.00451,2998,13.52766,22162
1149,signull,1,0.00451,2999,13.53217,22162
1150,sim732,1,0.00451,3000,13.53668,22162
1151,sittingbool,1,0.00451,3001,13.54120,22162
1152,sizovilya,1,0.00451,3002,13.54571,22162
1153,skabbes,1,0.00451,3003,13.55022,22162
1154,skatsaounis,1,0.00451,3004,13.55473,22162
1155,skyflyer,1,0.00451,3005,13.55925,22162
1156,small-egg,1,0.00451,3006,13.56376,22162
1157,smitfrank,1,0.00451,3007,13.56827,22162
1158,smvsmv,1,0.00451,3008,13.57278,22162
1159,snoopaku,1,0.00451,3009,13.57729,22162
1160,sodabrew,1,0.00451,3010,13.58181,22162
1161,sohlich,1,0.00451,3011,13.58632,22162
1162,SonicGD,1,0.00451,3012,13.59083,22162
1163,SpaceKennel,1,0.00451,3013,13.59534,22162
1164,splilly1987,1,0.00451,3014,13.59986,22162
1165,sr34,1,0.00451,3015,13.60437,22162
1166,sschick-prognos,1,0.00451,3016,13.60888,22162
1167,stamri,1,0.00451,3017,13.61339,22162
1168,stefanschneider,1,0.00451,3018,13.61790,22162
1169,stephenrob,1,0.00451,3019,13.62242,22162
1170,stetra,1,0.00451,3020,13.62693,22162
1171,stevenosborne-wf,1,0.00451,3021,13.63144,22162
1172,stodge,1,0.00451,3022,13.63595,22162
1173,stoicAlchemist,1,0.00451,3023,13.64047,22162
1174,subbu05,1,0.00451,3024,13.64498,22162
1175,subhendukundu,1,0.00451,3025,13.64949,22162
1176,sullis,1,0.00451,3026,13.65400,22162
1177,supriya-premkumar,1,0.00451,3027,13.65851,22162
1178,surryr,1,0.00451,3028,13.66303,22162
1179,syacko,1,0.00451,3029,13.66754,22162
1180,syhuanggz,1,0.00451,3030,13.67205,22162
1181,synchrone,1,0.00451,3031,13.67656,22162
1182,synepis,1,0.00451,3032,13.68108,22162
1183,szank,1,0.00451,3033,13.68559,22162
1184,t33m,1,0.00451,3034,13.69010,22162
1185,taddgiles,1,0.00451,3035,13.69461,22162
1186,Takashi-kun,1,0.00451,3036,13.69912,22162
1187,tanwarsatya,1,0.00451,3037,13.70364,22162
1188,tasdingoo,1,0.00451,3038,13.70815,22162
1189,tchap,1,0.00451,3039,13.71266,22162
1190,T-Erpstra,1,0.00451,3040,13.71717,22162
1191,tetsushiomi,1,0.00451,3041,13.72169,22162
1192,tgregory,1,0.00451,3042,13.72620,22162
1193,thanhngvpt,1,0.00451,3043,13.73071,22162
1194,thansen24,1,0.00451,3044,13.73522,22162
1195,theanimal666,1,0.00451,3045,13.73973,22162
1196,TheBlueSky,1,0.00451,3046,13.74425,22162
1197,thegoleffect,1,0.00451,3047,13.74876,22162
1198,thnt,1,0.00451,3048,13.75327,22162
1199,thomaslange24,1,0.00451,3049,13.75778,22162
1200,timneedham,1,0.00451,3050,13.76230,22162
1201,tisov,1,0.00451,3051,13.76681,22162
1202,toadzky,1,0.00451,3052,13.77132,22162
1203,tobiasmuecksch,1,0.00451,3053,13.77583,22162
1204,todd,1,0.00451,3054,13.78034,22162
1205,TokiTori,1,0.00451,3055,13.78486,22162
1206,tolmanam,1,0.00451,3056,13.78937,22162
1207,TomasRup,1,0.00451,3057,13.79388,22162
1208,tomazbracic,1,0.00451,3058,13.79839,22162
1209,toukovk,1,0.00451,3059,13.80291,22162
1210,trackroute,1,0.00451,3060,13.80742,22162
1211,tstenvi,1,0.00451,3061,13.81193,22162
1212,ttakahari,1,0.00451,3062,13.81644,22162
1213,tuorifei,1,0.00451,3063,13.82095,22162
1214,tutman96,1,0.00451,3064,13.82547,22162
1215,tuwukee,1,0.00451,3065,13.82998,22162
1216,tylerrinnan-wf,1,0.00451,3066,13.83449,22162
1217,ugiwgh,1,0.00451,3067,13.83900,22162
1218,ujwal-setlur,1,0.00451,3068,13.84352,22162
1219,UltraNemesis,1,0.00451,3069,13.84803,22162
1220,umesh3034,1,0.00451,3070,13.85254,22162
1221,Upperfoot,1,0.00451,3071,13.85705,22162
1222,uscorchr,1,0.00451,3072,13.86156,22162
1223,usuryasatyakumar,1,0.00451,3073,13.86608,22162
1224,uudashr,1,0.00451,3074,13.87059,22162
1225,valpip,1,0.00451,3075,13.87510,22162
1226,vandkris,1,0.00451,3076,13.87961,22162
1227,vanillahsu,1,0.00451,3077,13.88413,22162
1228,veerapatyok,1,0.00451,3078,13.88864,22162
1229,veznidav,1,0.00451,3079,13.89315,22162
1230,VictorBarrantes,1,0.00451,3080,13.89766,22162
1231,vietthang207,1,0.00451,3081,13.90217,22162
1232,vikramkarandikar,1,0.00451,3082,13.90669,22162
1233,vinayxbox,1,0.00451,3083,13.91120,22162
1234,viveksatasiya,1,0.00451,3084,13.91571,22162
1235,vonafor,1,0.00451,3085,13.92022,22162
1236,Vonnguru,1,0.00451,3086,13.92474,22162
1237,vornet,1,0.00451,3087,13.92925,22162
1238,vsysoev,1,0.00451,3088,13.93376,22162
1239,vykulakov,1,0.00451,3089,13.93827,22162
1240,wade19870531,1,0.00451,3090,13.94278,22162
1241,waeljammal,1,0.00451,3091,13.94730,22162
1242,wallride,1,0.00451,3092,13.95181,22162
1243,wardenlym,1,0.00451,3093,13.95632,22162
1244,WDevereux,1,0.00451,3094,13.96083,22162
1245,websoftwares,1,0.00451,3095,13.96535,22162
1246,webu2014,1,0.00451,3096,13.96986,22162
1247,wenlittleoil,1,0.00451,3097,13.97437,22162
1248,whmountains,1,0.00451,3098,13.97888,22162
1249,willihelm,1,0.00451,3099,13.98340,22162
1250,willowish,1,0.00451,3100,13.98791,22162
1251,will-yip,1,0.00451,3101,13.99242,22162
1252,windyliupei,1,0.00451,3102,13.99693,22162
1253,winwisely99,1,0.00451,3103,14.00144,22162
1254,wisni,1,0.00451,3104,14.00596,22162
1255,WithoutCaps,1,0.00451,3105,14.01047,22162
1256,witq,1,0.00451,3106,14.01498,22162
1257,WizardOfArc,1,0.00451,3107,14.01949,22162
1258,wllenyj,1,0.00451,3108,14.02401,22162
1259,wojtkowiak,1,0.00451,3109,14.02852,22162
1260,wongak,1,0.00451,3110,14.03303,22162
1261,wpjunior,1,0.00451,3111,14.03754,22162
1262,xeroxstar,1,0.00451,3112,14.04205,22162
1263,xiam,1,0.00451,3113,14.04657,22162
1264,xiaoshengaimm,1,0.00451,3114,14.05108,22162
1265,xiaou,1,0.00451,3115,14.05559,22162
1266,ximply,1,0.00451,3116,14.06010,22162
1267,xowenx,1,0.00451,3117,14.06462,22162
1268,xxxcoltxxx,1,0.00451,3118,14.06913,22162
1269,xxxmailk,1,0.00451,3119,14.07364,22162
1270,yatskevich,1,0.00451,3120,14.07815,22162
1271,yiyang5055,1,0.00451,3121,14.08266,22162
1272,ynkumar143,1,0.00451,3122,14.08718,22162
1273,yosiat,1,0.00451,3123,14.09169,22162
1274,yrsh,1,0.00451,3124,14.09620,22162
1275,ys-zhao,1,0.00451,3125,14.10071,22162
1276,yuashuplyak,1,0.00451,3126,14.10523,22162
1277,yuridiniz,1,0.00451,3127,14.10974,22162
1278,Zannith,1,0.00451,3128,14.11425,22162
1279,zboni-gpsw,1,0.00451,3129,14.11876,22162
1280,zbxzxx,1,0.00451,3130,14.12327,22162
1281,zbyzhengzong,1,0.00451,3131,14.12779,22162
1282,zeusito,1,0.00451,3132,14.13230,22162
1283,zhangjian326,1,0.00451,3133,14.13681,22162
1284,ZhiqinYang,1,0.00451,3134,14.14132,22162
1285,ZiCog,1,0.00451,3135,14.14584,22162
1286,ziyi-yan,1,0.00451,3136,14.15035,22162
1287,ZiyunYang,1,0.00451,3137,14.15486,22162
1288,zlinwei,1,0.00451,3138,14.15937,22162
1289,zpr,1,0.00451,3139,14.16388,22162
1290,zweizeichen,1,0.00451,3140,14.16840,22162
1291,zzerjae,1,0.00451,3141,14.17291,22162
