rank_number,actor,contributions,percent,cumulative_sum,cumulative_percent,all_contributions
1,njhale,2485,3.26445,2485,3.26445,76123
2,kevinrizza,2352,3.08974,4837,6.35419,76123
3,J0zi,2053,2.69695,6890,9.05114,76123
4,timflannagan1,1913,2.51304,8803,11.56418,76123
5,dmesser,1673,2.19776,10476,13.76194,76123
6,aravindhp,1664,2.18594,12140,15.94787,76123
7,dinhxuanvu,1174,1.54224,13314,17.49011,76123
8,tkashem,1065,1.39905,14379,18.88917,76123
9,anik120,781,1.02597,15160,19.91514,76123
10,benluddy,657,0.86308,15817,20.77821,76123
11,mvalahtv,656,0.86176,16473,21.63998,76123
12,jozzi,471,0.61874,16944,22.25871,76123
13,aneeshkp,432,0.56750,17376,22.82622,76123
14,asmacdo,388,0.50970,17764,23.33592,76123
15,bentito,367,0.48211,18131,23.81803,76123
16,EmilyM1,303,0.39804,18434,24.21607,76123
17,bharathi-tenneti,254,0.33367,18688,24.54974,76123
18,varshaprasad96,244,0.32053,18932,24.87028,76123
19,MartinBasti,230,0.30214,19162,25.17242,76123
20,jeremylinlin,213,0.27981,19375,25.45223,76123
21,harishsurf,206,0.27061,19581,25.72284,76123
22,ssimk0,191,0.25091,19772,25.97375,76123
23,theishshah,191,0.25091,19963,26.22466,76123
24,dymurray,165,0.21675,20128,26.44142,76123
25,tschuy,143,0.18785,20271,26.62927,76123
26,Edke,127,0.16684,20398,26.79611,76123
27,eivantsov,127,0.16684,20525,26.96294,76123
28,flickerfly,118,0.15501,20643,27.11795,76123
29,commanderchewbacca,101,0.13268,20744,27.25063,76123
30,galderz,100,0.13137,20844,27.38200,76123
31,guymguym,88,0.11560,20932,27.49760,76123
32,gfbarros,87,0.11429,21019,27.61189,76123
33,niso120b,82,0.10772,21101,27.71961,76123
34,vazirim,82,0.10772,21183,27.82733,76123
35,tmckayus,81,0.10641,21264,27.93374,76123
36,xiangjingli,73,0.09590,21337,28.02964,76123
37,jmckind,72,0.09458,21409,28.12422,76123
38,Jamstah,70,0.09196,21479,28.21618,76123
39,mew2057,68,0.08933,21547,28.30551,76123
40,tlwu2013,68,0.08933,21615,28.39483,76123
41,davidfestal,66,0.08670,21681,28.48154,76123
42,rashmigottipati,64,0.08407,21745,28.56561,76123
43,pruan-rht,63,0.08276,21808,28.64837,76123
44,amalkurup89,57,0.07488,21865,28.72325,76123
45,jeyaramashok,57,0.07488,21922,28.79813,76123
46,spahl,57,0.07488,21979,28.87301,76123
47,sunsingerus,56,0.07357,22035,28.94657,76123
48,tolusha,55,0.07225,22090,29.01882,76123
49,beautytiger,54,0.07094,22144,29.08976,76123
50,CSdread,54,0.07094,22198,29.16070,76123
51,DhritiShikhar,54,0.07094,22252,29.23164,76123
52,cdjohnson,53,0.06962,22305,29.30126,76123
53,grdryn,52,0.06831,22357,29.36957,76123
54,rodrigovalin,52,0.06831,22409,29.43788,76123
55,simrandhaliw,52,0.06831,22461,29.50619,76123
56,wladimiiir,52,0.06831,22513,29.57450,76123
57,aharbis,51,0.06700,22564,29.64150,76123
58,csomh,51,0.06700,22615,29.70850,76123
59,mmariani,51,0.06700,22666,29.77549,76123
60,esara,47,0.06174,22713,29.83724,76123
61,janepelladinesh,47,0.06174,22760,29.89898,76123
62,gregsheremeta,46,0.06043,22806,29.95941,76123
63,jkatz,46,0.06043,22852,30.01984,76123
64,ctron,45,0.05911,22897,30.07895,76123
65,jdockter,44,0.05780,22941,30.13675,76123
66,skitt,43,0.05649,22984,30.19324,76123
67,rigazilla,42,0.05517,23026,30.24841,76123
68,jsm84,41,0.05386,23067,30.30227,76123
69,demonCoder95,37,0.04861,23104,30.35088,76123
70,LouisPlisso,37,0.04861,23141,30.39949,76123
71,lbroudoux,35,0.04598,23176,30.44546,76123
72,davemeurer,34,0.04466,23210,30.49013,76123
73,pdettori,34,0.04466,23244,30.53479,76123
74,ron1,34,0.04466,23278,30.57946,76123
75,sichvoge,34,0.04466,23312,30.62412,76123
76,FxKu,33,0.04335,23345,30.66747,76123
77,shettyh,33,0.04335,23378,30.71082,76123
78,svallala,33,0.04335,23411,30.75417,76123
79,miguelsorianod,32,0.04204,23443,30.79621,76123
80,tomsucho,32,0.04204,23475,30.83825,76123
81,cheesiong-lee,31,0.04072,23506,30.87897,76123
82,aakarshg,30,0.03941,23536,30.91838,76123
83,nrchakradhar,30,0.03941,23566,30.95779,76123
84,cap1984,29,0.03810,23595,30.99589,76123
85,I-am-Dishon,29,0.03810,23624,31.03398,76123
86,prabhatdubey1,29,0.03810,23653,31.07208,76123
87,tahmmee,28,0.03678,23681,31.10886,76123
88,pb82,27,0.03547,23708,31.14433,76123
89,pratikjagrut,27,0.03547,23735,31.17980,76123
90,janmaterne,26,0.03416,23761,31.21396,76123
91,smiklosovic,26,0.03416,23787,31.24811,76123
92,2uasimojo,25,0.03284,23812,31.28095,76123
93,alourie,25,0.03284,23837,31.31379,76123
94,jmesnil,25,0.03284,23862,31.34664,76123
95,Lucaber,25,0.03284,23887,31.37948,76123
96,matihost,25,0.03284,23912,31.41232,76123
97,rammohanc,25,0.03284,23937,31.44516,76123
98,rkratky,25,0.03284,23962,31.47800,76123
99,adrian555,24,0.03153,23986,31.50953,76123
100,SapientGuardian,24,0.03153,24010,31.54106,76123
101,dmvolod,23,0.03021,24033,31.57127,76123
102,johnkim76,23,0.03021,24056,31.60149,76123
103,ktenzer,23,0.03021,24079,31.63170,76123
104,kubemq,23,0.03021,24102,31.66192,76123
105,27149chen,22,0.02890,24124,31.69082,76123
106,baluchicken,22,0.02890,24146,31.71972,76123
107,hitman99,22,0.02890,24168,31.74862,76123
108,horis233,22,0.02890,24190,31.77752,76123
109,LaVLaS,22,0.02890,24212,31.80642,76123
110,edwardcallahan,21,0.02759,24233,31.83401,76123
111,eguzki,21,0.02759,24254,31.86159,76123
112,k-wall,21,0.02759,24275,31.88918,76123
113,petro404,21,0.02759,24296,31.91677,76123
114,sa-cloud,21,0.02759,24317,31.94435,76123
115,aaronmcohen,20,0.02627,24337,31.97063,76123
116,BlackMix,20,0.02627,24357,31.99690,76123
117,deekshahegde86,20,0.02627,24377,32.02317,76123
118,kumarrprashant2005,20,0.02627,24397,32.04945,76123
119,mamafun,20,0.02627,24417,32.07572,76123
120,marcoderama,20,0.02627,24437,32.10199,76123
121,mikeshng,20,0.02627,24457,32.12827,76123
122,AndrienkoAleksandr,19,0.02496,24476,32.15323,76123
123,davidffrench,19,0.02496,24495,32.17819,76123
124,gaurav-dalvi,19,0.02496,24514,32.20314,76123
125,heoneal,19,0.02496,24533,32.22810,76123
126,nathanbrophy,19,0.02496,24552,32.25306,76123
127,otakumike,19,0.02496,24571,32.27802,76123
128,chmeliik,18,0.02365,24589,32.30167,76123
129,cvp-ops,18,0.02365,24607,32.32532,76123
130,IBMRob,18,0.02365,24625,32.34896,76123
131,komish,18,0.02365,24643,32.37261,76123
132,RakhithaRR,18,0.02365,24661,32.39625,76123
133,satishrao84,18,0.02365,24679,32.41990,76123
134,akoserwal,17,0.02233,24696,32.44223,76123
135,kaczyns,17,0.02233,24713,32.46456,76123
136,ldimaggi,17,0.02233,24730,32.48690,76123
137,lrgar,17,0.02233,24747,32.50923,76123
138,MatousJobanek,17,0.02233,24764,32.53156,76123
139,mikkeschiren,17,0.02233,24781,32.55389,76123
140,piyush-nimbalkar,17,0.02233,24798,32.57623,76123
141,rareddy,17,0.02233,24815,32.59856,76123
142,andriisoldatenko,16,0.02102,24831,32.61958,76123
143,dustinspecker,16,0.02102,24847,32.64059,76123
144,dweepgogia,16,0.02102,24863,32.66161,76123
145,huizengaJoe,16,0.02102,24879,32.68263,76123
146,RushinthJohn,16,0.02102,24895,32.70365,76123
147,Venkat19967,16,0.02102,24911,32.72467,76123
148,zanoubia,16,0.02102,24927,32.74569,76123
149,chowmean,15,0.01970,24942,32.76539,76123
150,davi5e,15,0.01970,24957,32.78510,76123
151,dirgim,15,0.01970,24972,32.80480,76123
152,jamesnetherton,15,0.01970,24987,32.82451,76123
153,matyix,15,0.01970,25002,32.84421,76123
154,RyuunoAelia,15,0.01970,25017,32.86392,76123
155,shivamerla,15,0.01970,25032,32.88362,76123
156,tduzan,15,0.01970,25047,32.90333,76123
157,thomasmckay,15,0.01970,25062,32.92303,76123
158,zachncst,15,0.01970,25077,32.94274,76123
159,disposab1e,14,0.01839,25091,32.96113,76123
160,ffoysal,14,0.01839,25105,32.97952,76123
161,jpadams,14,0.01839,25119,32.99791,76123
162,lluan444,14,0.01839,25133,33.01630,76123
163,ManojDhanorkar,14,0.01839,25147,33.03469,76123
164,mathianasj,14,0.01839,25161,33.05309,76123
165,mossuchida,14,0.01839,25175,33.07148,76123
166,paterczm,14,0.01839,25189,33.08987,76123
167,Rulox,14,0.01839,25203,33.10826,76123
168,sky-big,14,0.01839,25217,33.12665,76123
169,tonytcampbell,14,0.01839,25231,33.14504,76123
170,vinzent,14,0.01839,25245,33.16343,76123
171,yaminisridaran,14,0.01839,25259,33.18182,76123
172,aravinder111,13,0.01708,25272,33.19890,76123
173,baijum,13,0.01708,25285,33.21598,76123
174,cagrev,13,0.01708,25298,33.23306,76123
175,djwhatle,13,0.01708,25311,33.25013,76123
176,konsotirop,13,0.01708,25324,33.26721,76123
177,mkuznyetsov,13,0.01708,25337,33.28429,76123
178,philbrookes,13,0.01708,25350,33.30137,76123
179,spanichella,13,0.01708,25363,33.31845,76123
180,srinivas-kandula,13,0.01708,25376,33.33552,76123
181,welshDoug,13,0.01708,25389,33.35260,76123
182,AnilKumarBandi27,12,0.01576,25401,33.36836,76123
183,bmicklea,12,0.01576,25413,33.38413,76123
184,chatton,12,0.01576,25425,33.39989,76123
185,CohenAviad,12,0.01576,25437,33.41566,76123
186,danyollee,12,0.01576,25449,33.43142,76123
187,flamingdumpster,12,0.01576,25461,33.44718,76123
188,himanshug,12,0.01576,25473,33.46295,76123
189,lamek,12,0.01576,25485,33.47871,76123
190,muralov,12,0.01576,25497,33.49448,76123
191,openlabs-edge,12,0.01576,25509,33.51024,76123
192,pliurh,12,0.01576,25521,33.52600,76123
193,RameshaKaru,12,0.01576,25533,33.54177,76123
194,selvamt94,12,0.01576,25545,33.55753,76123
195,xcaspar,12,0.01576,25557,33.57330,76123
196,a1exeyz,11,0.01445,25568,33.58775,76123
197,agaffney,11,0.01445,25579,33.60220,76123
198,BIAOXYZ,11,0.01445,25590,33.61665,76123
199,cschwede,11,0.01445,25601,33.63110,76123
200,devdattakulkarni,11,0.01445,25612,33.64555,76123
201,erikgb,11,0.01445,25623,33.66000,76123
202,itdove,11,0.01445,25634,33.67445,76123
203,javanthropus,11,0.01445,25645,33.68890,76123
204,jesperhansen17,11,0.01445,25656,33.70335,76123
205,Joibel,11,0.01445,25667,33.71780,76123
206,jsenko,11,0.01445,25678,33.73225,76123
207,kaushiksrinivas,11,0.01445,25689,33.74670,76123
208,nvjmayo,11,0.01445,25700,33.76115,76123
209,oriyarde,11,0.01445,25711,33.77560,76123
210,prometherion,11,0.01445,25722,33.79005,76123
211,stenwt,11,0.01445,25733,33.80450,76123
212,wangzheng422,11,0.01445,25744,33.81895,76123
213,andy2046,10,0.01314,25754,33.83209,76123
214,baichinger,10,0.01314,25764,33.84522,76123
215,bandrade,10,0.01314,25774,33.85836,76123
216,BrianMWest,10,0.01314,25784,33.87150,76123
217,dlong-1,10,0.01314,25794,33.88463,76123
218,glothriel,10,0.01314,25804,33.89777,76123
219,jharrington22,10,0.01314,25814,33.91091,76123
220,Jiri-Kremser,10,0.01314,25824,33.92404,76123
221,jkremser,10,0.01314,25834,33.93718,76123
222,lcarva,10,0.01314,25844,33.95032,76123
223,nginx-git,10,0.01314,25854,33.96345,76123
224,oreissig,10,0.01314,25864,33.97659,76123
225,petomalina,10,0.01314,25874,33.98973,76123
226,riponbanik,10,0.01314,25884,34.00286,76123
227,romachalm,10,0.01314,25894,34.01600,76123
228,rvansa,10,0.01314,25904,34.02914,76123
229,yangzhares,10,0.01314,25914,34.04227,76123
230,YanRyan,10,0.01314,25924,34.05541,76123
231,Ashutosh-Shukla,9,0.01182,25933,34.06723,76123
232,chawlanikhil24,9,0.01182,25942,34.07906,76123
233,dannyzaken,9,0.01182,25951,34.09088,76123
234,dbenque-1a,9,0.01182,25960,34.10270,76123
235,degenaro,9,0.01182,25969,34.11453,76123
236,gpanagiotidis,9,0.01182,25978,34.12635,76123
237,ivanstanev,9,0.01182,25987,34.13817,76123
238,Jobava,9,0.01182,25996,34.14999,76123
239,mabukar,9,0.01182,26005,34.16182,76123
240,mwoodson,9,0.01182,26014,34.17364,76123
241,nickboldt,9,0.01182,26023,34.18546,76123
242,radtriste,9,0.01182,26032,34.19729,76123
243,sbar95,9,0.01182,26041,34.20911,76123
244,slopezz,9,0.01182,26050,34.22093,76123
245,woodliu,9,0.01182,26059,34.23275,76123
246,xkwangcn,9,0.01182,26068,34.24458,76123
247,YianZong,9,0.01182,26077,34.25640,76123
248,ZoltanOnody,9,0.01182,26086,34.26822,76123
249,abaiken,8,0.01051,26094,34.27873,76123
250,anyasabo,8,0.01051,26102,34.28924,76123
251,atinsood,8,0.01051,26110,34.29975,76123
252,bfabec,8,0.01051,26118,34.31026,76123
253,DanielXLee,8,0.01051,26126,34.32077,76123
254,fitex,8,0.01051,26134,34.33128,76123
255,georgettica,8,0.01051,26142,34.34179,76123
256,johnnyrun,8,0.01051,26150,34.35230,76123
257,jwilander,8,0.01051,26158,34.36281,76123
258,kraman,8,0.01051,26166,34.37332,76123
259,lgarciaaco,8,0.01051,26174,34.38383,76123
260,linzhaoming,8,0.01051,26182,34.39434,76123
261,namratachaudhary,8,0.01051,26190,34.40484,76123
262,Nik-Novak,8,0.01051,26198,34.41535,76123
263,pebrc,8,0.01051,26206,34.42586,76123
264,prashantokochavara,8,0.01051,26214,34.43637,76123
265,pre,8,0.01051,26222,34.44688,76123
266,rajneesh-ops,8,0.01051,26230,34.45739,76123
267,rvsingh011,8,0.01051,26238,34.46790,76123
268,sancyx,8,0.01051,26246,34.47841,76123
269,abergmeier,7,0.00920,26253,34.48761,76123
270,aerdei,7,0.00920,26260,34.49680,76123
271,al45tair,7,0.00920,26267,34.50600,76123
272,BenElgar,7,0.00920,26274,34.51519,76123
273,bostrt,7,0.00920,26281,34.52439,76123
274,camilocot,7,0.00920,26288,34.53358,76123
275,Cerebus,7,0.00920,26295,34.54278,76123
276,cwilkers,7,0.00920,26302,34.55198,76123
277,darrylb-github,7,0.00920,26309,34.56117,76123
278,fantapsody,7,0.00920,26316,34.57037,76123
279,gacopl,7,0.00920,26323,34.57956,76123
280,gearoidibm,7,0.00920,26330,34.58876,76123
281,iamabhishek-dubey,7,0.00920,26337,34.59795,76123
282,just1900,7,0.00920,26344,34.60715,76123
283,kasey,7,0.00920,26351,34.61634,76123
284,mandaltu123,7,0.00920,26358,34.62554,76123
285,mikedickey,7,0.00920,26365,34.63474,76123
286,nataraj24,7,0.00920,26372,34.64393,76123
287,nidin,7,0.00920,26379,34.65313,76123
288,patoarvizu,7,0.00920,26386,34.66232,76123
289,riccardomc,7,0.00920,26393,34.67152,76123
290,spolti,7,0.00920,26400,34.68071,76123
291,srleyva,7,0.00920,26407,34.68991,76123
292,VenkatRamaraju,7,0.00920,26414,34.69911,76123
293,YathendraPrasad,7,0.00920,26421,34.70830,76123
294,aavarghese,6,0.00788,26427,34.71618,76123
295,aeb-sia,6,0.00788,26433,34.72407,76123
296,aemperador,6,0.00788,26439,34.73195,76123
297,AllAppreg3,6,0.00788,26445,34.73983,76123
298,apollolemonte,6,0.00788,26451,34.74771,76123
299,BaddamJhansi,6,0.00788,26457,34.75559,76123
300,bgaechter,6,0.00788,26463,34.76347,76123
301,bingosummer,6,0.00788,26469,34.77136,76123
302,brianwcook,6,0.00788,26475,34.77924,76123
303,bvwells,6,0.00788,26481,34.78712,76123
304,dacleyra,6,0.00788,26487,34.79500,76123
305,daquinoaldo,6,0.00788,26493,34.80288,76123
306,deniskril,6,0.00788,26499,34.81077,76123
307,dian-xh,6,0.00788,26505,34.81865,76123
308,dubauski,6,0.00788,26511,34.82653,76123
309,feli5,6,0.00788,26517,34.83441,76123
310,fengxsong,6,0.00788,26523,34.84229,76123
311,FreedomBen,6,0.00788,26529,34.85018,76123
312,Gallardot,6,0.00788,26535,34.85806,76123
313,gautamkmr,6,0.00788,26541,34.86594,76123
314,huangjiasingle,6,0.00788,26547,34.87382,76123
315,ilanuriel,6,0.00788,26553,34.88170,76123
316,ivanguravel,6,0.00788,26559,34.88959,76123
317,Jinchul81,6,0.00788,26565,34.89747,76123
318,Jmainguy,6,0.00788,26571,34.90535,76123
319,kotyara85,6,0.00788,26577,34.91323,76123
320,kumarappanc,6,0.00788,26583,34.92111,76123
321,lisa,6,0.00788,26589,34.92900,76123
322,LuciferInLove,6,0.00788,26595,34.93688,76123
323,matskiv,6,0.00788,26601,34.94476,76123
324,metacosm,6,0.00788,26607,34.95264,76123
325,mishindm,6,0.00788,26613,34.96052,76123
326,mmellin,6,0.00788,26619,34.96841,76123
327,mohamadnikan2013,6,0.00788,26625,34.97629,76123
328,MrBasset,6,0.00788,26631,34.98417,76123
329,pgerv12,6,0.00788,26637,34.99205,76123
330,rajmechi,6,0.00788,26643,34.99993,76123
331,rbaumgar,6,0.00788,26649,35.00782,76123
332,reuvenharrison,6,0.00788,26655,35.01570,76123
333,rhdedgar,6,0.00788,26661,35.02358,76123
334,ryandgoulding,6,0.00788,26667,35.03146,76123
335,Slayv,6,0.00788,26673,35.03934,76123
336,suratsuriya,6,0.00788,26679,35.04723,76123
337,talham7391,6,0.00788,26685,35.05511,76123
338,thbkrkr,6,0.00788,26691,35.06299,76123
339,thebithead,6,0.00788,26697,35.07087,76123
340,waynz0r,6,0.00788,26703,35.07875,76123
341,weii666,6,0.00788,26709,35.08664,76123
342,xm2,6,0.00788,26715,35.09452,76123
343,accammer,5,0.00657,26720,35.10109,76123
344,aceeric,5,0.00657,26725,35.10765,76123
345,alinadonisa,5,0.00657,26730,35.11422,76123
346,ankitathomas,5,0.00657,26735,35.12079,76123
347,austincunningham,5,0.00657,26740,35.12736,76123
348,bofm,5,0.00657,26745,35.13393,76123
349,deepaktawri,5,0.00657,26750,35.14050,76123
350,dimitraz,5,0.00657,26755,35.14706,76123
351,dinusha92,5,0.00657,26760,35.15363,76123
352,emmajiafan,5,0.00657,26765,35.16020,76123
353,f41gh7,5,0.00657,26770,35.16677,76123
354,hupiper,5,0.00657,26775,35.17334,76123
355,jazzdan,5,0.00657,26780,35.17991,76123
356,jdob,5,0.00657,26785,35.18647,76123
357,jhernandezb,5,0.00657,26790,35.19304,76123
358,jleach,5,0.00657,26795,35.19961,76123
359,Katiyman,5,0.00657,26800,35.20618,76123
360,kpiwko,5,0.00657,26805,35.21275,76123
361,lallinger-arbeit,5,0.00657,26810,35.21932,76123
362,maikelvl,5,0.00657,26815,35.22588,76123
363,mandymchu,5,0.00657,26820,35.23245,76123
364,marcomancuso,5,0.00657,26825,35.23902,76123
365,maschmid,5,0.00657,26830,35.24559,76123
366,math3vz,5,0.00657,26835,35.25216,76123
367,mdbooth,5,0.00657,26840,35.25873,76123
368,miguel-santiago,5,0.00657,26845,35.26529,76123
369,monaka,5,0.00657,26850,35.27186,76123
370,nareshdesh,5,0.00657,26855,35.27843,76123
371,nirrozenbaum,5,0.00657,26860,35.28500,76123
372,pollosp,5,0.00657,26865,35.29157,76123
373,realmjian,5,0.00657,26870,35.29814,76123
374,shenkonghui,5,0.00657,26875,35.30470,76123
375,StykMartin,5,0.00657,26880,35.31127,76123
376,supermqB,5,0.00657,26885,35.31784,76123
377,syswu,5,0.00657,26890,35.32441,76123
378,the-scott-hand,5,0.00657,26895,35.33098,76123
379,tony-clarke-amdocs,5,0.00657,26900,35.33755,76123
380,UdayVishwakarma,5,0.00657,26905,35.34411,76123
381,ustcsunshine,5,0.00657,26910,35.35068,76123
382,Uvindu96,5,0.00657,26915,35.35725,76123
383,vaghetti,5,0.00657,26920,35.36382,76123
384,vchande,5,0.00657,26925,35.37039,76123
385,WtfJoke,5,0.00657,26930,35.37696,76123
386,zach-source,5,0.00657,26935,35.38352,76123
387,abalki001,4,0.00525,26939,35.38878,76123
388,Abonazir,4,0.00525,26943,35.39403,76123
389,adityabyreddy74,4,0.00525,26947,35.39929,76123
390,adrianmo,4,0.00525,26951,35.40454,76123
391,akieling,4,0.00525,26955,35.40980,76123
392,aloismayr,4,0.00525,26959,35.41505,76123
393,anfanycw,4,0.00525,26963,35.42031,76123
394,ArbelNathan,4,0.00525,26967,35.42556,76123
395,becitsthere,4,0.00525,26971,35.43082,76123
396,bergerhoffer,4,0.00525,26975,35.43607,76123
397,bobdonat,4,0.00525,26979,35.44133,76123
398,Brian-Williams,4,0.00525,26983,35.44658,76123
399,brindasanth,4,0.00525,26987,35.45183,76123
400,buoto,4,0.00525,26991,35.45709,76123
401,chinglinwen,4,0.00525,26995,35.46234,76123
402,codytrey,4,0.00525,26999,35.46760,76123
403,coopstah13,4,0.00525,27003,35.47285,76123
404,cristi-,4,0.00525,27007,35.47811,76123
405,davidkirwan,4,0.00525,27011,35.48336,76123
406,david-shepard,4,0.00525,27015,35.48862,76123
407,denyskril,4,0.00525,27019,35.49387,76123
408,DTMad,4,0.00525,27023,35.49913,76123
409,ejez,4,0.00525,27027,35.50438,76123
410,evalsocket,4,0.00525,27031,35.50964,76123
411,feicun,4,0.00525,27035,35.51489,76123
412,JaroslavMajera,4,0.00525,27039,35.52015,76123
413,JoelColledge,4,0.00525,27043,35.52540,76123
414,kdwodc,4,0.00525,27047,35.53065,76123
415,killwing,4,0.00525,27051,35.53591,76123
416,lut777,4,0.00525,27055,35.54116,76123
417,lxop,4,0.00525,27059,35.54642,76123
418,Man-Jain,4,0.00525,27063,35.55167,76123
419,michalkarolik,4,0.00525,27067,35.55693,76123
420,morstad,4,0.00525,27071,35.56218,76123
421,mrunge,4,0.00525,27075,35.56744,76123
422,msenmurugan,4,0.00525,27079,35.57269,76123
423,msjostrom,4,0.00525,27083,35.57795,76123
424,nitishm,4,0.00525,27087,35.58320,76123
425,olukas,4,0.00525,27091,35.58846,76123
426,orainxiong,4,0.00525,27095,35.59371,76123
427,periklis,4,0.00525,27099,35.59896,76123
428,peteanusergiu,4,0.00525,27103,35.60422,76123
429,prophetstor-ai,4,0.00525,27107,35.60947,76123
430,Purushotham233,4,0.00525,27111,35.61473,76123
431,sacharya,4,0.00525,27115,35.61998,76123
432,sandoichi,4,0.00525,27119,35.62524,76123
433,saurabh1284,4,0.00525,27123,35.63049,76123
434,selvamt70,4,0.00525,27127,35.63575,76123
435,slemeur,4,0.00525,27131,35.64100,76123
436,sunbinnnnn,4,0.00525,27135,35.64626,76123
437,tima,4,0.00525,27139,35.65151,76123
438,tirelibirefe,4,0.00525,27143,35.65677,76123
439,t-matsuo,4,0.00525,27147,35.66202,76123
440,TriTiger,4,0.00525,27151,35.66728,76123
441,yahliu,4,0.00525,27155,35.67253,76123
442,YanFenGuo,4,0.00525,27159,35.67778,76123
443,yueyongyue,4,0.00525,27163,35.68304,76123
444,zeromsi,4,0.00525,27167,35.68829,76123
445,adberglund,3,0.00394,27170,35.69223,76123
446,adellape,3,0.00394,27173,35.69618,76123
447,ajanikow,3,0.00394,27176,35.70012,76123
448,aliartiza75,3,0.00394,27179,35.70406,76123
449,aliench0,3,0.00394,27182,35.70800,76123
450,anravi,3,0.00394,27185,35.71194,76123
451,arhimondr,3,0.00394,27188,35.71588,76123
452,ArjonBu,3,0.00394,27191,35.71982,76123
453,Bruslan,3,0.00394,27194,35.72376,76123
454,bvkin,3,0.00394,27197,35.72770,76123
455,cacois,3,0.00394,27200,35.73164,76123
456,cangencer,3,0.00394,27203,35.73559,76123
457,chrsoo,3,0.00394,27206,35.73953,76123
458,chuckersjp,3,0.00394,27209,35.74347,76123
459,claud-kim,3,0.00394,27212,35.74741,76123
460,corentin1002,3,0.00394,27215,35.75135,76123
461,craicoverflow,3,0.00394,27218,35.75529,76123
462,dangeoffroy,3,0.00394,27221,35.75923,76123
463,dayleparker,3,0.00394,27224,35.76317,76123
464,devnulled,3,0.00394,27227,35.76711,76123
465,dharmit,3,0.00394,27230,35.77105,76123
466,dofinn,3,0.00394,27233,35.77500,76123
467,dougjdouma,3,0.00394,27236,35.77894,76123
468,dove-young,3,0.00394,27239,35.78288,76123
469,EngHabu,3,0.00394,27242,35.78682,76123
470,fentas,3,0.00394,27245,35.79076,76123
471,gmendel,3,0.00394,27248,35.79470,76123
472,harpratap,3,0.00394,27251,35.79864,76123
473,hyprnick,3,0.00394,27254,35.80258,76123
474,iamkirkbater,3,0.00394,27257,35.80652,76123
475,ib-steffen,3,0.00394,27260,35.81046,76123
476,IMOKURI,3,0.00394,27263,35.81441,76123
477,InfoSec812,3,0.00394,27266,35.81835,76123
478,intolerance,3,0.00394,27269,35.82229,76123
479,ipansa,3,0.00394,27272,35.82623,76123
480,Jacklli,3,0.00394,27275,35.83017,76123
481,janiew,3,0.00394,27278,35.83411,76123
482,jarifibrahim,3,0.00394,27281,35.83805,76123
483,JayeshThamke,3,0.00394,27284,35.84199,76123
484,jeffreystoke,3,0.00394,27287,35.84593,76123
485,jenmalloy,3,0.00394,27290,35.84987,76123
486,JHrefiD,3,0.00394,27293,35.85382,76123
487,jhrozek,3,0.00394,27296,35.85776,76123
488,JieJhih,3,0.00394,27299,35.86170,76123
489,jihed,3,0.00394,27302,35.86564,76123
490,jkhelil,3,0.00394,27305,35.86958,76123
491,jonnyfiveiq,3,0.00394,27308,35.87352,76123
492,jontow,3,0.00394,27311,35.87746,76123
493,josledp,3,0.00394,27314,35.88140,76123
494,jtaleric,3,0.00394,27317,35.88534,76123
495,jynok,3,0.00394,27320,35.88928,76123
496,Kaitou786,3,0.00394,27323,35.89323,76123
497,kremmydas,3,0.00394,27326,35.89717,76123
498,kristiandrucker,3,0.00394,27329,35.90111,76123
499,ktreese,3,0.00394,27332,35.90505,76123
500,l0rd,3,0.00394,27335,35.90899,76123
501,l10xbin,3,0.00394,27338,35.91293,76123
502,ladmitry,3,0.00394,27341,35.91687,76123
503,laik,3,0.00394,27344,35.92081,76123
504,LandoCalrizzian,3,0.00394,27347,35.92475,76123
505,larham,3,0.00394,27350,35.92869,76123
506,madhavi-reddy24,3,0.00394,27353,35.93264,76123
507,magick93,3,0.00394,27356,35.93658,76123
508,mancini0,3,0.00394,27359,35.94052,76123
509,marcusportmann,3,0.00394,27362,35.94446,76123
510,mattmb,3,0.00394,27365,35.94840,76123
511,mcurran-us,3,0.00394,27368,35.95234,76123
512,meragodbole,3,0.00394,27371,35.95628,76123
513,mflpopescu,3,0.00394,27374,35.96022,76123
514,micahlee,3,0.00394,27377,35.96416,76123
515,MichaelBrandt4994,3,0.00394,27380,35.96810,76123
516,michaelhenkel,3,0.00394,27383,35.97205,76123
517,mikeroyal,3,0.00394,27386,35.97599,76123
518,mlococo,3,0.00394,27389,35.97993,76123
519,mojsha,3,0.00394,27392,35.98387,76123
520,mphammer,3,0.00394,27395,35.98781,76123
521,mprahl,3,0.00394,27398,35.99175,76123
522,nalbury-handy,3,0.00394,27401,35.99569,76123
523,navidsh,3,0.00394,27404,35.99963,76123
524,newgoliath,3,0.00394,27407,36.00357,76123
525,nut-abctech,3,0.00394,27410,36.00751,76123
526,obeleh,3,0.00394,27413,36.01146,76123
527,Oblynx,3,0.00394,27416,36.01540,76123
528,olivermccarthy,3,0.00394,27419,36.01934,76123
529,pamelachristie,3,0.00394,27422,36.02328,76123
530,paulghattas,3,0.00394,27425,36.02722,76123
531,pawelzny,3,0.00394,27428,36.03116,76123
532,pbergene,3,0.00394,27431,36.03510,76123
533,pharwalk,3,0.00394,27434,36.03904,76123
534,pmacik,3,0.00394,27437,36.04298,76123
535,rafaelvanoni,3,0.00394,27440,36.04692,76123
536,rayanebel,3,0.00394,27443,36.05087,76123
537,revollat,3,0.00394,27446,36.05481,76123
538,rgordill,3,0.00394,27449,36.05875,76123
539,RnnyZhng,3,0.00394,27452,36.06269,76123
540,rootAvish,3,0.00394,27455,36.06663,76123
541,routerhan,3,0.00394,27458,36.07057,76123
542,sashaPM,3,0.00394,27461,36.07451,76123
543,sferich888,3,0.00394,27464,36.07845,76123
544,shekharberry,3,0.00394,27467,36.08239,76123
545,sjakati98,3,0.00394,27470,36.08633,76123
546,spanichellazhaw,3,0.00394,27473,36.09027,76123
547,spiegela,3,0.00394,27476,36.09422,76123
548,sreekanth-ragi,3,0.00394,27479,36.09816,76123
549,StevenMercurio,3,0.00394,27482,36.10210,76123
550,subodh-dharma,3,0.00394,27485,36.10604,76123
551,swapnil-zendesk,3,0.00394,27488,36.10998,76123
552,t0ffel,3,0.00394,27491,36.11392,76123
553,tabishathar,3,0.00394,27494,36.11786,76123
554,themr0c,3,0.00394,27497,36.12180,76123
555,thesunnysky,3,0.00394,27500,36.12574,76123
556,titou10titou10,3,0.00394,27503,36.12968,76123
557,tomqwpl,3,0.00394,27506,36.13363,76123
558,Verolop,3,0.00394,27509,36.13757,76123
559,vovkanaz,3,0.00394,27512,36.14151,76123
560,WenlinH,3,0.00394,27515,36.14545,76123
561,wfindley,3,0.00394,27518,36.14939,76123
562,witmicko,3,0.00394,27521,36.15333,76123
563,wkulhanek,3,0.00394,27524,36.15727,76123
564,YanFen-Guo,3,0.00394,27527,36.16121,76123
565,abhinandan13jan,2,0.00263,27529,36.16384,76123
566,adawolfs,2,0.00263,27531,36.16647,76123
567,AdheipSingh,2,0.00263,27533,36.16909,76123
568,adi658,2,0.00263,27535,36.17172,76123
569,alexander-aldev,2,0.00263,27537,36.17435,76123
570,aliciafmachado,2,0.00263,27539,36.17698,76123
571,alikor,2,0.00263,27541,36.17960,76123
572,alynlin,2,0.00263,27543,36.18223,76123
573,anandswaminathan,2,0.00263,27545,36.18486,76123
574,andrewwebber,2,0.00263,27547,36.18749,76123
575,ansuabraham,2,0.00263,27549,36.19011,76123
576,anurag-prakash-singh,2,0.00263,27551,36.19274,76123
577,apinnecke,2,0.00263,27553,36.19537,76123
578,artburkart,2,0.00263,27555,36.19800,76123
579,awalker125,2,0.00263,27557,36.20062,76123
580,b1zzu,2,0.00263,27559,36.20325,76123
581,Baisang,2,0.00263,27561,36.20588,76123
582,barleyer,2,0.00263,27563,36.20850,76123
583,benbennett,2,0.00263,27565,36.21113,76123
584,bipuladh,2,0.00263,27567,36.21376,76123
585,bparry02,2,0.00263,27569,36.21639,76123
586,bvoss,2,0.00263,27571,36.21901,76123
587,caggles,2,0.00263,27573,36.22164,76123
588,cajundave,2,0.00263,27575,36.22427,76123
589,canghai908,2,0.00263,27577,36.22690,76123
590,chambridge,2,0.00263,27579,36.22952,76123
591,CheesyFeet,2,0.00263,27581,36.23215,76123
592,cheewaio,2,0.00263,27583,36.23478,76123
593,chowarth123,2,0.00263,27585,36.23741,76123
594,christophermaier,2,0.00263,27587,36.24003,76123
595,ch-stark,2,0.00263,27589,36.24266,76123
596,cliles,2,0.00263,27591,36.24529,76123
597,corinnekrych,2,0.00263,27593,36.24791,76123
598,corylanou,2,0.00263,27595,36.25054,76123
599,damozhiying,2,0.00263,27597,36.25317,76123
600,danialgood,2,0.00263,27599,36.25580,76123
601,Davidsoff,2,0.00263,27601,36.25842,76123
602,deweya,2,0.00263,27603,36.26105,76123
603,emmanuelewangi,2,0.00263,27605,36.26368,76123
604,EpiqSty,2,0.00263,27607,36.26631,76123
605,eranco74,2,0.00263,27609,36.26893,76123
606,etiennedi,2,0.00263,27611,36.27156,76123
607,fmoctezuma,2,0.00263,27613,36.27419,76123
608,foriusso84,2,0.00263,27615,36.27682,76123
609,gaurav-nelson,2,0.00263,27617,36.27944,76123
610,gerrit8143,2,0.00263,27619,36.28207,76123
611,gflarity,2,0.00263,27621,36.28470,76123
612,ginccc,2,0.00263,27623,36.28732,76123
613,gmarcy,2,0.00263,27625,36.28995,76123
614,gmgreg,2,0.00263,27627,36.29258,76123
615,HansK-p,2,0.00263,27629,36.29521,76123
616,HarishSandbox,2,0.00263,27631,36.29783,76123
617,hehesky,2,0.00263,27633,36.30046,76123
618,heydenb,2,0.00263,27635,36.30309,76123
619,infinispanrelease,2,0.00263,27637,36.30572,76123
620,jamesbroadhead,2,0.00263,27639,36.30834,76123
621,janekbaraniewski,2,0.00263,27641,36.31097,76123
622,jiwq,2,0.00263,27643,36.31360,76123
623,jmeis,2,0.00263,27645,36.31623,76123
624,jmelis,2,0.00263,27647,36.31885,76123
625,josericardomcastro,2,0.00263,27649,36.32148,76123
626,jplock,2,0.00263,27651,36.32411,76123
627,jsharpe,2,0.00263,27653,36.32673,76123
628,js-max,2,0.00263,27655,36.32936,76123
629,jthomperoo,2,0.00263,27657,36.33199,76123
630,kanekoh,2,0.00263,27659,36.33462,76123
631,kirankumar-mahi,2,0.00263,27661,36.33724,76123
632,KlausTele,2,0.00263,27663,36.33987,76123
633,krish7919,2,0.00263,27665,36.34250,76123
634,lli-hiya,2,0.00263,27667,36.34513,76123
635,luszczynski,2,0.00263,27669,36.34775,76123
636,magescher,2,0.00263,27671,36.35038,76123
637,marekcbj,2,0.00263,27673,36.35301,76123
638,martojdk,2,0.00263,27675,36.35563,76123
639,mathspanda,2,0.00263,27677,36.35826,76123
640,mcgG,2,0.00263,27679,36.36089,76123
641,Mengkzhaoyun,2,0.00263,27681,36.36352,76123
642,msepehr,2,0.00263,27683,36.36614,76123
643,netzzer,2,0.00263,27685,36.36877,76123
644,nharik25,2,0.00263,27687,36.37140,76123
645,nhosoi,2,0.00263,27689,36.37403,76123
646,nicknezis,2,0.00263,27691,36.37665,76123
647,nmars,2,0.00263,27693,36.37928,76123
648,nzaharioudakis,2,0.00263,27695,36.38191,76123
649,onlymellb,2,0.00263,27697,36.38454,76123
650,oraNod,2,0.00263,27699,36.38716,76123
651,oseoin,2,0.00263,27701,36.38979,76123
652,otterley,2,0.00263,27703,36.39242,76123
653,oxful,2,0.00263,27705,36.39504,76123
654,patelajayp,2,0.00263,27707,36.39767,76123
655,patst,2,0.00263,27709,36.40030,76123
656,pchriste,2,0.00263,27711,36.40293,76123
657,peterducai,2,0.00263,27713,36.40555,76123
658,peterjakobs,2,0.00263,27715,36.40818,76123
659,plainchanter,2,0.00263,27717,36.41081,76123
660,polefishu,2,0.00263,27719,36.41344,76123
661,poros,2,0.00263,27721,36.41606,76123
662,q-o-app,2,0.00263,27723,36.41869,76123
663,qubusp,2,0.00263,27725,36.42132,76123
664,Robb-Greathouse,2,0.00263,27727,36.42395,76123
665,robotmaxtron,2,0.00263,27729,36.42657,76123
666,saamalik,2,0.00263,27731,36.42920,76123
667,schmidtd,2,0.00263,27733,36.43183,76123
668,sebsoto,2,0.00263,27735,36.43445,76123
669,sethpeterson,2,0.00263,27737,36.43708,76123
670,shrinandj,2,0.00263,27739,36.43971,76123
671,skckadiyala,2,0.00263,27741,36.44234,76123
672,slaperche-scality,2,0.00263,27743,36.44496,76123
673,snehahegde7,2,0.00263,27745,36.44759,76123
674,SnuK87,2,0.00263,27747,36.45022,76123
675,sonam1412,2,0.00263,27749,36.45285,76123
676,ssbano,2,0.00263,27751,36.45547,76123
677,steveyang95,2,0.00263,27753,36.45810,76123
678,tapairmax,2,0.00263,27755,36.46073,76123
679,TenSt,2,0.00263,27757,36.46336,76123
680,thatInfrastructureGuy,2,0.00263,27759,36.46598,76123
681,thegridman,2,0.00263,27761,36.46861,76123
682,theRealWardo,2,0.00263,27763,36.47124,76123
683,TimoL,2,0.00263,27765,36.47386,76123
684,tkonduri,2,0.00263,27767,36.47649,76123
685,tliron,2,0.00263,27769,36.47912,76123
686,tomklino,2,0.00263,27771,36.48175,76123
687,tpouyer,2,0.00263,27773,36.48437,76123
688,traghave,2,0.00263,27775,36.48700,76123
689,uma-spatil,2,0.00263,27777,36.48963,76123
690,unterstein,2,0.00263,27779,36.49226,76123
691,vaishali-prophecy,2,0.00263,27781,36.49488,76123
692,vincmarz,2,0.00263,27783,36.49751,76123
693,vintikzzz,2,0.00263,27785,36.50014,76123
694,wanminny,2,0.00263,27787,36.50277,76123
695,WarheadsSE,2,0.00263,27789,36.50539,76123
696,weibaohui,2,0.00263,27791,36.50802,76123
697,wondersong,2,0.00263,27793,36.51065,76123
698,xt99,2,0.00263,27795,36.51327,76123
699,xxmyjk,2,0.00263,27797,36.51590,76123
700,yashvardhannanavati,2,0.00263,27799,36.51853,76123
701,yathendra,2,0.00263,27801,36.52116,76123
702,yazug,2,0.00263,27803,36.52378,76123
703,younglee1,2,0.00263,27805,36.52641,76123
704,zbing0203,2,0.00263,27807,36.52904,76123
705,zzztimbo,2,0.00263,27809,36.53167,76123
706,0944336868,1,0.00131,27810,36.53298,76123
707,45cali,1,0.00131,27811,36.53429,76123
708,AAbouZaid,1,0.00131,27812,36.53561,76123
709,abc11h,1,0.00131,27813,36.53692,76123
710,adamcmiel,1,0.00131,27814,36.53823,76123
711,adarshaj,1,0.00131,27815,36.53955,76123
712,adrian,1,0.00131,27816,36.54086,76123
713,agiertli,1,0.00131,27817,36.54218,76123
714,a-hat,1,0.00131,27818,36.54349,76123
715,ahrtr,1,0.00131,27819,36.54480,76123
716,Ajay41117,1,0.00131,27820,36.54612,76123
717,ajssmith,1,0.00131,27821,36.54743,76123
718,AlexeyUzhva,1,0.00131,27822,36.54874,76123
719,alex-guenther,1,0.00131,27823,36.55006,76123
720,alimobrem,1,0.00131,27824,36.55137,76123
721,aman1989v,1,0.00131,27825,36.55268,76123
722,anandsinghkunwar,1,0.00131,27826,36.55400,76123
723,andrewazores,1,0.00131,27827,36.55531,76123
724,angapov,1,0.00131,27828,36.55663,76123
725,anikin-aa,1,0.00131,27829,36.55794,76123
726,ankitrgadiya,1,0.00131,27830,36.55925,76123
727,ankitsinhaiitg,1,0.00131,27831,36.56057,76123
728,Annegies,1,0.00131,27832,36.56188,76123
729,anwar6953,1,0.00131,27833,36.56319,76123
730,apasrini,1,0.00131,27834,36.56451,76123
731,arewm,1,0.00131,27835,36.56582,76123
732,aRobinson-R7,1,0.00131,27836,36.56713,76123
733,arturobrzut,1,0.00131,27837,36.56845,76123
734,arunkanthkarre,1,0.00131,27838,36.56976,76123
735,ashokhein,1,0.00131,27839,36.57108,76123
736,asishrs,1,0.00131,27840,36.57239,76123
737,austince,1,0.00131,27841,36.57370,76123
738,austinpapp,1,0.00131,27842,36.57502,76123
739,avarf,1,0.00131,27843,36.57633,76123
740,avrahams,1,0.00131,27844,36.57764,76123
741,Azadehkhojandi,1,0.00131,27845,36.57896,76123
742,bah2830,1,0.00131,27846,36.58027,76123
743,bekircanagaoglu,1,0.00131,27847,36.58159,76123
744,benceszikora,1,0.00131,27848,36.58290,76123
745,bennyturns,1,0.00131,27849,36.58421,76123
746,benoit-a,1,0.00131,27850,36.58553,76123
747,bjpritch,1,0.00131,27851,36.58684,76123
748,bkannadassan,1,0.00131,27852,36.58815,76123
749,blafrisch,1,0.00131,27853,36.58947,76123
750,bonhamcm,1,0.00131,27854,36.59078,76123
751,bpayt2,1,0.00131,27855,36.59209,76123
752,brnavneet,1,0.00131,27856,36.59341,76123
753,brvith,1,0.00131,27857,36.59472,76123
754,burov,1,0.00131,27858,36.59604,76123
755,bvboca,1,0.00131,27859,36.59735,76123
756,bymafmaf,1,0.00131,27860,36.59866,76123
757,cdc1807,1,0.00131,27861,36.59998,76123
758,cdoan1,1,0.00131,27862,36.60129,76123
759,charles-d-burton,1,0.00131,27863,36.60260,76123
760,chenmin1992,1,0.00131,27864,36.60392,76123
761,chrisbygrave,1,0.00131,27865,36.60523,76123
762,christianhxc,1,0.00131,27866,36.60654,76123
763,ChristianKreuzberger,1,0.00131,27867,36.60786,76123
764,christophefarges,1,0.00131,27868,36.60917,76123
765,christopherL91,1,0.00131,27869,36.61049,76123
766,claudio4j,1,0.00131,27870,36.61180,76123
767,Cristian-Hernandez,1,0.00131,27871,36.61311,76123
768,dalelane,1,0.00131,27872,36.61443,76123
769,danehrlich1,1,0.00131,27873,36.61574,76123
770,danielkucera,1,0.00131,27874,36.61705,76123
771,danielle-mustillo,1,0.00131,27875,36.61837,76123
772,daniellohausen,1,0.00131,27876,36.61968,76123
773,danielsig727,1,0.00131,27877,36.62099,76123
774,danni-m,1,0.00131,27878,36.62231,76123
775,DarkSkyT9A,1,0.00131,27879,36.62362,76123
776,darmenliu,1,0.00131,27880,36.62494,76123
777,darrensu-ibm,1,0.00131,27881,36.62625,76123
778,david50407,1,0.00131,27882,36.62756,76123
779,davidshepard989,1,0.00131,27883,36.62888,76123
780,DeekshithVemula,1,0.00131,27884,36.63019,76123
781,dejwsz,1,0.00131,27885,36.63150,76123
782,deknos,1,0.00131,27886,36.63282,76123
783,depauna,1,0.00131,27887,36.63413,76123
784,Devin-Holland,1,0.00131,27888,36.63545,76123
785,devopsgym,1,0.00131,27889,36.63676,76123
786,dhrp,1,0.00131,27890,36.63807,76123
787,diogormatas,1,0.00131,27891,36.63939,76123
788,djohnston89,1,0.00131,27892,36.64070,76123
789,dkirrane,1,0.00131,27893,36.64201,76123
790,doltori,1,0.00131,27894,36.64333,76123
791,dougdouma,1,0.00131,27895,36.64464,76123
792,drf,1,0.00131,27896,36.64595,76123
793,duritong,1,0.00131,27897,36.64727,76123
794,dwertent,1,0.00131,27898,36.64858,76123
795,e9169,1,0.00131,27899,36.64990,76123
796,eformat,1,0.00131,27900,36.65121,76123
797,egaudet,1,0.00131,27901,36.65252,76123
798,elemental-lf,1,0.00131,27902,36.65384,76123
799,eltomato89,1,0.00131,27903,36.65515,76123
800,enekofb,1,0.00131,27904,36.65646,76123
801,erdrix,1,0.00131,27905,36.65778,76123
802,evadnoob,1,0.00131,27906,36.65909,76123
803,eyusupov,1,0.00131,27907,36.66040,76123
804,fabstu,1,0.00131,27908,36.66172,76123
805,feikesteenbergen,1,0.00131,27909,36.66303,76123
806,filimonov,1,0.00131,27910,36.66435,76123
807,fkarakas,1,0.00131,27911,36.66566,76123
808,fpetkovski,1,0.00131,27912,36.66697,76123
809,fr34k8,1,0.00131,27913,36.66829,76123
810,Frankkkkk,1,0.00131,27914,36.66960,76123
811,freddy-perez,1,0.00131,27915,36.67091,76123
812,gaborbernat,1,0.00131,27916,36.67223,76123
813,gautam1858,1,0.00131,27917,36.67354,76123
814,gautambaghel,1,0.00131,27918,36.67486,76123
815,gegles,1,0.00131,27919,36.67617,76123
816,genialmaniac,1,0.00131,27920,36.67748,76123
817,geoberle,1,0.00131,27921,36.67880,76123
818,geritol,1,0.00131,27922,36.68011,76123
819,giacomoch,1,0.00131,27923,36.68142,76123
820,GNewbury1,1,0.00131,27924,36.68274,76123
821,gnunn1,1,0.00131,27925,36.68405,76123
822,gzur,1,0.00131,27926,36.68536,76123
823,h777xx,1,0.00131,27927,36.68668,76123
824,h7kanna,1,0.00131,27928,36.68799,76123
825,halmai,1,0.00131,27929,36.68931,76123
826,hardbone12,1,0.00131,27930,36.69062,76123
827,harisrini,1,0.00131,27931,36.69193,76123
828,harjas27,1,0.00131,27932,36.69325,76123
829,harveyelsom,1,0.00131,27933,36.69456,76123
830,Havilland,1,0.00131,27934,36.69587,76123
831,havmad,1,0.00131,27935,36.69719,76123
832,hawky-4s-,1,0.00131,27936,36.69850,76123
833,hbfjk,1,0.00131,27937,36.69981,76123
834,heisenbergye,1,0.00131,27938,36.70113,76123
835,hermanbanken,1,0.00131,27939,36.70244,76123
836,hibell,1,0.00131,27940,36.70376,76123
837,hjwilson1956,1,0.00131,27941,36.70507,76123
838,hkroger,1,0.00131,27942,36.70638,76123
839,holger-wg2,1,0.00131,27943,36.70770,76123
840,hyunysmile,1,0.00131,27944,36.70901,76123
841,ibuziuk,1,0.00131,27945,36.71032,76123
842,ingenthr,1,0.00131,27946,36.71164,76123
843,ioricloud,1,0.00131,27947,36.71295,76123
844,ishankhare07,1,0.00131,27948,36.71427,76123
845,iwasaki-kenta,1,0.00131,27949,36.71558,76123
846,iyurev,1,0.00131,27950,36.71689,76123
847,jadencodes,1,0.00131,27951,36.71821,76123
848,jadeyliu939,1,0.00131,27952,36.71952,76123
849,jaemyunlee,1,0.00131,27953,36.72083,76123
850,JakobGray,1,0.00131,27954,36.72215,76123
851,jamesphillpotts-fr,1,0.00131,27955,36.72346,76123
852,jarcher,1,0.00131,27956,36.72477,76123
853,jbrisbin,1,0.00131,27957,36.72609,76123
854,jdbaldry,1,0.00131,27958,36.72740,76123
855,JeremiahDJordan,1,0.00131,27959,36.72872,76123
856,jhgaylor,1,0.00131,27960,36.73003,76123
857,jjaferson,1,0.00131,27961,36.73134,76123
858,jmickey,1,0.00131,27962,36.73266,76123
859,johnfriz,1,0.00131,27963,36.73397,76123
860,jpigottj,1,0.00131,27964,36.73528,76123
861,jruano03,1,0.00131,27965,36.73660,76123
862,Juggcode,1,0.00131,27966,36.73791,76123
863,julienlim,1,0.00131,27967,36.73922,76123
864,justinbarrick,1,0.00131,27968,36.74054,76123
865,justinclift,1,0.00131,27969,36.74185,76123
866,jValdron,1,0.00131,27970,36.74317,76123
867,jwalters-gpsw,1,0.00131,27971,36.74448,76123
868,kalise,1,0.00131,27972,36.74579,76123
869,kapilpau,1,0.00131,27973,36.74711,76123
870,kapooklovely,1,0.00131,27974,36.74842,76123
871,kf6nux,1,0.00131,27975,36.74973,76123
872,kfdev170707,1,0.00131,27976,36.75105,76123
873,khodayard,1,0.00131,27977,36.75236,76123
874,kincl,1,0.00131,27978,36.75367,76123
875,kirankt,1,0.00131,27979,36.75499,76123
876,kshithijiyer,1,0.00131,27980,36.75630,76123
877,kYann,1,0.00131,27981,36.75762,76123
878,LaloLoop,1,0.00131,27982,36.75893,76123
879,laloyalo,1,0.00131,27983,36.76024,76123
880,leoluk,1,0.00131,27984,36.76156,76123
881,liurui-1,1,0.00131,27985,36.76287,76123
882,liuruiyiyang,1,0.00131,27986,36.76418,76123
883,lmammino,1,0.00131,27987,36.76550,76123
884,loadwiki,1,0.00131,27988,36.76681,76123
885,loxley,1,0.00131,27989,36.76813,76123
886,LPowlett,1,0.00131,27990,36.76944,76123
887,lukasz-antoniak,1,0.00131,27991,36.77075,76123
888,M4R774,1,0.00131,27992,36.77207,76123
889,mailzyok,1,0.00131,27993,36.77338,76123
890,malagoli,1,0.00131,27994,36.77469,76123
891,mansikulkarni96,1,0.00131,27995,36.77601,76123
892,marc-obrien,1,0.00131,27996,36.77732,76123
893,Marki4711,1,0.00131,27997,36.77863,76123
894,matthewygf,1,0.00131,27998,36.77995,76123
895,maxclac,1,0.00131,27999,36.78126,76123
896,mdelder,1,0.00131,28000,36.78258,76123
897,Mercwri,1,0.00131,28001,36.78389,76123
898,mffiedler,1,0.00131,28002,36.78520,76123
899,mfrances17,1,0.00131,28003,36.78652,76123
900,michaelcourcy,1,0.00131,28004,36.78783,76123
901,michalrabinowitch,1,0.00131,28005,36.78914,76123
902,Michkov,1,0.00131,28006,36.79046,76123
903,mikewied,1,0.00131,28007,36.79177,76123
904,mingzhuyang,1,0.00131,28008,36.79308,76123
905,mithuns,1,0.00131,28009,36.79440,76123
906,MMarus,1,0.00131,28010,36.79571,76123
907,mmuzikar,1,0.00131,28011,36.79703,76123
908,mphamapti,1,0.00131,28012,36.79834,76123
909,mr24091997,1,0.00131,28013,36.79965,76123
910,msmygit,1,0.00131,28014,36.80097,76123
911,msvechla,1,0.00131,28015,36.80228,76123
912,naeemkhan12,1,0.00131,28016,36.80359,76123
913,nate-duke,1,0.00131,28017,36.80491,76123
914,nathanweatherly,1,0.00131,28018,36.80622,76123
915,nmasse-itix,1,0.00131,28019,36.80754,76123
916,NoizeMe,1,0.00131,28020,36.80885,76123
917,NormJohnIV,1,0.00131,28021,36.81016,76123
918,odykyi,1,0.00131,28022,36.81148,76123
919,OItsMAK,1,0.00131,28023,36.81279,76123
920,onuryilmaz,1,0.00131,28024,36.81410,76123
921,oscarpicasso-intact,1,0.00131,28025,36.81542,76123
922,palak2011,1,0.00131,28026,36.81673,76123
923,panichella,1,0.00131,28027,36.81804,76123
924,ParFlesh,1,0.00131,28028,36.81936,76123
925,paulcostinean,1,0.00131,28029,36.82067,76123
926,pennpeng,1,0.00131,28030,36.82199,76123
927,petebowden,1,0.00131,28031,36.82330,76123
928,pgodowski,1,0.00131,28032,36.82461,76123
929,phantomjinx,1,0.00131,28033,36.82593,76123
930,philhug,1,0.00131,28034,36.82724,76123
931,pkrishnath,1,0.00131,28035,36.82855,76123
932,plnordquist,1,0.00131,28036,36.82987,76123
933,pmccarthy,1,0.00131,28037,36.83118,76123
934,posriniv,1,0.00131,28038,36.83249,76123
935,prasenforu,1,0.00131,28039,36.83381,76123
936,prashant182,1,0.00131,28040,36.83512,76123
937,primeroz,1,0.00131,28041,36.83644,76123
938,p-sforza,1,0.00131,28042,36.83775,76123
939,pyros2097,1,0.00131,28043,36.83906,76123
940,q42jaap,1,0.00131,28044,36.84038,76123
941,RahulNishad,1,0.00131,28045,36.84169,76123
942,rashmi43,1,0.00131,28046,36.84300,76123
943,ravishankarsrrav,1,0.00131,28047,36.84432,76123
944,rawc0der,1,0.00131,28048,36.84563,76123
945,rbo,1,0.00131,28049,36.84695,76123
946,Reamer,1,0.00131,28050,36.84826,76123
947,RedbackThomson,1,0.00131,28051,36.84957,76123
948,Redeux,1,0.00131,28052,36.85089,76123
949,renemoser-sbb,1,0.00131,28053,36.85220,76123
950,rgarcia6520,1,0.00131,28054,36.85351,76123
951,RoeeShlomo,1,0.00131,28055,36.85483,76123
952,rohitrsh,1,0.00131,28056,36.85614,76123
953,roufique2,1,0.00131,28057,36.85745,76123
954,rpajay,1,0.00131,28058,36.85877,76123
955,rrati,1,0.00131,28059,36.86008,76123
956,sahilsk,1,0.00131,28060,36.86140,76123
957,SamhooXee,1,0.00131,28061,36.86271,76123
958,sanbornick,1,0.00131,28062,36.86402,76123
959,schen1,1,0.00131,28063,36.86534,76123
960,sdudoladov,1,0.00131,28064,36.86665,76123
961,sebs42,1,0.00131,28065,36.86796,76123
962,seravat,1,0.00131,28066,36.86928,76123
963,sevennt,1,0.00131,28067,36.87059,76123
964,sfxworks,1,0.00131,28068,36.87190,76123
965,sgkiokas,1,0.00131,28069,36.87322,76123
966,sgrzemski,1,0.00131,28070,36.87453,76123
967,shawnshuang,1,0.00131,28071,36.87585,76123
968,shevchyk-aa,1,0.00131,28072,36.87716,76123
969,shrinaththube,1,0.00131,28073,36.87847,76123
970,shuawest,1,0.00131,28074,36.87979,76123
971,sjbylo,1,0.00131,28075,36.88110,76123
972,skhatri,1,0.00131,28076,36.88241,76123
973,skuffe,1,0.00131,28077,36.88373,76123
974,skycmoon,1,0.00131,28078,36.88504,76123
975,skylt,1,0.00131,28079,36.88635,76123
976,Smiley73,1,0.00131,28080,36.88767,76123
977,snowerem,1,0.00131,28081,36.88898,76123
978,solcates,1,0.00131,28082,36.89030,76123
979,s-rogers,1,0.00131,28083,36.89161,76123
980,ssecond,1,0.00131,28084,36.89292,76123
981,SSshahan,1,0.00131,28085,36.89424,76123
982,swe-covis,1,0.00131,28086,36.89555,76123
983,takara9,1,0.00131,28087,36.89686,76123
984,tamireran,1,0.00131,28088,36.89818,76123
985,taylanerden,1,0.00131,28089,36.89949,76123
986,taylormgeorge91,1,0.00131,28090,36.90081,76123
987,techthumb,1,0.00131,28091,36.90212,76123
988,termie,1,0.00131,28092,36.90343,76123
989,terorie,1,0.00131,28093,36.90475,76123
990,thecrudge,1,0.00131,28094,36.90606,76123
991,theSupermacy,1,0.00131,28095,36.90737,76123
992,thiagoalessio,1,0.00131,28096,36.90869,76123
993,thom8,1,0.00131,28097,36.91000,76123
994,tiagomeireles,1,0.00131,28098,36.91131,76123
995,TimMoran,1,0.00131,28099,36.91263,76123
996,Tirumalavasa,1,0.00131,28100,36.91394,76123
997,TopGunBasten,1,0.00131,28101,36.91526,76123
998,toppole69,1,0.00131,28102,36.91657,76123
999,tplevko,1,0.00131,28103,36.91788,76123
1000,trescst,1,0.00131,28104,36.91920,76123
1001,tsungming,1,0.00131,28105,36.92051,76123
1002,twose,1,0.00131,28106,36.92182,76123
1003,u5surf,1,0.00131,28107,36.92314,76123
1004,urfuwo,1,0.00131,28108,36.92445,76123
1005,vpavlin,1,0.00131,28109,36.92576,76123
1006,vthapar,1,0.00131,28110,36.92708,76123
1007,walkamongus,1,0.00131,28111,36.92839,76123
1008,waltforme,1,0.00131,28112,36.92971,76123
1009,wanderboessenkool,1,0.00131,28113,36.93102,76123
1010,wangdrew,1,0.00131,28114,36.93233,76123
1011,waseemkhosa,1,0.00131,28115,36.93365,76123
1012,whachoe,1,0.00131,28116,36.93496,76123
1013,whatwhat280,1,0.00131,28117,36.93627,76123
1014,wheelerlaw,1,0.00131,28118,36.93759,76123
1015,whowutwut,1,0.00131,28119,36.93890,76123
1016,wiardvanrij,1,0.00131,28120,36.94022,76123
1017,wlmvp,1,0.00131,28121,36.94153,76123
1018,xiaoshangquan,1,0.00131,28122,36.94284,76123
1019,xunchangguo,1,0.00131,28123,36.94416,76123
1020,yankcrime,1,0.00131,28124,36.94547,76123
1021,yersan,1,0.00131,28125,36.94678,76123
1022,YiannisGkoufas,1,0.00131,28126,36.94810,76123
1023,ypresa1,1,0.00131,28127,36.94941,76123
1024,zenglian,1,0.00131,28128,36.95072,76123
1025,zephinzer,1,0.00131,28129,36.95204,76123
1026,zerok,1,0.00131,28130,36.95335,76123
1027,zhangtbj,1,0.00131,28131,36.95467,76123
1028,zipper97412,1,0.00131,28132,36.95598,76123
