rank_number,actor,commits,percent,cumulative_sum,cumulative_percent,all_commits
1,LutzJaenicke,1116,0.46375,1116,0.46375,240647
2,PaulGap,917,0.38106,2033,0.84481,240647
3,mlaval,517,0.21484,2550,1.05964,240647
4,ichernev,468,0.19448,3018,1.25412,240647
5,bernd-edlinger,398,0.16539,3416,1.41951,240647
6,fellows3,348,0.14461,3764,1.56412,240647
7,jimfb,345,0.14336,4109,1.70748,240647
8,simov,289,0.12009,4398,1.82757,240647
9,benlesh,264,0.10970,4662,1.93728,240647
10,inder123,263,0.10929,4925,2.04657,240647
11,mary-poppins,245,0.10181,5170,2.14838,240647
12,ChrisMaddock,236,0.09807,5406,2.24644,240647
13,mspncp,184,0.07646,5590,2.32290,240647
14,sjtrimble,161,0.06690,5751,2.38981,240647
15,devversion,152,0.06316,5903,2.45297,240647
16,AtsushiKan,146,0.06067,6049,2.51364,240647
17,cexbrayat,132,0.05485,6181,2.56849,240647
18,btford,129,0.05361,6310,2.62210,240647
19,eiriktsarpalis,109,0.04529,6419,2.66739,240647
20,pshrmn,107,0.04446,6526,2.71186,240647
21,marek-safar,106,0.04405,6632,2.75590,240647
22,gotwarlost,101,0.04197,6733,2.79787,240647
23,fitzgen,90,0.03740,6823,2.83527,240647
24,twbs-grunt,87,0.03615,6910,2.87143,240647
25,DABH,83,0.03449,6993,2.90592,240647
26,abetomo,79,0.03283,7072,2.93874,240647
27,saper,78,0.03241,7150,2.97116,240647
28,falsyvalues,76,0.03158,7226,3.00274,240647
29,shadowspawn,71,0.02950,7297,3.03224,240647
30,alexindigo,68,0.02826,7365,3.06050,240647
31,mkarg,67,0.02784,7432,3.08834,240647
32,blakeembrey,65,0.02701,7497,3.11535,240647
33,nlf,65,0.02701,7562,3.14236,240647
34,sepidehMS,64,0.02659,7626,3.16896,240647
35,kevmoo,63,0.02618,7689,3.19514,240647
36,satazor,61,0.02535,7750,3.22048,240647
37,timrwood,61,0.02535,7811,3.24583,240647
38,oznetmaster,60,0.02493,7871,3.27077,240647
39,arb,59,0.02452,7930,3.29528,240647
40,hargasinski,59,0.02452,7989,3.31980,240647
41,goto-bus-stop,58,0.02410,8047,3.34390,240647
42,akre54,57,0.02369,8104,3.36759,240647
43,ayazhafiz,57,0.02369,8161,3.39127,240647
44,madler,56,0.02327,8217,3.41454,240647
45,romen,56,0.02327,8273,3.43782,240647
46,evmar,55,0.02286,8328,3.46067,240647
47,hnrch02,55,0.02286,8383,3.48353,240647
48,jsfb,55,0.02286,8438,3.50638,240647
49,stevemao,55,0.02286,8493,3.52924,240647
50,caesar1995,54,0.02244,8547,3.55168,240647
51,michaelficarra,53,0.02202,8600,3.57370,240647
52,threepointone,53,0.02202,8653,3.59572,240647
53,gsmet,52,0.02161,8705,3.61733,240647
54,jquense,52,0.02161,8757,3.63894,240647
55,realityking,52,0.02161,8809,3.66055,240647
56,stash,52,0.02161,8861,3.68216,240647
57,zhiyelee,51,0.02119,8912,3.70335,240647
58,robertmesserle,50,0.02078,8962,3.72413,240647
59,vanesyan,50,0.02078,9012,3.74490,240647
60,RyanZim,49,0.02036,9061,3.76527,240647
61,pieroxy,48,0.01995,9109,3.78521,240647
62,emilyemorehouse,47,0.01953,9156,3.80474,240647
63,OmarTawfik,47,0.01953,9203,3.82427,240647
64,Arkni,46,0.01912,9249,3.84339,240647
65,lacker,45,0.01870,9294,3.86209,240647
66,mathiasbynens,44,0.01828,9338,3.88037,240647
67,staabm,44,0.01828,9382,3.89866,240647
68,supergibbs,43,0.01787,9425,3.91653,240647
69,CaerusKaru,42,0.01745,9467,3.93398,240647
70,naomiblack,42,0.01745,9509,3.95143,240647
71,motdotla,41,0.01704,9550,3.96847,240647
72,thorn0,41,0.01704,9591,3.98551,240647
73,scalablecory,40,0.01662,9631,4.00213,240647
74,dcousens,39,0.01621,9670,4.01833,240647
75,evanvosberg,39,0.01621,9709,4.03454,240647
76,joyent-automation,39,0.01621,9748,4.05075,240647
77,nylen,39,0.01621,9787,4.06695,240647
78,Splaktar,38,0.01579,9825,4.08274,240647
79,OverZealous,37,0.01538,9862,4.09812,240647
80,tijoytom,37,0.01538,9899,4.11349,240647
81,coreyfarrell,36,0.01496,9935,4.12845,240647
82,mafintosh,36,0.01496,9971,4.14341,240647
83,andresgalante,35,0.01454,10006,4.15796,240647
84,jridgewell,35,0.01454,10041,4.17250,240647
85,pvorb,35,0.01454,10076,4.18705,240647
86,nickuraltsev,34,0.01413,10110,4.20117,240647
87,cpojer,33,0.01371,10143,4.21489,240647
88,JohnRGee,33,0.01371,10176,4.22860,240647
89,sokket,33,0.01371,10209,4.24231,240647
90,yeiacatl,33,0.01371,10242,4.25603,240647
91,pose,32,0.01330,10274,4.26932,240647
92,arschmitz,31,0.01288,10305,4.28221,240647
93,beldmit,30,0.01247,10335,4.29467,240647
94,BendingBender,30,0.01247,10365,4.30714,240647
95,EmpireJones,29,0.01205,10394,4.31919,240647
96,felipewmartins,29,0.01205,10423,4.33124,240647
97,frederikprijck,29,0.01205,10452,4.34329,240647
98,mleguen,29,0.01205,10481,4.35534,240647
99,seanstrom,29,0.01205,10510,4.36739,240647
100,spion,28,0.01164,10538,4.37903,240647
101,svick,28,0.01164,10566,4.39066,240647
102,swseverance,28,0.01164,10594,4.40230,240647
103,adrianheine,27,0.01122,10621,4.41352,240647
104,ahasall,27,0.01122,10648,4.42474,240647
105,davglass,27,0.01122,10675,4.43596,240647
106,joecritch,27,0.01122,10702,4.44718,240647
107,fnagel,26,0.01080,10728,4.45798,240647
108,gkossakowski,26,0.01080,10754,4.46879,240647
109,invernizzie,26,0.01080,10780,4.47959,240647
110,keyanzhang,26,0.01080,10806,4.49039,240647
111,Marusyk,26,0.01080,10832,4.50120,240647
112,mattbishop,26,0.01080,10858,4.51200,240647
113,tromey,26,0.01080,10884,4.52281,240647
114,VladUreche,26,0.01080,10910,4.53361,240647
115,FredKSchott,25,0.01039,10935,4.54400,240647
116,jteplitz602,25,0.01039,10960,4.55439,240647
117,Khaledgarbaya,25,0.01039,10985,4.56478,240647
118,stevemoser,25,0.01039,11010,4.57517,240647
119,tony19,25,0.01039,11035,4.58555,240647
120,zamont,25,0.01039,11060,4.59594,240647
121,dariajung,24,0.00997,11084,4.60592,240647
122,ermazi,24,0.00997,11108,4.61589,240647
123,LinusU,24,0.00997,11132,4.62586,240647
124,pakrym,24,0.00997,11156,4.63584,240647
125,peterblazejewicz,24,0.00997,11180,4.64581,240647
126,ashsearle,23,0.00956,11203,4.65537,240647
127,contra,23,0.00956,11226,4.66492,240647
128,DanielRuf,23,0.00956,11249,4.67448,240647
129,kentcdodds,23,0.00956,11272,4.68404,240647
130,lxShaDoWxl,23,0.00956,11295,4.69360,240647
131,reconbot,23,0.00956,11318,4.70315,240647
132,TrySound,23,0.00956,11341,4.71271,240647
133,vszakats,23,0.00956,11364,4.72227,240647
134,ysds,23,0.00956,11387,4.73183,240647
135,BastienL,22,0.00914,11409,4.74097,240647
136,JohnPostlethwait,22,0.00914,11431,4.75011,240647
137,Marsup,22,0.00914,11453,4.75925,240647
138,Tratcher,22,0.00914,11475,4.76840,240647
139,krytarowski,21,0.00873,11496,4.77712,240647
140,SamVerschueren,21,0.00873,11517,4.78585,240647
141,dariobraun,20,0.00831,11537,4.79416,240647
142,torkleyy,20,0.00831,11557,4.80247,240647
143,typicaljoe,20,0.00831,11577,4.81078,240647
144,vojtajina,20,0.00831,11597,4.81909,240647
145,yujayee,20,0.00831,11617,4.82740,240647
146,AfsanehR,19,0.00790,11636,4.83530,240647
147,Foxandxss,19,0.00790,11655,4.84319,240647
148,MitMaro,19,0.00790,11674,4.85109,240647
149,niksy,19,0.00790,11693,4.85898,240647
150,SomeKittens,19,0.00790,11712,4.86688,240647
151,substack,19,0.00790,11731,4.87478,240647
152,TrevorKarjanis,19,0.00790,11750,4.88267,240647
153,troygoode,19,0.00790,11769,4.89057,240647
154,yungsters,19,0.00790,11788,4.89846,240647
155,ahmadnassri,18,0.00748,11806,4.90594,240647
156,benelliott,18,0.00748,11824,4.91342,240647
157,jakemac53,18,0.00748,11842,4.92090,240647
158,jcblw,18,0.00748,11860,4.92838,240647
159,jeremyvii,18,0.00748,11878,4.93586,240647
160,kevva,18,0.00748,11896,4.94334,240647
161,robrich,18,0.00748,11914,4.95082,240647
162,supercodepoet,18,0.00748,11932,4.95830,240647
163,alexwolfe,17,0.00706,11949,4.96536,240647
164,amilajack,17,0.00706,11966,4.97243,240647
165,Andarist,17,0.00706,11983,4.97949,240647
166,dicko2,17,0.00706,12000,4.98656,240647
167,doowb,17,0.00706,12017,4.99362,240647
168,jarrodyellets,17,0.00706,12034,5.00069,240647
169,jbnicolai,17,0.00706,12051,5.00775,240647
170,loganfsmyth,17,0.00706,12068,5.01481,240647
171,TheSavior,17,0.00706,12085,5.02188,240647
172,carlossanlop,16,0.00665,12101,5.02853,240647
173,damieng,16,0.00665,12117,5.03518,240647
174,dragos,16,0.00665,12133,5.04182,240647
175,mmikowski,16,0.00665,12149,5.04847,240647
176,othiym23,16,0.00665,12165,5.05512,240647
177,pgilad,16,0.00665,12181,5.06177,240647
178,rvagg,16,0.00665,12197,5.06842,240647
179,tomocchino,16,0.00665,12213,5.07507,240647
180,wesleytodd,16,0.00665,12229,5.08172,240647
181,battaglr,15,0.00623,12244,5.08795,240647
182,billyjanitsch,15,0.00623,12259,5.09418,240647
183,devongovett,15,0.00623,12274,5.10042,240647
184,gjungb,15,0.00623,12289,5.10665,240647
185,kanongil,15,0.00623,12304,5.11288,240647
186,Simek,15,0.00623,12319,5.11912,240647
187,vatsan-madhavan,15,0.00623,12334,5.12535,240647
188,defunctzombie,14,0.00582,12348,5.13117,240647
189,gourlaysama,14,0.00582,12362,5.13698,240647
190,Ichoran,14,0.00582,12376,5.14280,240647
191,jkotalik,14,0.00582,12390,5.14862,240647
192,lunaruan,14,0.00582,12404,5.15444,240647
193,stevehobbsdev,14,0.00582,12418,5.16026,240647
194,woahitsraj,14,0.00582,12432,5.16607,240647
195,andreialecu,13,0.00540,12445,5.17148,240647
196,arjantijms,13,0.00540,12458,5.17688,240647
197,aswaterman,13,0.00540,12471,5.18228,240647
198,evocateur,13,0.00540,12484,5.18768,240647
199,grimreaper,13,0.00540,12497,5.19308,240647
200,macjohnny,13,0.00540,12510,5.19849,240647
201,mattlewis92,13,0.00540,12523,5.20389,240647
202,paulmillr,13,0.00540,12536,5.20929,240647
203,StringEpsilon,13,0.00540,12549,5.21469,240647
204,bimargulies-google,12,0.00499,12561,5.21968,240647
205,BridgeAR,12,0.00499,12573,5.22467,240647
206,Chainhelen,12,0.00499,12585,5.22965,240647
207,dannyskoog,12,0.00499,12597,5.23464,240647
208,davidjb,12,0.00499,12609,5.23962,240647
209,FiveTimesTheFun,12,0.00499,12621,5.24461,240647
210,julianobrasil,12,0.00499,12633,5.24960,240647
211,nicolo-ribaudo,12,0.00499,12645,5.25458,240647
212,omsmith,12,0.00499,12657,5.25957,240647
213,Pereida,12,0.00499,12669,5.26456,240647
214,PeteGillinGoogle,12,0.00499,12681,5.26954,240647
215,pickfire,12,0.00499,12693,5.27453,240647
216,schnittstabil,12,0.00499,12705,5.27952,240647
217,alrra,11,0.00457,12716,5.28409,240647
218,apechimp,11,0.00457,12727,5.28866,240647
219,brandonroberts,11,0.00457,12738,5.29323,240647
220,butterflyhug,11,0.00457,12749,5.29780,240647
221,ChALkeR,11,0.00457,12760,5.30237,240647
222,d10,11,0.00457,12771,5.30694,240647
223,danez,11,0.00457,12782,5.31151,240647
224,davepacheco,11,0.00457,12793,5.31609,240647
225,escodel,11,0.00457,12804,5.32066,240647
226,Goodwine,11,0.00457,12815,5.32523,240647
227,hazendaz,11,0.00457,12826,5.32980,240647
228,joshlemer,11,0.00457,12837,5.33437,240647
229,joshwand,11,0.00457,12848,5.33894,240647
230,jutaz,11,0.00457,12859,5.34351,240647
231,mapleeit,11,0.00457,12870,5.34808,240647
232,raja-ashok,11,0.00457,12881,5.35265,240647
233,agnosticdev,10,0.00416,12891,5.35681,240647
234,alireza-mh,10,0.00416,12901,5.36096,240647
235,amZotti,10,0.00416,12911,5.36512,240647
236,ChrisAlderson,10,0.00416,12921,5.36928,240647
237,clemmy,10,0.00416,12931,5.37343,240647
238,coolaj86,10,0.00416,12941,5.37759,240647
239,Degubi,10,0.00416,12951,5.38174,240647
240,Gillespie59,10,0.00416,12961,5.38590,240647
241,justsml,10,0.00416,12971,5.39005,240647
242,keithharvey,10,0.00416,12981,5.39421,240647
243,MaximilianTews,10,0.00416,12991,5.39836,240647
244,maxogden,10,0.00416,13001,5.40252,240647
245,michaelgeorgeattard,10,0.00416,13011,5.40667,240647
246,mojavelinux,10,0.00416,13021,5.41083,240647
247,paulirish,10,0.00416,13031,5.41499,240647
248,pfmooney,10,0.00416,13041,5.41914,240647
249,PiPeep,10,0.00416,13051,5.42330,240647
250,robwormald,10,0.00416,13061,5.42745,240647
251,urish,10,0.00416,13071,5.43161,240647
252,WilliamCollishaw,10,0.00416,13081,5.43576,240647
253,xcatliu,10,0.00416,13091,5.43992,240647
254,aisera-mikowski,9,0.00374,13100,5.44366,240647
255,AlmeroSteyn,9,0.00374,13109,5.44740,240647
256,aLostEngineer,9,0.00374,13118,5.45114,240647
257,bradwestfall,9,0.00374,13127,5.45488,240647
258,Delagen,9,0.00374,13136,5.45862,240647
259,FezVrasta,9,0.00374,13145,5.46236,240647
260,graue,9,0.00374,13154,5.46610,240647
261,gricey432,9,0.00374,13163,5.46984,240647
262,jmm,9,0.00374,13172,5.47358,240647
263,jorrit,9,0.00374,13181,5.47732,240647
264,kseamon,9,0.00374,13190,5.48106,240647
265,LayZeeDK,9,0.00374,13199,5.48480,240647
266,MartinKolarik,9,0.00374,13208,5.48854,240647
267,mbehrlich,9,0.00374,13217,5.49228,240647
268,mikesherov,9,0.00374,13226,5.49602,240647
269,mysticatea,9,0.00374,13235,5.49976,240647
270,nattress,9,0.00374,13244,5.50350,240647
271,packtpartner,9,0.00374,13253,5.50724,240647
272,philipp-spiess,9,0.00374,13262,5.51098,240647
273,PowerKiKi,9,0.00374,13271,5.51472,240647
274,rmartin-stratus,9,0.00374,13280,5.51846,240647
275,sevensees,9,0.00374,13289,5.52220,240647
276,suguru03,9,0.00374,13298,5.52594,240647
277,Suresh918,9,0.00374,13307,5.52968,240647
278,thlorenz,9,0.00374,13316,5.53342,240647
279,tommcdon,9,0.00374,13325,5.53716,240647
280,tylermcginnis,9,0.00374,13334,5.54090,240647
281,valery1707,9,0.00374,13343,5.54464,240647
282,zkat,9,0.00374,13352,5.54838,240647
283,ajcvickers,8,0.00332,13360,5.55170,240647
284,anenviousguest,8,0.00332,13368,5.55502,240647
285,beaugunderson,8,0.00332,13376,5.55835,240647
286,chris-smith-zocdoc,8,0.00332,13384,5.56167,240647
287,christophehurpeau,8,0.00332,13392,5.56500,240647
288,davidkaya,8,0.00332,13400,5.56832,240647
289,dominykas,8,0.00332,13408,5.57165,240647
290,Fank,8,0.00332,13416,5.57497,240647
291,gregersrygg,8,0.00332,13424,5.57830,240647
292,janvanhelvoort,8,0.00332,13432,5.58162,240647
293,jddxf,8,0.00332,13440,5.58494,240647
294,josepot,8,0.00332,13448,5.58827,240647
295,keertip,8,0.00332,13456,5.59159,240647
296,parjong,8,0.00332,13464,5.59492,240647
297,Raynos,8,0.00332,13472,5.59824,240647
298,rxaviers,8,0.00332,13480,5.60157,240647
299,sebkur,8,0.00332,13488,5.60489,240647
300,stefichjo,8,0.00332,13496,5.60821,240647
301,syranide,8,0.00332,13504,5.61154,240647
302,vvakame,8,0.00332,13512,5.61486,240647
303,12wrigja,7,0.00291,13519,5.61777,240647
304,a0viedo,7,0.00291,13526,5.62068,240647
305,DominikTrenz,7,0.00291,13533,5.62359,240647
306,dutchenkoOleg,7,0.00291,13540,5.62650,240647
307,ExE-Boss,7,0.00291,13547,5.62941,240647
308,hannob,7,0.00291,13554,5.63232,240647
309,Hibernate-CI,7,0.00291,13561,5.63523,240647
310,hubot,7,0.00291,13568,5.63813,240647
311,jedmao,7,0.00291,13575,5.64104,240647
312,jnordberg,7,0.00291,13582,5.64395,240647
313,JordyvanDortmont,7,0.00291,13589,5.64686,240647
314,Kerumen,7,0.00291,13596,5.64977,240647
315,laumair,7,0.00291,13603,5.65268,240647
316,madmir,7,0.00291,13610,5.65559,240647
317,max-b,7,0.00291,13617,5.65850,240647
318,mier85,7,0.00291,13624,5.66140,240647
319,mreinstein,7,0.00291,13631,5.66431,240647
320,nicketson,7,0.00291,13638,5.66722,240647
321,Noodle05,7,0.00291,13645,5.67013,240647
322,NthPortal,7,0.00291,13652,5.67304,240647
323,panchenko,7,0.00291,13659,5.67595,240647
324,pkaminski,7,0.00291,13666,5.67886,240647
325,rricard,7,0.00291,13673,5.68177,240647
326,saucecontrol,7,0.00291,13680,5.68468,240647
327,sergej2705,7,0.00291,13687,5.68758,240647
328,Sibiraj-Codes,7,0.00291,13694,5.69049,240647
329,steveluscher,7,0.00291,13701,5.69340,240647
330,vargaz,7,0.00291,13708,5.69631,240647
331,vjkoskela,7,0.00291,13715,5.69922,240647
332,ad-si,6,0.00249,13721,5.70171,240647
333,asbjornu,6,0.00249,13727,5.70421,240647
334,blackdwarf,6,0.00249,13733,5.70670,240647
335,boneskull,6,0.00249,13739,5.70919,240647
336,chenglou,6,0.00249,13745,5.71169,240647
337,chlins,6,0.00249,13751,5.71418,240647
338,Coeur,6,0.00249,13757,5.71667,240647
339,crandmck,6,0.00249,13763,5.71917,240647
340,ctavan,6,0.00249,13769,5.72166,240647
341,ekilah,6,0.00249,13775,5.72415,240647
342,erikkemperman,6,0.00249,13781,5.72665,240647
343,fiddur,6,0.00249,13787,5.72914,240647
344,focusaurus,6,0.00249,13793,5.73163,240647
345,Hongbo-Miao,6,0.00249,13799,5.73413,240647
346,hudochenkov,6,0.00249,13805,5.73662,240647
347,jaredly,6,0.00249,13811,5.73911,240647
348,jcouv,6,0.00249,13817,5.74160,240647
349,kytart,6,0.00249,13823,5.74410,240647
350,lukeapage,6,0.00249,13829,5.74659,240647
351,MaggieTsang,6,0.00249,13835,5.74908,240647
352,manishbansal8843,6,0.00249,13841,5.75158,240647
353,mattdesl,6,0.00249,13847,5.75407,240647
354,mckramer,6,0.00249,13853,5.75656,240647
355,mjomble,6,0.00249,13859,5.75906,240647
356,nali,6,0.00249,13865,5.76155,240647
357,nategraf,6,0.00249,13871,5.76404,240647
358,nateprewitt,6,0.00249,13877,5.76654,240647
359,ning-github,6,0.00249,13883,5.76903,240647
360,not-an-aardvark,6,0.00249,13889,5.77152,240647
361,obriensystems,6,0.00249,13895,5.77402,240647
362,oliversalzburg,6,0.00249,13901,5.77651,240647
363,panva,6,0.00249,13907,5.77900,240647
364,reggi,6,0.00249,13913,5.78150,240647
365,Richienb,6,0.00249,13919,5.78399,240647
366,rickhanlonii,6,0.00249,13925,5.78648,240647
367,roji,6,0.00249,13931,5.78898,240647
368,schen381,6,0.00249,13937,5.79147,240647
369,shiftylogic,6,0.00249,13943,5.79396,240647
370,snout-o,6,0.00249,13949,5.79646,240647
371,stevenyxu,6,0.00249,13955,5.79895,240647
372,TehShrike,6,0.00249,13961,5.80144,240647
373,viktorklang,6,0.00249,13967,5.80394,240647
374,yursha,6,0.00249,13973,5.80643,240647
375,ababkov,5,0.00208,13978,5.80851,240647
376,aickin,5,0.00208,13983,5.81059,240647
377,alanorth,5,0.00208,13988,5.81266,240647
378,alfaproject,5,0.00208,13993,5.81474,240647
379,amogilev,5,0.00208,13998,5.81682,240647
380,AndreasCag,5,0.00208,14003,5.81890,240647
381,andrleite,5,0.00208,14008,5.82097,240647
382,avindra,5,0.00208,14013,5.82305,240647
383,beeman,5,0.00208,14018,5.82513,240647
384,cburroughs,5,0.00208,14023,5.82721,240647
385,crosscompile,5,0.00208,14028,5.82929,240647
386,dantman,5,0.00208,14033,5.83136,240647
387,dschenkelman,5,0.00208,14038,5.83344,240647
388,DylanPiercey,5,0.00208,14043,5.83552,240647
389,elyobo,5,0.00208,14048,5.83760,240647
390,eps1lon,5,0.00208,14053,5.83967,240647
391,EtaiG,5,0.00208,14058,5.84175,240647
392,Eunix,5,0.00208,14063,5.84383,240647
393,fat,5,0.00208,14068,5.84591,240647
394,foolip,5,0.00208,14073,5.84798,240647
395,gillyb,5,0.00208,14078,5.85006,240647
396,iz4blue,5,0.00208,14083,5.85214,240647
397,jeffmo,5,0.00208,14088,5.85422,240647
398,jergason,5,0.00208,14093,5.85630,240647
399,jesselpalmer,5,0.00208,14098,5.85837,240647
400,jmezach,5,0.00208,14103,5.86045,240647
401,JoeCortopassi,5,0.00208,14108,5.86253,240647
402,keeratsingh,5,0.00208,14113,5.86461,240647
403,lextiz,5,0.00208,14118,5.86668,240647
404,LitoMore,5,0.00208,14123,5.86876,240647
405,lnfnunes,5,0.00208,14128,5.87084,240647
406,louy,5,0.00208,14133,5.87292,240647
407,maltefiala,5,0.00208,14138,5.87500,240647
408,manughub,5,0.00208,14143,5.87707,240647
409,markstos,5,0.00208,14148,5.87915,240647
410,michal-franc,5,0.00208,14153,5.88123,240647
411,middagj,5,0.00208,14158,5.88331,240647
412,mohsen1,5,0.00208,14163,5.88538,240647
413,monkeywithacupcake,5,0.00208,14168,5.88746,240647
414,Morishiri,5,0.00208,14173,5.88954,240647
415,nchikanov,5,0.00208,14178,5.89162,240647
416,nordligulv,5,0.00208,14183,5.89369,240647
417,ODAVING,5,0.00208,14188,5.89577,240647
418,ORESoftware,5,0.00208,14193,5.89785,240647
419,paulceli,5,0.00208,14198,5.89993,240647
420,peteretelej,5,0.00208,14203,5.90201,240647
421,pluma,5,0.00208,14208,5.90408,240647
422,pwolaq,5,0.00208,14213,5.90616,240647
423,repinel,5,0.00208,14218,5.90824,240647
424,RobJohnston,5,0.00208,14223,5.91032,240647
425,rosskevin,5,0.00208,14228,5.91239,240647
426,rschmitt,5,0.00208,14233,5.91447,240647
427,sbomer,5,0.00208,14238,5.91655,240647
428,sfuhrm,5,0.00208,14243,5.91863,240647
429,solomax,5,0.00208,14248,5.92071,240647
430,STRML,5,0.00208,14253,5.92278,240647
431,stroncium,5,0.00208,14258,5.92486,240647
432,TedSander,5,0.00208,14263,5.92694,240647
433,thefourtheye,5,0.00208,14268,5.92902,240647
434,tjcelaya,5,0.00208,14273,5.93109,240647
435,tjvantoll,5,0.00208,14278,5.93317,240647
436,tmurakam,5,0.00208,14283,5.93525,240647
437,tomByrer,5,0.00208,14288,5.93733,240647
438,WikiDiscoverer,5,0.00208,14293,5.93941,240647
439,yizhang82,5,0.00208,14298,5.94148,240647
440,ztsmith,5,0.00208,14303,5.94356,240647
441,2m,4,0.00166,14307,5.94522,240647
442,AdriVanHoudt,4,0.00166,14311,5.94688,240647
443,Airblader,4,0.00166,14315,5.94855,240647
444,alisianoi,4,0.00166,14319,5.95021,240647
445,alnikola,4,0.00166,14323,5.95187,240647
446,anatoliykmetyuk,4,0.00166,14327,5.95353,240647
447,AndersDJohnson,4,0.00166,14331,5.95520,240647
448,AndrusGerman,4,0.00166,14335,5.95686,240647
449,aorinevo,4,0.00166,14339,5.95852,240647
450,aroben,4,0.00166,14343,5.96018,240647
451,asnowwolf,4,0.00166,14347,5.96184,240647
452,audionerd,4,0.00166,14351,5.96351,240647
453,augusto-cdxs,4,0.00166,14355,5.96517,240647
454,b3vegan,4,0.00166,14359,5.96683,240647
455,barney2k7,4,0.00166,14363,5.96849,240647
456,beatgammit,4,0.00166,14367,5.97016,240647
457,benmosher,4,0.00166,14371,5.97182,240647
458,bfred-it,4,0.00166,14375,5.97348,240647
459,bmeck,4,0.00166,14379,5.97514,240647
460,boenrobot,4,0.00166,14383,5.97680,240647
461,brandon93s,4,0.00166,14387,5.97847,240647
462,cakofony,4,0.00166,14391,5.98013,240647
463,cbaker423,4,0.00166,14395,5.98179,240647
464,cheapsteak,4,0.00166,14399,5.98345,240647
465,chicoxyzzy,4,0.00166,14403,5.98512,240647
466,CompuIves,4,0.00166,14407,5.98678,240647
467,ctaggart,4,0.00166,14411,5.98844,240647
468,cyan33,4,0.00166,14415,5.99010,240647
469,david-proctor,4,0.00166,14419,5.99176,240647
470,delgurth,4,0.00166,14423,5.99343,240647
471,DenrizSusam,4,0.00166,14427,5.99509,240647
472,dickwall,4,0.00166,14431,5.99675,240647
473,dimitrisli,4,0.00166,14435,5.99841,240647
474,disjukr,4,0.00166,14439,6.00007,240647
475,donaldpipowitch,4,0.00166,14443,6.00174,240647
476,don-vip,4,0.00166,14447,6.00340,240647
477,dota17,4,0.00166,14451,6.00506,240647
478,ducminhn,4,0.00166,14455,6.00672,240647
479,eadamsintel,4,0.00166,14459,6.00839,240647
480,eed3si9n,4,0.00166,14463,6.01005,240647
481,eirslett,4,0.00166,14467,6.01171,240647
482,ElanHasson,4,0.00166,14471,6.01337,240647
483,ericnakagawa,4,0.00166,14475,6.01503,240647
484,erik-krogh,4,0.00166,14479,6.01670,240647
485,EsrefDurna,4,0.00166,14483,6.01836,240647
486,EvanCarroll,4,0.00166,14487,6.02002,240647
487,ExplodingCabbage,4,0.00166,14491,6.02168,240647
488,ffflorian,4,0.00166,14495,6.02335,240647
489,fidian,4,0.00166,14499,6.02501,240647
490,gajus,4,0.00166,14503,6.02667,240647
491,geekysrm,4,0.00166,14507,6.02833,240647
492,geoffbass,4,0.00166,14511,6.02999,240647
493,glenjamin,4,0.00166,14515,6.03166,240647
494,gnarf,4,0.00166,14519,6.03332,240647
495,gre,4,0.00166,14523,6.03498,240647
496,guptasourabh04,4,0.00166,14527,6.03664,240647
497,hildjj,4,0.00166,14531,6.03831,240647
498,horprogs,4,0.00166,14535,6.03997,240647
499,Hypnosphi,4,0.00166,14539,6.04163,240647
500,ianwalter,4,0.00166,14543,6.04329,240647
501,IljaDaderko,4,0.00166,14547,6.04495,240647
502,intellix,4,0.00166,14551,6.04662,240647
503,ioanacrant,4,0.00166,14555,6.04828,240647
504,jacklaurencegaray,4,0.00166,14559,6.04994,240647
505,jamestalmage,4,0.00166,14563,6.05160,240647
506,janpio,4,0.00166,14567,6.05326,240647
507,jaredpetersen,4,0.00166,14571,6.05493,240647
508,jayphelps,4,0.00166,14575,6.05659,240647
509,jeffomatic,4,0.00166,14579,6.05825,240647
510,jesstelford,4,0.00166,14583,6.05991,240647
511,jifeon,4,0.00166,14587,6.06158,240647
512,joelbraun,4,0.00166,14591,6.06324,240647
513,joshcanhelp,4,0.00166,14595,6.06490,240647
514,jugglinmike,4,0.00166,14599,6.06656,240647
515,justingrant,4,0.00166,14603,6.06822,240647
516,juthilo,4,0.00166,14607,6.06989,240647
517,kborchers,4,0.00166,14611,6.07155,240647
518,Laisky,4,0.00166,14615,6.07321,240647
519,lencioni,4,0.00166,14619,6.07487,240647
520,lipis,4,0.00166,14623,6.07654,240647
521,LukasDrgon,4,0.00166,14627,6.07820,240647
522,lyubomyr-shaydariv,4,0.00166,14631,6.07986,240647
523,markspolakovs,4,0.00166,14635,6.08152,240647
524,marvinhagemeister,4,0.00166,14639,6.08318,240647
525,mattbrundage,4,0.00166,14643,6.08485,240647
526,matthewjohnston4,4,0.00166,14647,6.08651,240647
527,mboudreau,4,0.00166,14651,6.08817,240647
528,mdedetrich,4,0.00166,14655,6.08983,240647
529,mfunkie,4,0.00166,14659,6.09150,240647
530,MidnightWonderer,4,0.00166,14663,6.09316,240647
531,mirabilos,4,0.00166,14667,6.09482,240647
532,monkpit,4,0.00166,14671,6.09648,240647
533,morenoh149,4,0.00166,14675,6.09814,240647
534,mortonfox,4,0.00166,14679,6.09981,240647
535,mrcoles,4,0.00166,14683,6.10147,240647
536,m-sp,4,0.00166,14687,6.10313,240647
537,natemcmaster,4,0.00166,14691,6.10479,240647
538,nowells,4,0.00166,14695,6.10645,240647
539,ntwb,4,0.00166,14699,6.10812,240647
540,OmicronPersei,4,0.00166,14703,6.10978,240647
541,omouse,4,0.00166,14707,6.11144,240647
542,oscar-stripe,4,0.00166,14711,6.11310,240647
543,OwnageIsMagic,4,0.00166,14715,6.11477,240647
544,perrin4869,4,0.00166,14719,6.11643,240647
545,poke,4,0.00166,14723,6.11809,240647
546,proth1,4,0.00166,14727,6.11975,240647
547,psachin,4,0.00166,14731,6.12141,240647
548,remal,4,0.00166,14735,6.12308,240647
549,rluba,4,0.00166,14739,6.12474,240647
550,rob-spoor,4,0.00166,14743,6.12640,240647
551,rtack,4,0.00166,14747,6.12806,240647
552,ruoho,4,0.00166,14751,6.12973,240647
553,selbekk,4,0.00166,14755,6.13139,240647
554,serima,4,0.00166,14759,6.13305,240647
555,shahata,4,0.00166,14763,6.13471,240647
556,simon04,4,0.00166,14767,6.13637,240647
557,StephenFluin,4,0.00166,14771,6.13804,240647
558,Stolr,4,0.00166,14775,6.13970,240647
559,taion,4,0.00166,14779,6.14136,240647
560,thekiba,4,0.00166,14783,6.14302,240647
561,tobiasschweizer,4,0.00166,14787,6.14468,240647
562,usmonster,4,0.00166,14791,6.14635,240647
563,verhas,4,0.00166,14795,6.14801,240647
564,wi-ski,4,0.00166,14799,6.14967,240647
565,wtgtybhertgeghgtwtg,4,0.00166,14803,6.15133,240647
566,xkxx,4,0.00166,14807,6.15300,240647
567,xt0rted,4,0.00166,14811,6.15466,240647
568,yasuf,4,0.00166,14815,6.15632,240647
569,ZDroid,4,0.00166,14819,6.15798,240647
570,Zenexer,4,0.00166,14823,6.15964,240647
571,zoechi,4,0.00166,14827,6.16131,240647
572,adrogon,3,0.00125,14830,6.16255,240647
573,ajaygm,3,0.00125,14833,6.16380,240647
574,aldermoovel,3,0.00125,14836,6.16505,240647
575,Alhadis,3,0.00125,14839,6.16629,240647
576,amitport,3,0.00125,14842,6.16754,240647
577,aquavitae,3,0.00125,14845,6.16879,240647
578,askpt,3,0.00125,14848,6.17003,240647
579,basarat,3,0.00125,14851,6.17128,240647
580,bcomnes,3,0.00125,14854,6.17253,240647
581,benjamn,3,0.00125,14857,6.17377,240647
582,BernhardRode,3,0.00125,14860,6.17502,240647
583,bhanuprasad14,3,0.00125,14863,6.17627,240647
584,BlockLabTV,3,0.00125,14866,6.17751,240647
585,bluelovers,3,0.00125,14869,6.17876,240647
586,bradlygreen,3,0.00125,14872,6.18001,240647
587,BrockBeaudry,3,0.00125,14875,6.18125,240647
588,Brooooooklyn,3,0.00125,14878,6.18250,240647
589,callumlocke,3,0.00125,14881,6.18375,240647
590,centromere,3,0.00125,14884,6.18499,240647
591,cmfcmf,3,0.00125,14887,6.18624,240647
592,cmilam87,3,0.00125,14890,6.18749,240647
593,colinmorelli,3,0.00125,14893,6.18873,240647
594,contextshuffling,3,0.00125,14896,6.18998,240647
595,craigdanj,3,0.00125,14899,6.19123,240647
596,dandv,3,0.00125,14902,6.19247,240647
597,danielhusar,3,0.00125,14905,6.19372,240647
598,DanielSeehausen,3,0.00125,14908,6.19497,240647
599,daveisfera,3,0.00125,14911,6.19621,240647
600,davidaurelio,3,0.00125,14914,6.19746,240647
601,dcherman,3,0.00125,14917,6.19871,240647
602,deinok,3,0.00125,14920,6.19995,240647
603,Deklin,3,0.00125,14923,6.20120,240647
604,denis-sokolov,3,0.00125,14926,6.20245,240647
605,dianjuar,3,0.00125,14929,6.20369,240647
606,dosentmatter,3,0.00125,14932,6.20494,240647
607,doughd,3,0.00125,14935,6.20619,240647
608,drcrallen,3,0.00125,14938,6.20743,240647
609,drumonii,3,0.00125,14941,6.20868,240647
610,dzuremar,3,0.00125,14944,6.20993,240647
611,eflorespalma,3,0.00125,14947,6.21117,240647
612,ehershey,3,0.00125,14950,6.21242,240647
613,eightnoneone,3,0.00125,14953,6.21367,240647
614,eriawan,3,0.00125,14956,6.21491,240647
615,farzonl,3,0.00125,14959,6.21616,240647
616,fatihafizoglu,3,0.00125,14962,6.21741,240647
617,ForJing,3,0.00125,14965,6.21865,240647
618,francoischalifour,3,0.00125,14968,6.21990,240647
619,gavlyukovskiy,3,0.00125,14971,6.22115,240647
620,govindrai,3,0.00125,14974,6.22239,240647
621,Gozala,3,0.00125,14977,6.22364,240647
622,greysteil,3,0.00125,14980,6.22489,240647
623,gswalden,3,0.00125,14983,6.22613,240647
624,hankduan,3,0.00125,14986,6.22738,240647
625,haraldreingruber,3,0.00125,14989,6.22863,240647
626,Hearen,3,0.00125,14992,6.22987,240647
627,hsingh23,3,0.00125,14995,6.23112,240647
628,hughsk,3,0.00125,14998,6.23237,240647
629,icambron,3,0.00125,15001,6.23361,240647
630,imsky,3,0.00125,15004,6.23486,240647
631,ionspin,3,0.00125,15007,6.23611,240647
632,isiahmeadows,3,0.00125,15010,6.23735,240647
633,JacoKoster,3,0.00125,15013,6.23860,240647
634,janekdb,3,0.00125,15016,6.23985,240647
635,jasnell,3,0.00125,15019,6.24109,240647
636,JBallin,3,0.00125,15022,6.24234,240647
637,JBtje,3,0.00125,15025,6.24359,240647
638,JobLeonard,3,0.00125,15028,6.24483,240647
639,joeledwards,3,0.00125,15031,6.24608,240647
640,JohnChen0,3,0.00125,15034,6.24732,240647
641,johnchen902,3,0.00125,15037,6.24857,240647
642,jokeyrhyme,3,0.00125,15040,6.24982,240647
643,jonbretman,3,0.00125,15043,6.25106,240647
644,JosephPecoraro,3,0.00125,15046,6.25231,240647
645,jsina,3,0.00125,15049,6.25356,240647
646,jtheoof,3,0.00125,15052,6.25480,240647
647,JunSun17,3,0.00125,15055,6.25605,240647
648,jure,3,0.00125,15058,6.25730,240647
649,jwalton,3,0.00125,15061,6.25854,240647
650,jwandrews,3,0.00125,15064,6.25979,240647
651,kevinashworth,3,0.00125,15067,6.26104,240647
652,KimBurgess,3,0.00125,15070,6.26228,240647
653,kingisaac95,3,0.00125,15073,6.26353,240647
654,kirill-usov,3,0.00125,15076,6.26478,240647
655,klieber,3,0.00125,15079,6.26602,240647
656,kmarinushkin,3,0.00125,15082,6.26727,240647
657,knowbody,3,0.00125,15085,6.26852,240647
658,kunagpal,3,0.00125,15088,6.26976,240647
659,lexjacobs,3,0.00125,15091,6.27101,240647
660,Lixire,3,0.00125,15094,6.27226,240647
661,lookfirst,3,0.00125,15097,6.27350,240647
662,lovasoa,3,0.00125,15100,6.27475,240647
663,lrsmith,3,0.00125,15103,6.27600,240647
664,lucasleelz,3,0.00125,15106,6.27724,240647
665,lysannef,3,0.00125,15109,6.27849,240647
666,m0mus,3,0.00125,15112,6.27974,240647
667,marclaval,3,0.00125,15115,6.28098,240647
668,markus1189,3,0.00125,15118,6.28223,240647
669,martine,3,0.00125,15121,6.28348,240647
670,mathieumg,3,0.00125,15124,6.28472,240647
671,m-burst,3,0.00125,15127,6.28597,240647
672,MeiKatz,3,0.00125,15130,6.28722,240647
673,melloc,3,0.00125,15133,6.28846,240647
674,MeyerNils,3,0.00125,15136,6.28971,240647
675,mikermcneil,3,0.00125,15139,6.29096,240647
676,mikkomaunu,3,0.00125,15142,6.29220,240647
677,misacorn,3,0.00125,15145,6.29345,240647
678,miyajan,3,0.00125,15148,6.29470,240647
679,mjhea0,3,0.00125,15151,6.29594,240647
680,mohd-akram,3,0.00125,15154,6.29719,240647
681,moorage,3,0.00125,15157,6.29844,240647
682,morriq,3,0.00125,15160,6.29968,240647
683,msmania,3,0.00125,15163,6.30093,240647
684,murphysean,3,0.00125,15166,6.30218,240647
685,nanjingboy,3,0.00125,15169,6.30342,240647
686,naturalwarren,3,0.00125,15172,6.30467,240647
687,Nicholaiii,3,0.00125,15175,6.30592,240647
688,nicojs,3,0.00125,15178,6.30716,240647
689,NightlyNexus,3,0.00125,15181,6.30841,240647
690,NiklasMerz,3,0.00125,15184,6.30966,240647
691,oGsLP,3,0.00125,15187,6.31090,240647
692,oliviertassinari,3,0.00125,15190,6.31215,240647
693,onovotny,3,0.00125,15193,6.31340,240647
694,onpaws,3,0.00125,15196,6.31464,240647
695,onstring,3,0.00125,15199,6.31589,240647
696,orischwartz,3,0.00125,15202,6.31714,240647
697,partheseas,3,0.00125,15205,6.31838,240647
698,pedrottimark,3,0.00125,15208,6.31963,240647
699,peterfuwork,3,0.00125,15211,6.32088,240647
700,petetnt,3,0.00125,15214,6.32212,240647
701,phapdinh,3,0.00125,15217,6.32337,240647
702,pieceofsummer,3,0.00125,15220,6.32462,240647
703,pjohnmeyer,3,0.00125,15223,6.32586,240647
704,pocesar,3,0.00125,15226,6.32711,240647
705,popey456963,3,0.00125,15229,6.32836,240647
706,rauchg,3,0.00125,15232,6.32960,240647
707,RByers,3,0.00125,15235,6.33085,240647
708,reduckted,3,0.00125,15238,6.33210,240647
709,reedloden,3,0.00125,15241,6.33334,240647
710,reiz,3,0.00125,15244,6.33459,240647
711,rharter,3,0.00125,15247,6.33584,240647
712,rhernandez35,3,0.00125,15250,6.33708,240647
713,RicardoVaranda,3,0.00125,15253,6.33833,240647
714,robstoll,3,0.00125,15256,6.33958,240647
715,rolodato,3,0.00125,15259,6.34082,240647
716,rriggin,3,0.00125,15262,6.34207,240647
717,rrthomas,3,0.00125,15265,6.34332,240647
718,rs017991,3,0.00125,15268,6.34456,240647
719,sahan91,3,0.00125,15271,6.34581,240647
720,sanex3339,3,0.00125,15274,6.34706,240647
721,santipalenque,3,0.00125,15277,6.34830,240647
722,sebdeckers,3,0.00125,15280,6.34955,240647
723,Sebmaster,3,0.00125,15283,6.35080,240647
724,sebnow,3,0.00125,15286,6.35204,240647
725,SensitiveMix,3,0.00125,15289,6.35329,240647
726,Shingyx,3,0.00125,15292,6.35454,240647
727,shrasool,3,0.00125,15295,6.35578,240647
728,silvenon,3,0.00125,15298,6.35703,240647
729,smoke,3,0.00125,15301,6.35828,240647
730,sobolevn,3,0.00125,15304,6.35952,240647
731,Spikhalskiy,3,0.00125,15307,6.36077,240647
732,stevezhu,3,0.00125,15310,6.36202,240647
733,styfle,3,0.00125,15313,6.36326,240647
734,tatsuyafw,3,0.00125,15316,6.36451,240647
735,TheRoSS,3,0.00125,15319,6.36576,240647
736,th-ko,3,0.00125,15322,6.36700,240647
737,tienpham94,3,0.00125,15325,6.36825,240647
738,tinchou,3,0.00125,15328,6.36950,240647
739,tnguyen14,3,0.00125,15331,6.37074,240647
740,tobegit3hub,3,0.00125,15334,6.37199,240647
741,tonylukasavage,3,0.00125,15337,6.37324,240647
742,TooTallNate,3,0.00125,15340,6.37448,240647
743,tracker1,3,0.00125,15343,6.37573,240647
744,trbngr,3,0.00125,15346,6.37698,240647
745,tstringer,3,0.00125,15349,6.37822,240647
746,ttowncompiled,3,0.00125,15352,6.37947,240647
747,Vadorequest,3,0.00125,15355,6.38072,240647
748,vlbee,3,0.00125,15358,6.38196,240647
749,wilgert,3,0.00125,15361,6.38321,240647
750,wmertens,3,0.00125,15364,6.38446,240647
751,yangmillstheory,3,0.00125,15367,6.38570,240647
752,yasirmhd,3,0.00125,15370,6.38695,240647
753,ymekuria,3,0.00125,15373,6.38820,240647
754,zjmiller,3,0.00125,15376,6.38944,240647
755,zzz40500,3,0.00125,15379,6.39069,240647
756,0xced,2,0.00083,15381,6.39152,240647
757,0xflotus,2,0.00083,15383,6.39235,240647
758,8398a7,2,0.00083,15385,6.39318,240647
759,aackerman,2,0.00083,15387,6.39401,240647
760,abalmos,2,0.00083,15389,6.39484,240647
761,adamretter,2,0.00083,15391,6.39567,240647
762,adamyi,2,0.00083,15393,6.39651,240647
763,adarrra,2,0.00083,15395,6.39734,240647
764,adekbadek,2,0.00083,15397,6.39817,240647
765,aelij,2,0.00083,15399,6.39900,240647
766,afitiskin,2,0.00083,15401,6.39983,240647
767,agray,2,0.00083,15403,6.40066,240647
768,aianus,2,0.00083,15405,6.40149,240647
769,ajcrowe,2,0.00083,15407,6.40232,240647
770,ajfranzoia,2,0.00083,15409,6.40315,240647
771,Alanscut,2,0.00083,15411,6.40399,240647
772,albanm,2,0.00083,15413,6.40482,240647
773,albertkang,2,0.00083,15415,6.40565,240647
774,alehander42,2,0.00083,15417,6.40648,240647
775,Aleksandyr,2,0.00083,15419,6.40731,240647
776,alexandrnikitin,2,0.00083,15421,6.40814,240647
777,alexkrolick,2,0.00083,15423,6.40897,240647
778,alfaslash,2,0.00083,15425,6.40980,240647
779,alFReD-NSH,2,0.00083,15427,6.41063,240647
780,ameyjadiye,2,0.00083,15429,6.41147,240647
781,amohamme,2,0.00083,15431,6.41230,240647
782,Anber,2,0.00083,15433,6.41313,240647
783,andreitroiebbc,2,0.00083,15435,6.41396,240647
784,andresroberto,2,0.00083,15437,6.41479,240647
785,angelo-v,2,0.00083,15439,6.41562,240647
786,anibalardid,2,0.00083,15441,6.41645,240647
787,anirudhramanan,2,0.00083,15443,6.41728,240647
788,anjoshigor,2,0.00083,15445,6.41811,240647
789,AntonLandor,2,0.00083,15447,6.41895,240647
790,arcana261,2,0.00083,15449,6.41978,240647
791,armiiller,2,0.00083,15451,6.42061,240647
792,arminsolecki,2,0.00083,15453,6.42144,240647
793,arpitpandey0209,2,0.00083,15455,6.42227,240647
794,artnez,2,0.00083,15457,6.42310,240647
795,aschlapsi,2,0.00083,15459,6.42393,240647
796,ashinzekene,2,0.00083,15461,6.42476,240647
797,atodorov,2,0.00083,15463,6.42559,240647
798,autopulated,2,0.00083,15465,6.42643,240647
799,azat,2,0.00083,15467,6.42726,240647
800,B3zo0,2,0.00083,15469,6.42809,240647
801,bahamas10,2,0.00083,15471,6.42892,240647
802,banli17,2,0.00083,15473,6.42975,240647
803,baopham,2,0.00083,15475,6.43058,240647
804,bascoder,2,0.00083,15477,6.43141,240647
805,bdougie,2,0.00083,15479,6.43224,240647
806,behrangsa,2,0.00083,15481,6.43307,240647
807,benatespina,2,0.00083,15483,6.43391,240647
808,bengadbois,2,0.00083,15485,6.43474,240647
809,benjaminp,2,0.00083,15487,6.43557,240647
810,billymoon,2,0.00083,15489,6.43640,240647
811,bjarneo,2,0.00083,15491,6.43723,240647
812,bkiselka,2,0.00083,15493,6.43806,240647
813,BlueHatbRit,2,0.00083,15495,6.43889,240647
814,bojand,2,0.00083,15497,6.43972,240647
815,bokub,2,0.00083,15499,6.44055,240647
816,brendo,2,0.00083,15501,6.44139,240647
817,brettdh,2,0.00083,15503,6.44222,240647
818,bripkens,2,0.00083,15505,6.44305,240647
819,brycebaril,2,0.00083,15507,6.44388,240647
820,bsingr,2,0.00083,15509,6.44471,240647
821,btelles,2,0.00083,15511,6.44554,240647
822,byronigoe,2,0.00083,15513,6.44637,240647
823,bzoz,2,0.00083,15515,6.44720,240647
824,calebboyd,2,0.00083,15517,6.44803,240647
825,CarstenWickner,2,0.00083,15519,6.44886,240647
826,cassianomon,2,0.00083,15521,6.44970,240647
827,cbdeveloper,2,0.00083,15523,6.45053,240647
828,chalup,2,0.00083,15525,6.45136,240647
829,chanakasan,2,0.00083,15527,6.45219,240647
830,charlierudolph,2,0.00083,15529,6.45302,240647
831,charsleysa,2,0.00083,15531,6.45385,240647
832,chrisdukakis,2,0.00083,15533,6.45468,240647
833,christophercurrie,2,0.00083,15535,6.45551,240647
834,cianclarke,2,0.00083,15537,6.45634,240647
835,cif,2,0.00083,15539,6.45718,240647
836,clamp03,2,0.00083,15541,6.45801,240647
837,cn007b,2,0.00083,15543,6.45884,240647
838,CodeMan99,2,0.00083,15545,6.45967,240647
839,CodyReichert,2,0.00083,15547,6.46050,240647
840,colesimmons,2,0.00083,15549,6.46133,240647
841,coleturner,2,0.00083,15551,6.46216,240647
842,colindickson,2,0.00083,15553,6.46299,240647
843,Coly010,2,0.00083,15555,6.46382,240647
844,coryhouse,2,0.00083,15557,6.46466,240647
845,cos,2,0.00083,15559,6.46549,240647
846,coxlinton,2,0.00083,15561,6.46632,240647
847,cpereida,2,0.00083,15563,6.46715,240647
848,crossjs,2,0.00083,15565,6.46798,240647
849,d2bit,2,0.00083,15567,6.46881,240647
850,danryan,2,0.00083,15569,6.46964,240647
851,danthegoodman,2,0.00083,15571,6.47047,240647
852,dariusk,2,0.00083,15573,6.47130,240647
853,DavidePastore,2,0.00083,15575,6.47214,240647
854,DavSanchez,2,0.00083,15577,6.47297,240647
855,DAXaholic,2,0.00083,15579,6.47380,240647
856,dblevins,2,0.00083,15581,6.47463,240647
857,ddunkin,2,0.00083,15583,6.47546,240647
858,delavara,2,0.00083,15585,6.47629,240647
859,delirius325,2,0.00083,15587,6.47712,240647
860,delitescere,2,0.00083,15589,6.47795,240647
861,dhurlburtusa,2,0.00083,15591,6.47878,240647
862,dlax,2,0.00083,15593,6.47962,240647
863,dmnd,2,0.00083,15595,6.48045,240647
864,dnalborczyk,2,0.00083,15597,6.48128,240647
865,domoritz,2,0.00083,15599,6.48211,240647
866,dot-asm,2,0.00083,15601,6.48294,240647
867,dotLou,2,0.00083,15603,6.48377,240647
868,douglasknudsen,2,0.00083,15605,6.48460,240647
869,DrPizza,2,0.00083,15607,6.48543,240647
870,dushmis,2,0.00083,15609,6.48626,240647
871,dwanderton,2,0.00083,15611,6.48710,240647
872,ecnepsnai,2,0.00083,15613,6.48793,240647
873,eddiemonge,2,0.00083,15615,6.48876,240647
874,ehmicky,2,0.00083,15617,6.48959,240647
875,Eisermann,2,0.00083,15619,6.49042,240647
876,ejpbruel,2,0.00083,15621,6.49125,240647
877,ekkis,2,0.00083,15623,6.49208,240647
878,elkdanger,2,0.00083,15625,6.49291,240647
879,eloytoro,2,0.00083,15627,6.49374,240647
880,emilio,2,0.00083,15629,6.49458,240647
881,EmilTholin,2,0.00083,15631,6.49541,240647
882,Errorname,2,0.00083,15633,6.49624,240647
883,eternalharvest,2,0.00083,15635,6.49707,240647
884,Ethan-Arrowood,2,0.00083,15637,6.49790,240647
885,evancarey,2,0.00083,15639,6.49873,240647
886,fatso83,2,0.00083,15641,6.49956,240647
887,felixyonex,2,0.00083,15643,6.50039,240647
888,fishbar,2,0.00083,15645,6.50122,240647
889,FlashSheridan,2,0.00083,15647,6.50205,240647
890,FokkeZB,2,0.00083,15649,6.50289,240647
891,fommil,2,0.00083,15651,6.50372,240647
892,fpoumian,2,0.00083,15653,6.50455,240647
893,francisdb,2,0.00083,15655,6.50538,240647
894,francois2metz,2,0.00083,15657,6.50621,240647
895,frehner,2,0.00083,15659,6.50704,240647
896,fridays,2,0.00083,15661,6.50787,240647
897,frostming,2,0.00083,15663,6.50870,240647
898,gengjiawen,2,0.00083,15665,6.50953,240647
899,ghuntley,2,0.00083,15667,6.51037,240647
900,gkwang,2,0.00083,15669,6.51120,240647
901,Glazy,2,0.00083,15671,6.51203,240647
902,goenning,2,0.00083,15673,6.51286,240647
903,gonzalez,2,0.00083,15675,6.51369,240647
904,gpspake,2,0.00083,15677,6.51452,240647
905,Grasseh,2,0.00083,15679,6.51535,240647
906,gregkalapos,2,0.00083,15681,6.51618,240647
907,grisha-kotler,2,0.00083,15683,6.51701,240647
908,guiguan,2,0.00083,15685,6.51785,240647
909,gupash,2,0.00083,15687,6.51868,240647
910,hans-kinnek,2,0.00083,15689,6.51951,240647
911,hbrotan,2,0.00083,15691,6.52034,240647
912,hemp,2,0.00083,15693,6.52117,240647
913,henderea,2,0.00083,15695,6.52200,240647
914,henryqdineen,2,0.00083,15697,6.52283,240647
915,himynameisdave,2,0.00083,15699,6.52366,240647
916,holyjak,2,0.00083,15701,6.52449,240647
917,humiaozuzu,2,0.00083,15703,6.52533,240647
918,hxsf,2,0.00083,15705,6.52616,240647
919,hzh,2,0.00083,15707,6.52699,240647
920,iamdoron,2,0.00083,15709,6.52782,240647
921,idlerboris,2,0.00083,15711,6.52865,240647
922,ieatfood,2,0.00083,15713,6.52948,240647
923,igorline,2,0.00083,15715,6.53031,240647
924,ilyasidorchik,2,0.00083,15717,6.53114,240647
925,indutny,2,0.00083,15719,6.53197,240647
926,istarkov,2,0.00083,15721,6.53281,240647
927,itchyny,2,0.00083,15723,6.53364,240647
928,jahraphael,2,0.00083,15725,6.53447,240647
929,JakeChampion,2,0.00083,15727,6.53530,240647
930,jakewins,2,0.00083,15729,6.53613,240647
931,james-callahan,2,0.00083,15731,6.53696,240647
932,jamesgpearce,2,0.00083,15733,6.53779,240647
933,Jamim,2,0.00083,15735,6.53862,240647
934,jamshedd,2,0.00083,15737,6.53945,240647
935,JandersonConstantino,2,0.00083,15739,6.54029,240647
936,jannic,2,0.00083,15741,6.54112,240647
937,jaswilli,2,0.00083,15743,6.54195,240647
938,javache,2,0.00083,15745,6.54278,240647
939,jbarnettwomply,2,0.00083,15747,6.54361,240647
940,jboavida,2,0.00083,15749,6.54444,240647
941,jchris,2,0.00083,15751,6.54527,240647
942,jcrben,2,0.00083,15753,6.54610,240647
943,jcspader,2,0.00083,15755,6.54693,240647
944,jd-carroll,2,0.00083,15757,6.54776,240647
945,jdelStrother,2,0.00083,15759,6.54860,240647
946,jdorfman,2,0.00083,15761,6.54943,240647
947,jdufresne,2,0.00083,15763,6.55026,240647
948,jedwards1211,2,0.00083,15765,6.55109,240647
949,jennifer-mann,2,0.00083,15767,6.55192,240647
950,jeremenichelli,2,0.00083,15769,6.55275,240647
951,jerome-nelson,2,0.00083,15771,6.55358,240647
952,jgalat,2,0.00083,15773,6.55441,240647
953,jhabdas,2,0.00083,15775,6.55524,240647
954,jimthedev,2,0.00083,15777,6.55608,240647
955,jisaacks,2,0.00083,15779,6.55691,240647
956,jmendeth,2,0.00083,15781,6.55774,240647
957,jniebuhr,2,0.00083,15783,6.55857,240647
958,joearasin,2,0.00083,15785,6.55940,240647
959,joej164,2,0.00083,15787,6.56023,240647
960,joel-leitch,2,0.00083,15789,6.56106,240647
961,joelongstreet,2,0.00083,15791,6.56189,240647
962,johnhampton,2,0.00083,15793,6.56272,240647
963,johnjohndoe,2,0.00083,15795,6.56356,240647
964,joliss,2,0.00083,15797,6.56439,240647
965,joongsoo,2,0.00083,15799,6.56522,240647
966,jordanstephens,2,0.00083,15801,6.56605,240647
967,joshalling,2,0.00083,15803,6.56688,240647
968,joshuawilson,2,0.00083,15805,6.56771,240647
969,joyzheng,2,0.00083,15807,6.56854,240647
970,jrevillas,2,0.00083,15809,6.56937,240647
971,juandiana,2,0.00083,15811,6.57020,240647
972,julio-lopez,2,0.00083,15813,6.57104,240647
973,julkwel,2,0.00083,15815,6.57187,240647
974,JustATrick,2,0.00083,15817,6.57270,240647
975,Jwan622,2,0.00083,15819,6.57353,240647
976,jwise,2,0.00083,15821,6.57436,240647
977,kambleaa007,2,0.00083,15823,6.57519,240647
978,kamranayub,2,0.00083,15825,6.57602,240647
979,karlhorky,2,0.00083,15827,6.57685,240647
980,keithamus,2,0.00083,15829,6.57768,240647
981,kevinSuttle,2,0.00083,15831,6.57852,240647
982,kindy,2,0.00083,15833,6.57935,240647
983,KirankumarAmbati,2,0.00083,15835,6.58018,240647
984,KodrAus,2,0.00083,15837,6.58101,240647
985,kor-k,2,0.00083,15839,6.58184,240647
986,kostasp,2,0.00083,15841,6.58267,240647
987,kpdecker,2,0.00083,15843,6.58350,240647
988,kpping,2,0.00083,15845,6.58433,240647
989,krusolu,2,0.00083,15847,6.58516,240647
990,lacolaco,2,0.00083,15849,6.58600,240647
991,larsgrefer,2,0.00083,15851,6.58683,240647
992,lazywithclass,2,0.00083,15853,6.58766,240647
993,lbalmaceda,2,0.00083,15855,6.58849,240647
994,LeSuisse,2,0.00083,15857,6.58932,240647
995,libHive,2,0.00083,15859,6.59015,240647
996,lidavidm,2,0.00083,15861,6.59098,240647
997,lifeiscontent,2,0.00083,15863,6.59181,240647
998,liff,2,0.00083,15865,6.59264,240647
999,light24bulbs,2,0.00083,15867,6.59348,240647
1000,listton,2,0.00083,15869,6.59431,240647
1001,lostintangent,2,0.00083,15871,6.59514,240647
1002,lox,2,0.00083,15873,6.59597,240647
1003,luigiberrettini,2,0.00083,15875,6.59680,240647
1004,lukehorvat,2,0.00083,15877,6.59763,240647
1005,lukewestby,2,0.00083,15879,6.59846,240647
1006,lvinniel,2,0.00083,15881,6.59929,240647
1007,magnificode,2,0.00083,15883,6.60012,240647
1008,maleetz,2,0.00083,15885,6.60095,240647
1009,marcospassos,2,0.00083,15887,6.60179,240647
1010,marionebl,2,0.00083,15889,6.60262,240647
1011,markgardner,2,0.00083,15891,6.60345,240647
1012,MarkHerhold,2,0.00083,15893,6.60428,240647
1013,MarshallOfSound,2,0.00083,15895,6.60511,240647
1014,martinmcwhorter,2,0.00083,15897,6.60594,240647
1015,mastermatt,2,0.00083,15899,6.60677,240647
1016,matteofigus,2,0.00083,15901,6.60760,240647
1017,MatthewHerbst,2,0.00083,15903,6.60843,240647
1018,MatthiasKunnen,2,0.00083,15905,6.60927,240647
1019,mattjanssen,2,0.00083,15907,6.61010,240647
1020,mattpolzin,2,0.00083,15909,6.61093,240647
1021,mdlavin,2,0.00083,15911,6.61176,240647
1022,mechpen,2,0.00083,15913,6.61259,240647
1023,megastef,2,0.00083,15915,6.61342,240647
1024,meirotstein,2,0.00083,15917,6.61425,240647
1025,mfitz3,2,0.00083,15919,6.61508,240647
1026,mgolovatiy-atconsulting-ru,2,0.00083,15921,6.61591,240647
1027,miguelmota,2,0.00083,15923,6.61675,240647
1028,mihbor,2,0.00083,15925,6.61758,240647
1029,mikea,2,0.00083,15927,6.61841,240647
1030,MikeRalphson,2,0.00083,15929,6.61924,240647
1031,mirague,2,0.00083,15931,6.62007,240647
1032,Morhaus,2,0.00083,15933,6.62090,240647
1033,Mottie,2,0.00083,15935,6.62173,240647
1034,mpfj,2,0.00083,15937,6.62256,240647
1035,mplonka,2,0.00083,15939,6.62339,240647
1036,mrjfox,2,0.00083,15941,6.62423,240647
1037,mtsmfm,2,0.00083,15943,6.62506,240647
1038,murbar,2,0.00083,15945,6.62589,240647
1039,mweibel,2,0.00083,15947,6.62672,240647
1040,MylesBorins,2,0.00083,15949,6.62755,240647
1041,Nadia--,2,0.00083,15951,6.62838,240647
1042,nahuel,2,0.00083,15953,6.62921,240647
1043,nanomosfet,2,0.00083,15955,6.63004,240647
1044,navaati,2,0.00083,15957,6.63087,240647
1045,nazieb,2,0.00083,15959,6.63171,240647
1046,nbali,2,0.00083,15961,6.63254,240647
1047,necinc,2,0.00083,15963,6.63337,240647
1048,nedbat,2,0.00083,15965,6.63420,240647
1049,negezor,2,0.00083,15967,6.63503,240647
1050,ngg,2,0.00083,15969,6.63586,240647
1051,nhodges,2,0.00083,15971,6.63669,240647
1052,NickPresta,2,0.00083,15973,6.63752,240647
1053,nimaa77,2,0.00083,15975,6.63835,240647
1054,nowke,2,0.00083,15977,6.63919,240647
1055,nstdio,2,0.00083,15979,6.64002,240647
1056,ntkme,2,0.00083,15981,6.64085,240647
1057,ntotten,2,0.00083,15983,6.64168,240647
1058,ObsidianMinor,2,0.00083,15985,6.64251,240647
1059,odykyi,2,0.00083,15987,6.64334,240647
1060,Om4ar,2,0.00083,15989,6.64417,240647
1061,oncletom,2,0.00083,15991,6.64500,240647
1062,ooflorent,2,0.00083,15993,6.64583,240647
1063,orgads,2,0.00083,15995,6.64667,240647
1064,OzzieOrca,2,0.00083,15997,6.64750,240647
1065,pablonete,2,0.00083,15999,6.64833,240647
1066,pahdo,2,0.00083,16001,6.64916,240647
1067,palanik,2,0.00083,16003,6.64999,240647
1068,paniko0,2,0.00083,16005,6.65082,240647
1069,papandreou,2,0.00083,16007,6.65165,240647
1070,pascalim,2,0.00083,16009,6.65248,240647
1071,paulferaud,2,0.00083,16011,6.65331,240647
1072,pbi-qfs,2,0.00083,16013,6.65414,240647
1073,penx,2,0.00083,16015,6.65498,240647
1074,petercm,2,0.00083,16017,6.65581,240647
1075,peterpoe,2,0.00083,16019,6.65664,240647
1076,pithu,2,0.00083,16021,6.65747,240647
1077,PixnBits,2,0.00083,16023,6.65830,240647
1078,pleunv,2,0.00083,16025,6.65913,240647
1079,poizan42,2,0.00083,16027,6.65996,240647
1080,popomore,2,0.00083,16029,6.66079,240647
1081,portgasd666,2,0.00083,16031,6.66162,240647
1082,PoziWorld,2,0.00083,16033,6.66246,240647
1083,pselden,2,0.00083,16035,6.66329,240647
1084,Psidium,2,0.00083,16037,6.66412,240647
1085,ptoonen,2,0.00083,16039,6.66495,240647
1086,quocvu,2,0.00083,16041,6.66578,240647
1087,ravefalcon92,2,0.00083,16043,6.66661,240647
1088,raveslave,2,0.00083,16045,6.66744,240647
1089,raybooysen,2,0.00083,16047,6.66827,240647
1090,rbdrenn,2,0.00083,16049,6.66910,240647
1091,rf,2,0.00083,16051,6.66994,240647
1092,rfkm,2,0.00083,16053,6.67077,240647
1093,rgansevles,2,0.00083,16055,6.67160,240647
1094,ricardohbin,2,0.00083,16057,6.67243,240647
1095,RichardBradley,2,0.00083,16059,6.67326,240647
1096,risseraka,2,0.00083,16061,6.67409,240647
1097,rkmlai,2,0.00083,16063,6.67492,240647
1098,rnglnd,2,0.00083,16065,6.67575,240647
1099,Rohitkrops,2,0.00083,16067,6.67658,240647
1100,ronnyroeller,2,0.00083,16069,6.67742,240647
1101,rootulp,2,0.00083,16071,6.67825,240647
1102,RpprRoger,2,0.00083,16073,6.67908,240647
1103,rrrene,2,0.00083,16075,6.67991,240647
1104,rwoodnz,2,0.00083,16077,6.68074,240647
1105,ryanmeador,2,0.00083,16079,6.68157,240647
1106,SadPandaBear,2,0.00083,16081,6.68240,240647
1107,Sakarisson,2,0.00083,16083,6.68323,240647
1108,salier,2,0.00083,16085,6.68406,240647
1109,sandynomad,2,0.00083,16087,6.68490,240647
1110,sassanh,2,0.00083,16089,6.68573,240647
1111,sassquad,2,0.00083,16091,6.68656,240647
1112,saxicek,2,0.00083,16093,6.68739,240647
1113,scheglov,2,0.00083,16095,6.68822,240647
1114,schwigri,2,0.00083,16097,6.68905,240647
1115,seanbright,2,0.00083,16099,6.68988,240647
1116,Sebring,2,0.00083,16101,6.69071,240647
1117,sereysethy,2,0.00083,16103,6.69154,240647
1118,sgbrown,2,0.00083,16105,6.69238,240647
1119,shivijais,2,0.00083,16107,6.69321,240647
1120,shortspider,2,0.00083,16109,6.69404,240647
1121,Siilwyn,2,0.00083,16111,6.69487,240647
1122,simlu,2,0.00083,16113,6.69570,240647
1123,simoneb,2,0.00083,16115,6.69653,240647
1124,skryvets,2,0.00083,16117,6.69736,240647
1125,slavede,2,0.00083,16119,6.69819,240647
1126,SlexAxton,2,0.00083,16121,6.69902,240647
1127,smashercosmo,2,0.00083,16123,6.69985,240647
1128,smbape,2,0.00083,16125,6.70069,240647
1129,smusali,2,0.00083,16127,6.70152,240647
1130,snow01,2,0.00083,16129,6.70235,240647
1131,som-snytt,2,0.00083,16131,6.70318,240647
1132,sonewman,2,0.00083,16133,6.70401,240647
1133,sonnemaf,2,0.00083,16135,6.70484,240647
1134,sorohan,2,0.00083,16137,6.70567,240647
1135,Sp1l,2,0.00083,16139,6.70650,240647
1136,stephan-tolksdorf,2,0.00083,16141,6.70733,240647
1137,stucox,2,0.00083,16143,6.70817,240647
1138,surajwy,2,0.00083,16145,6.70900,240647
1139,susisu,2,0.00083,16147,6.70983,240647
1140,syllant,2,0.00083,16149,6.71066,240647
1141,tardyp,2,0.00083,16151,6.71149,240647
1142,taylorc93,2,0.00083,16153,6.71232,240647
1143,tdurtschi,2,0.00083,16155,6.71315,240647
1144,tedpennings,2,0.00083,16157,6.71398,240647
1145,telmen,2,0.00083,16159,6.71481,240647
1146,tenjaa,2,0.00083,16161,6.71565,240647
1147,tenwit,2,0.00083,16163,6.71648,240647
1148,theel0ja,2,0.00083,16165,6.71731,240647
1149,theogravity,2,0.00083,16167,6.71814,240647
1150,TheTalisman,2,0.00083,16169,6.71897,240647
1151,TheToolbox,2,0.00083,16171,6.71980,240647
1152,thiagoarrais,2,0.00083,16173,6.72063,240647
1153,timlevett,2,0.00083,16175,6.72146,240647
1154,TinyMan,2,0.00083,16177,6.72229,240647
1155,tjsail33,2,0.00083,16179,6.72313,240647
1156,tlhunter,2,0.00083,16181,6.72396,240647
1157,todd,2,0.00083,16183,6.72479,240647
1158,todesking,2,0.00083,16185,6.72562,240647
1159,tom-sherman,2,0.00083,16187,6.72645,240647
1160,trentm,2,0.00083,16189,6.72728,240647
1161,treymack,2,0.00083,16191,6.72811,240647
1162,tridium,2,0.00083,16193,6.72894,240647
1163,TSMMark,2,0.00083,16195,6.72977,240647
1164,Tvrqvoise,2,0.00083,16197,6.73061,240647
1165,TylerBrock,2,0.00083,16199,6.73144,240647
1166,tylerwhall,2,0.00083,16201,6.73227,240647
1167,uhaciogullari,2,0.00083,16203,6.73310,240647
1168,unional,2,0.00083,16205,6.73393,240647
1169,vadimdemedes,2,0.00083,16207,6.73476,240647
1170,vanillajonathan,2,0.00083,16209,6.73559,240647
1171,vasiliyb,2,0.00083,16211,6.73642,240647
1172,vbraun,2,0.00083,16213,6.73725,240647
1173,vcsjones,2,0.00083,16215,6.73809,240647
1174,vdukhovni,2,0.00083,16217,6.73892,240647
1175,vergenzt,2,0.00083,16219,6.73975,240647
1176,vgoma,2,0.00083,16221,6.74058,240647
1177,vivmishra,2,0.00083,16223,6.74141,240647
1178,vkarpov15,2,0.00083,16225,6.74224,240647
1179,VladShcherbin,2,0.00083,16227,6.74307,240647
1180,voxpelli,2,0.00083,16229,6.74390,240647
1181,vvo,2,0.00083,16231,6.74473,240647
1182,wayou,2,0.00083,16233,6.74557,240647
1183,Widdershin,2,0.00083,16235,6.74640,240647
1184,willnorris,2,0.00083,16237,6.74723,240647
1185,wnvko,2,0.00083,16239,6.74806,240647
1186,woollybogger,2,0.00083,16241,6.74889,240647
1187,wotbstars,2,0.00083,16243,6.74972,240647
1188,wraithgar,2,0.00083,16245,6.75055,240647
1189,xenoterracide,2,0.00083,16247,6.75138,240647
1190,yausername,2,0.00083,16249,6.75221,240647
1191,Yaxian,2,0.00083,16251,6.75304,240647
1192,ycmjason,2,0.00083,16253,6.75388,240647
1193,Youmoo,2,0.00083,16255,6.75471,240647
1194,Youssef1313,2,0.00083,16257,6.75554,240647
1195,zackseuberling,2,0.00083,16259,6.75637,240647
1196,zenglian,2,0.00083,16261,6.75720,240647
1197,zhenlan,2,0.00083,16263,6.75803,240647
1198,zzz6519003,2,0.00083,16265,6.75886,240647
1199,0x1mason,1,0.00042,16266,6.75928,240647
1200,0x326,1,0.00042,16267,6.75969,240647
1201,0xbaadf00d,1,0.00042,16268,6.76011,240647
1202,1071496910,1,0.00042,16269,6.76052,240647
1203,3flex,1,0.00042,16270,6.76094,240647
1204,4leem,1,0.00042,16271,6.76136,240647
1205,aakash2602,1,0.00042,16272,6.76177,240647
1206,aakoch,1,0.00042,16273,6.76219,240647
1207,aaronang,1,0.00042,16274,6.76260,240647
1208,AaronFriel,1,0.00042,16275,6.76302,240647
1209,Aboisier,1,0.00042,16276,6.76343,240647
1210,abraham,1,0.00042,16277,6.76385,240647
1211,acjay,1,0.00042,16278,6.76426,240647
1212,acroca,1,0.00042,16279,6.76468,240647
1213,adamgruber,1,0.00042,16280,6.76510,240647
1214,adamreeve,1,0.00042,16281,6.76551,240647
1215,adamvoss,1,0.00042,16282,6.76593,240647
1216,adelevie,1,0.00042,16283,6.76634,240647
1217,adeolabadmus,1,0.00042,16284,6.76676,240647
1218,admosity,1,0.00042,16285,6.76717,240647
1219,adwiii,1,0.00042,16286,6.76759,240647
1220,aeschright,1,0.00042,16287,6.76800,240647
1221,afeld,1,0.00042,16288,6.76842,240647
1222,AgentME,1,0.00042,16289,6.76884,240647
1223,aguynamedben,1,0.00042,16290,6.76925,240647
1224,ahmdsolmn,1,0.00042,16291,6.76967,240647
1225,ahmedsoliman92,1,0.00042,16292,6.77008,240647
1226,aifodu,1,0.00042,16293,6.77050,240647
1227,aigdonia,1,0.00042,16294,6.77091,240647
1228,akd-io,1,0.00042,16295,6.77133,240647
1229,akvamalin,1,0.00042,16296,6.77174,240647
1230,alansouzati,1,0.00042,16297,6.77216,240647
1231,alexandercerutti,1,0.00042,16298,6.77258,240647
1232,alexbokii,1,0.00042,16299,6.77299,240647
1233,alexilyaev,1,0.00042,16300,6.77341,240647
1234,alexmckenley,1,0.00042,16301,6.77382,240647
1235,alirezaafkar,1,0.00042,16302,6.77424,240647
1236,alopezsanchez,1,0.00042,16303,6.77465,240647
1237,alundiak,1,0.00042,16304,6.77507,240647
1238,amcdnl,1,0.00042,16305,6.77548,240647
1239,amiller-gh,1,0.00042,16306,6.77590,240647
1240,AMoreaux,1,0.00042,16307,6.77632,240647
1241,anchnk,1,0.00042,16308,6.77673,240647
1242,andrebsguedes,1,0.00042,16309,6.77715,240647
1243,AndreiRailean,1,0.00042,16310,6.77756,240647
1244,andrew,1,0.00042,16311,6.77798,240647
1245,AndrewKvalheim,1,0.00042,16312,6.77839,240647
1246,andrewnester,1,0.00042,16313,6.77881,240647
1247,andreybleme,1,0.00042,16314,6.77922,240647
1248,andriisoldatenko,1,0.00042,16315,6.77964,240647
1249,andyfeller,1,0.00042,16316,6.78006,240647
1250,andymc12,1,0.00042,16317,6.78047,240647
1251,angadgill92,1,0.00042,16318,6.78089,240647
1252,Anomen,1,0.00042,16319,6.78130,240647
1253,anotherpit,1,0.00042,16320,6.78172,240647
1254,anslzo,1,0.00042,16321,6.78213,240647
1255,antons,1,0.00042,16322,6.78255,240647
1256,anubhav25gupta,1,0.00042,16323,6.78296,240647
1257,anurse,1,0.00042,16324,6.78338,240647
1258,apirom9,1,0.00042,16325,6.78380,240647
1259,aplsek,1,0.00042,16326,6.78421,240647
1260,apsknight,1,0.00042,16327,6.78463,240647
1261,arahansen,1,0.00042,16328,6.78504,240647
1262,araslanov,1,0.00042,16329,6.78546,240647
1263,Arhell,1,0.00042,16330,6.78587,240647
1264,aroget,1,0.00042,16331,6.78629,240647
1265,arosh,1,0.00042,16332,6.78670,240647
1266,arouel,1,0.00042,16333,6.78712,240647
1267,arthurvr,1,0.00042,16334,6.78754,240647
1268,ArtsiomCh,1,0.00042,16335,6.78795,240647
1269,artywhite,1,0.00042,16336,6.78837,240647
1270,ashishpatelcs,1,0.00042,16337,6.78878,240647
1271,Asthetic,1,0.00042,16338,6.78920,240647
1272,AstraSerg,1,0.00042,16339,6.78961,240647
1273,atifaziz,1,0.00042,16340,6.79003,240647
1274,A-Tokyo,1,0.00042,16341,6.79044,240647
1275,atom-morgan,1,0.00042,16342,6.79086,240647
1276,attilah,1,0.00042,16343,6.79128,240647
1277,autowp,1,0.00042,16344,6.79169,240647
1278,avnersorek,1,0.00042,16345,6.79211,240647
1279,AVVS,1,0.00042,16346,6.79252,240647
1280,awiddersheim,1,0.00042,16347,6.79294,240647
1281,awlayton,1,0.00042,16348,6.79335,240647
1282,aymericbouzy,1,0.00042,16349,6.79377,240647
1283,Azert-Mark,1,0.00042,16350,6.79418,240647
1284,azhao12345,1,0.00042,16351,6.79460,240647
1285,baboquivari,1,0.00042,16352,6.79502,240647
1286,bakape,1,0.00042,16353,6.79543,240647
1287,bakorer,1,0.00042,16354,6.79585,240647
1288,balduncle,1,0.00042,16355,6.79626,240647
1289,bargemb,1,0.00042,16356,6.79668,240647
1290,baronswindle,1,0.00042,16357,6.79709,240647
1291,barrymichaeldoyle,1,0.00042,16358,6.79751,240647
1292,Baschdl,1,0.00042,16359,6.79792,240647
1293,bbodenmiller,1,0.00042,16360,6.79834,240647
1294,bdmason,1,0.00042,16361,6.79876,240647
1295,belugabehr,1,0.00042,16362,6.79917,240647
1296,benjaminhoffman,1,0.00042,16363,6.79959,240647
1297,ben-manes,1,0.00042,16364,6.80000,240647
1298,bernard-leech,1,0.00042,16365,6.80042,240647
1299,bgw,1,0.00042,16366,6.80083,240647
1300,BigAB,1,0.00042,16367,6.80125,240647
1301,bisguzar,1,0.00042,16368,6.80166,240647
1302,blainesch,1,0.00042,16369,6.80208,240647
1303,blair,1,0.00042,16370,6.80249,240647
1304,Blaisorblade,1,0.00042,16371,6.80291,240647
1305,BloodShura,1,0.00042,16372,6.80333,240647
1306,bnb,1,0.00042,16373,6.80374,240647
1307,bnorm,1,0.00042,16374,6.80416,240647
1308,bodgit,1,0.00042,16375,6.80457,240647
1309,BoLaMN,1,0.00042,16376,6.80499,240647
1310,bontibon,1,0.00042,16377,6.80540,240647
1311,BookOfGreg,1,0.00042,16378,6.80582,240647
1312,BorodinDK,1,0.00042,16379,6.80623,240647
1313,botaberg,1,0.00042,16380,6.80665,240647
1314,bpetex,1,0.00042,16381,6.80707,240647
1315,bploetz,1,0.00042,16382,6.80748,240647
1316,brandon-pereira,1,0.00042,16383,6.80790,240647
1317,brismuth,1,0.00042,16384,6.80831,240647
1318,brodybits,1,0.00042,16385,6.80873,240647
1319,bryanar,1,0.00042,16386,6.80914,240647
1320,btd,1,0.00042,16387,6.80956,240647
1321,buerkle,1,0.00042,16388,6.80997,240647
1322,bugknightyyp,1,0.00042,16389,6.81039,240647
1323,bugtype,1,0.00042,16390,6.81081,240647
1324,byr-gdp,1,0.00042,16391,6.81122,240647
1325,C45tr0,1,0.00042,16392,6.81164,240647
1326,capaj,1,0.00042,16393,6.81205,240647
1327,Caravus,1,0.00042,16394,6.81247,240647
1328,cardamon,1,0.00042,16395,6.81288,240647
1329,carkod,1,0.00042,16396,6.81330,240647
1330,carolinacmoravia,1,0.00042,16397,6.81371,240647
1331,carterkozak,1,0.00042,16398,6.81413,240647
1332,caub,1,0.00042,16399,6.81455,240647
1333,cb372,1,0.00042,16400,6.81496,240647
1334,cbrianso,1,0.00042,16401,6.81538,240647
1335,cconroy,1,0.00042,16402,6.81579,240647
1336,cemeyer,1,0.00042,16403,6.81621,240647
1337,ceph3us,1,0.00042,16404,6.81662,240647
1338,cesarbs,1,0.00042,16405,6.81704,240647
1339,c-geek,1,0.00042,16406,6.81745,240647
1340,ChaitanyaPramod,1,0.00042,16407,6.81787,240647
1341,chaseadamsio,1,0.00042,16408,6.81829,240647
1342,chengkungui,1,0.00042,16409,6.81870,240647
1343,chengluyu,1,0.00042,16410,6.81912,240647
1344,chienkira,1,0.00042,16411,6.81953,240647
1345,chinhodado,1,0.00042,16412,6.81995,240647
1346,chmelevskij,1,0.00042,16413,6.82036,240647
1347,chris13524,1,0.00042,16414,6.82078,240647
1348,chrisalbrecht,1,0.00042,16415,6.82119,240647
1349,chrisbolin,1,0.00042,16416,6.82161,240647
1350,chriscartlidge,1,0.00042,16417,6.82203,240647
1351,chrisgavin,1,0.00042,16418,6.82244,240647
1352,chrisprice,1,0.00042,16419,6.82286,240647
1353,chrisrpatterson,1,0.00042,16420,6.82327,240647
1354,ChristianSchwarz,1,0.00042,16421,6.82369,240647
1355,ChristopherDavenport,1,0.00042,16422,6.82410,240647
1356,chtseac,1,0.00042,16423,6.82452,240647
1357,chulkilee,1,0.00042,16424,6.82493,240647
1358,ciceropablo,1,0.00042,16425,6.82535,240647
1359,cjpillsbury,1,0.00042,16426,6.82577,240647
1360,ckuhn,1,0.00042,16427,6.82618,240647
1361,claylo,1,0.00042,16428,6.82660,240647
1362,cleitonmendonca,1,0.00042,16429,6.82701,240647
1363,cloojure,1,0.00042,16430,6.82743,240647
1364,cmatheson,1,0.00042,16431,6.82784,240647
1365,codef0rmer,1,0.00042,16432,6.82826,240647
1366,coderbyheart,1,0.00042,16433,6.82867,240647
1367,codingsince1985,1,0.00042,16434,6.82909,240647
1368,codyj110,1,0.00042,16435,6.82951,240647
1369,colltoaction,1,0.00042,16436,6.82992,240647
1370,compulim,1,0.00042,16437,6.83034,240647
1371,conartist6,1,0.00042,16438,6.83075,240647
1372,ConnorMcF,1,0.00042,16439,6.83117,240647
1373,ConradIrwin,1,0.00042,16440,6.83158,240647
1374,CoolCoderTony,1,0.00042,16441,6.83200,240647
1375,coreh,1,0.00042,16442,6.83241,240647
1376,coryasilva,1,0.00042,16443,6.83283,240647
1377,cowwoc,1,0.00042,16444,6.83325,240647
1378,cpillsbury,1,0.00042,16445,6.83366,240647
1379,cravler,1,0.00042,16446,6.83408,240647
1380,CRC-Mismatch,1,0.00042,16447,6.83449,240647
1381,crhistianramirez,1,0.00042,16448,6.83491,240647
1382,csimplestring,1,0.00042,16449,6.83532,240647
1383,Cslove,1,0.00042,16450,6.83574,240647
1384,CWSpear,1,0.00042,16451,6.83615,240647
1385,daevidpreis,1,0.00042,16452,6.83657,240647
1386,dahim2006,1,0.00042,16453,6.83699,240647
1387,daniel347x,1,0.00042,16454,6.83740,240647
1388,danielmachado,1,0.00042,16455,6.83782,240647
1389,danielpowell4,1,0.00042,16456,6.83823,240647
1390,das-peter,1,0.00042,16457,6.83865,240647
1391,davidfurlong,1,0.00042,16458,6.83906,240647
1392,DavidHe1127,1,0.00042,16459,6.83948,240647
1393,davidpatrick,1,0.00042,16460,6.83989,240647
1394,DavidTPate,1,0.00042,16461,6.84031,240647
1395,davlloyd,1,0.00042,16462,6.84073,240647
1396,dbkr,1,0.00042,16463,6.84114,240647
1397,dbrugne,1,0.00042,16464,6.84156,240647
1398,dcworldwide,1,0.00042,16465,6.84197,240647
1399,DDRBoxman,1,0.00042,16466,6.84239,240647
1400,debajitr,1,0.00042,16467,6.84280,240647
1401,debudda,1,0.00042,16468,6.84322,240647
1402,deepakpathania,1,0.00042,16469,6.84363,240647
1403,demoneaux,1,0.00042,16470,6.84405,240647
1404,den314,1,0.00042,16471,6.84447,240647
1405,devonharvey,1,0.00042,16472,6.84488,240647
1406,deyboy90,1,0.00042,16473,6.84530,240647
1407,dgrcode,1,0.00042,16474,6.84571,240647
1408,diamondo25,1,0.00042,16475,6.84613,240647
1409,dimas,1,0.00042,16476,6.84654,240647
1410,divjotsinghnanda,1,0.00042,16477,6.84696,240647
1411,djchie,1,0.00042,16478,6.84737,240647
1412,djulien,1,0.00042,16479,6.84779,240647
1413,dlazerka,1,0.00042,16480,6.84821,240647
1414,dmap,1,0.00042,16481,6.84862,240647
1415,dmin,1,0.00042,16482,6.84904,240647
1416,domenic,1,0.00042,16483,6.84945,240647
1417,dominicbarnes,1,0.00042,16484,6.84987,240647
1418,donroyco,1,0.00042,16485,6.85028,240647
1419,dotchev,1,0.00042,16486,6.85070,240647
1420,dperezde,1,0.00042,16487,6.85111,240647
1421,dprotaso,1,0.00042,16488,6.85153,240647
1422,drajakumar,1,0.00042,16489,6.85194,240647
1423,drcapulet,1,0.00042,16490,6.85236,240647
1424,DreaminginCodeZH,1,0.00042,16491,6.85278,240647
1425,drew-moore,1,0.00042,16492,6.85319,240647
1426,drichard,1,0.00042,16493,6.85361,240647
1427,driverpt,1,0.00042,16494,6.85402,240647
1428,ds300,1,0.00042,16495,6.85444,240647
1429,dtgoitia,1,0.00042,16496,6.85485,240647
1430,dtothefp,1,0.00042,16497,6.85527,240647
1431,dtslvr,1,0.00042,16498,6.85568,240647
1432,DustinCampbell,1,0.00042,16499,6.85610,240647
1433,DWand,1,0.00042,16500,6.85652,240647
1434,eclipsewebmaster,1,0.00042,16501,6.85693,240647
1435,EddyVerbruggen,1,0.00042,16502,6.85735,240647
1436,edi9999,1,0.00042,16503,6.85776,240647
1437,edify42,1,0.00042,16504,6.85818,240647
1438,edmBernard,1,0.00042,16505,6.85859,240647
1439,edorivai,1,0.00042,16506,6.85901,240647
1440,eduardbadillo,1,0.00042,16507,6.85942,240647
1441,edusperoni,1,0.00042,16508,6.85984,240647
1442,EgidioCaprino,1,0.00042,16509,6.86026,240647
1443,ehtb,1,0.00042,16510,6.86067,240647
1444,ekevoo,1,0.00042,16511,6.86109,240647
1445,ekmartin,1,0.00042,16512,6.86150,240647
1446,eleumik,1,0.00042,16513,6.86192,240647
1447,ElForastero,1,0.00042,16514,6.86233,240647
1448,elliott-davis,1,0.00042,16515,6.86275,240647
1449,elliottsj,1,0.00042,16516,6.86316,240647
1450,emmanuelbernard,1,0.00042,16517,6.86358,240647
1451,Eomm,1,0.00042,16518,6.86400,240647
1452,epelc,1,0.00042,16519,6.86441,240647
1453,epicfaace,1,0.00042,16520,6.86483,240647
1454,er1c,1,0.00042,16521,6.86524,240647
1455,erf,1,0.00042,16522,6.86566,240647
1456,ericyang89,1,0.00042,16523,6.86607,240647
1457,erikbern,1,0.00042,16524,6.86649,240647
1458,esiegel,1,0.00042,16525,6.86690,240647
1459,estaub,1,0.00042,16526,6.86732,240647
1460,estrada9166,1,0.00042,16527,6.86774,240647
1461,eugeneotto,1,0.00042,16528,6.86815,240647
1462,eugenesmlv,1,0.00042,16529,6.86857,240647
1463,evanshortiss,1,0.00042,16530,6.86898,240647
1464,eventualbuddha,1,0.00042,16531,6.86940,240647
1465,faridfor,1,0.00042,16532,6.86981,240647
1466,farnabaz,1,0.00042,16533,6.87023,240647
1467,farrago,1,0.00042,16534,6.87064,240647
1468,fearphage,1,0.00042,16535,6.87106,240647
1469,finnigantime,1,0.00042,16536,6.87148,240647
1470,fiznool,1,0.00042,16537,6.87189,240647
1471,fkgozali,1,0.00042,16538,6.87231,240647
1472,flotwig,1,0.00042,16539,6.87272,240647
1473,flut1,1,0.00042,16540,6.87314,240647
1474,forresst,1,0.00042,16541,6.87355,240647
1475,forsberg,1,0.00042,16542,6.87397,240647
1476,FourwingsY,1,0.00042,16543,6.87438,240647
1477,frangio,1,0.00042,16544,6.87480,240647
1478,frankier,1,0.00042,16545,6.87522,240647
1479,FrankPeschel-Gallee,1,0.00042,16546,6.87563,240647
1480,frederikbosch,1,0.00042,16547,6.87605,240647
1481,fregante,1,0.00042,16548,6.87646,240647
1482,frob,1,0.00042,16549,6.87688,240647
1483,frystpingvin,1,0.00042,16550,6.87729,240647
1484,fureweb-com,1,0.00042,16551,6.87771,240647
1485,gabegorelick,1,0.00042,16552,6.87812,240647
1486,garrypolley,1,0.00042,16553,6.87854,240647
1487,garthk,1,0.00042,16554,6.87896,240647
1488,Gary-Zh,1,0.00042,16555,6.87937,240647
1489,gcangussu,1,0.00042,16556,6.87979,240647
1490,geek,1,0.00042,16557,6.88020,240647
1491,gentoo90,1,0.00042,16558,6.88062,240647
1492,geobde,1,0.00042,16559,6.88103,240647
1493,ge-o-rg,1,0.00042,16560,6.88145,240647
1494,GeorgeGkas,1,0.00042,16561,6.88186,240647
1495,george-ranjan,1,0.00042,16562,6.88228,240647
1496,geraldolsribeiro,1,0.00042,16563,6.88270,240647
1497,getkey,1,0.00042,16564,6.88311,240647
1498,gfx,1,0.00042,16565,6.88353,240647
1499,ghandhikus,1,0.00042,16566,6.88394,240647
1500,GianlucaGuarini,1,0.00042,16567,6.88436,240647
1501,gildean,1,0.00042,16568,6.88477,240647
1502,gitlabbin,1,0.00042,16569,6.88519,240647
1503,gj,1,0.00042,16570,6.88560,240647
1504,Glavin001,1,0.00042,16571,6.88602,240647
1505,glena,1,0.00042,16572,6.88644,240647
1506,glensc,1,0.00042,16573,6.88685,240647
1507,golear91,1,0.00042,16574,6.88727,240647
1508,goleary,1,0.00042,16575,6.88768,240647
1509,Gommorach,1,0.00042,16576,6.88810,240647
1510,gouch,1,0.00042,16577,6.88851,240647
1511,grantcarthew,1,0.00042,16578,6.88893,240647
1512,greatjack1,1,0.00042,16579,6.88934,240647
1513,gugu,1,0.00042,16580,6.88976,240647
1514,guptasourabh,1,0.00042,16581,6.89018,240647
1515,gustavomazzoni,1,0.00042,16582,6.89059,240647
1516,gutsytechster,1,0.00042,16583,6.89101,240647
1517,gwhenne,1,0.00042,16584,6.89142,240647
1518,gyandeeps,1,0.00042,16585,6.89184,240647
1519,GyrosGeier,1,0.00042,16586,6.89225,240647
1520,HakurouKen,1,0.00042,16587,6.89267,240647
1521,handrews,1,0.00042,16588,6.89308,240647
1522,harriha,1,0.00042,16589,6.89350,240647
1523,haskellcamargo,1,0.00042,16590,6.89392,240647
1524,Hawkeye1909,1,0.00042,16591,6.89433,240647
1525,hayawata3626,1,0.00042,16592,6.89475,240647
1526,h-des,1,0.00042,16593,6.89516,240647
1527,hedgepigdaniel,1,0.00042,16594,6.89558,240647
1528,heidid,1,0.00042,16595,6.89599,240647
1529,hekike,1,0.00042,16596,6.89641,240647
1530,heloflier,1,0.00042,16597,6.89682,240647
1531,hessmjr,1,0.00042,16598,6.89724,240647
1532,heyamykate,1,0.00042,16599,6.89766,240647
1533,heygrady,1,0.00042,16600,6.89807,240647
1534,hmarr,1,0.00042,16601,6.89849,240647
1535,hmble,1,0.00042,16602,6.89890,240647
1536,holm,1,0.00042,16603,6.89932,240647
1537,hoobdeebla,1,0.00042,16604,6.89973,240647
1538,Hookyns,1,0.00042,16605,6.90015,240647
1539,hozefaj,1,0.00042,16606,6.90056,240647
1540,hqzxzwb,1,0.00042,16607,6.90098,240647
1541,HurricaneJames,1,0.00042,16608,6.90139,240647
1542,huxi,1,0.00042,16609,6.90181,240647
1543,Hypercubed,1,0.00042,16610,6.90223,240647
1544,iamakulov,1,0.00042,16611,6.90264,240647
1545,iam-merlin,1,0.00042,16612,6.90306,240647
1546,iamplugged,1,0.00042,16613,6.90347,240647
1547,ianstormtaylor,1,0.00042,16614,6.90389,240647
1548,iarna,1,0.00042,16615,6.90430,240647
1549,ibrahimpg,1,0.00042,16616,6.90472,240647
1550,idangozlan,1,0.00042,16617,6.90513,240647
1551,iDemonix,1,0.00042,16618,6.90555,240647
1552,idirouhab,1,0.00042,16619,6.90597,240647
1553,idmontie,1,0.00042,16620,6.90638,240647
1554,ignacioiglesias,1,0.00042,16621,6.90680,240647
1555,igncp,1,0.00042,16622,6.90721,240647
1556,IgorMiller,1,0.00042,16623,6.90763,240647
1557,igor-savin-ht,1,0.00042,16624,6.90804,240647
1558,ilyapx,1,0.00042,16625,6.90846,240647
1559,imdevin567,1,0.00042,16626,6.90887,240647
1560,imysak,1,0.00042,16627,6.90929,240647
1561,infused,1,0.00042,16628,6.90971,240647
1562,Iniesta8,1,0.00042,16629,6.91012,240647
1563,inikulin,1,0.00042,16630,6.91054,240647
1564,insfrag,1,0.00042,16631,6.91095,240647
1565,inversion,1,0.00042,16632,6.91137,240647
1566,io7m,1,0.00042,16633,6.91178,240647
1567,ipolevoy,1,0.00042,16634,6.91220,240647
1568,isabellatea,1,0.00042,16635,6.91261,240647
1569,ismamz,1,0.00042,16636,6.91303,240647
1570,isTravis,1,0.00042,16637,6.91345,240647
1571,ITonyLi,1,0.00042,16638,6.91386,240647
1572,Ivan-Kalatchev,1,0.00042,16639,6.91428,240647
1573,IVLIU,1,0.00042,16640,6.91469,240647
1574,ixalon,1,0.00042,16641,6.91511,240647
1575,jack4it,1,0.00042,16642,6.91552,240647
1576,jackspaniel,1,0.00042,16643,6.91594,240647
1577,JackuB,1,0.00042,16644,6.91635,240647
1578,jackwanders,1,0.00042,16645,6.91677,240647
1579,jacopofar,1,0.00042,16646,6.91719,240647
1580,jakemingolla,1,0.00042,16647,6.91760,240647
1581,jakepetroules,1,0.00042,16648,6.91802,240647
1582,JaKXz,1,0.00042,16649,6.91843,240647
1583,jamesevickery,1,0.00042,16650,6.91885,240647
1584,jamiebuilds,1,0.00042,16651,6.91926,240647
1585,jamischarles,1,0.00042,16652,6.91968,240647
1586,janaagaard75,1,0.00042,16653,6.92009,240647
1587,janderudder,1,0.00042,16654,6.92051,240647
1588,jankal,1,0.00042,16655,6.92093,240647
1589,JanMalch,1,0.00042,16656,6.92134,240647
1590,Janpot,1,0.00042,16657,6.92176,240647
1591,japgolly,1,0.00042,16658,6.92217,240647
1592,jardilio,1,0.00042,16659,6.92259,240647
1593,Jared-Dev,1,0.00042,16660,6.92300,240647
1594,jaredsuttles,1,0.00042,16661,6.92342,240647
1595,jareware,1,0.00042,16662,6.92383,240647
1596,jasonclinx,1,0.00042,16663,6.92425,240647
1597,jaspermdegroot,1,0.00042,16664,6.92467,240647
1598,jaubourg,1,0.00042,16665,6.92508,240647
1599,javespi,1,0.00042,16666,6.92550,240647
1600,jawn,1,0.00042,16667,6.92591,240647
1601,jbleduigou,1,0.00042,16668,6.92633,240647
1602,jbonta,1,0.00042,16669,6.92674,240647
1603,jde1,1,0.00042,16670,6.92716,240647
1604,jden,1,0.00042,16671,6.92757,240647
1605,jdreesen,1,0.00042,16672,6.92799,240647
1606,jdspugh,1,0.00042,16673,6.92841,240647
1607,jeffbski,1,0.00042,16674,6.92882,240647
1608,jehadja,1,0.00042,16675,6.92924,240647
1609,jennifer-shehane,1,0.00042,16676,6.92965,240647
1610,jensenbox,1,0.00042,16677,6.93007,240647
1611,jeremy-w,1,0.00042,16678,6.93048,240647
1612,jf17,1,0.00042,16679,6.93090,240647
1613,jfairbank,1,0.00042,16680,6.93131,240647
1614,jharris4,1,0.00042,16681,6.93173,240647
1615,jhickson,1,0.00042,16682,6.93215,240647
1616,jimbrowne,1,0.00042,16683,6.93256,240647
1617,JitixPhotobox,1,0.00042,16684,6.93298,240647
1618,jlongster,1,0.00042,16685,6.93339,240647
1619,jmg87,1,0.00042,16686,6.93381,240647
1620,jmsv,1,0.00042,16687,6.93422,240647
1621,jmthibault79,1,0.00042,16688,6.93464,240647
1622,jmventura,1,0.00042,16689,6.93505,240647
1623,joefraley,1,0.00042,16690,6.93547,240647
1624,joelgallant,1,0.00042,16691,6.93589,240647
1625,joelittlejohn,1,0.00042,16692,6.93630,240647
1626,joepie91,1,0.00042,16693,6.93672,240647
1627,joestein,1,0.00042,16694,6.93713,240647
1628,JoeZheng2015,1,0.00042,16695,6.93755,240647
1629,JohnAlbin,1,0.00042,16696,6.93796,240647
1630,johnjelinek,1,0.00042,16697,6.93838,240647
1631,jomeier,1,0.00042,16698,6.93879,240647
1632,jondubois,1,0.00042,16699,6.93921,240647
1633,jonekdahl,1,0.00042,16700,6.93963,240647
1634,jonganc,1,0.00042,16701,6.94004,240647
1635,joordas,1,0.00042,16702,6.94046,240647
1636,jordanhendricks,1,0.00042,16703,6.94087,240647
1637,Jose-CF,1,0.00042,16704,6.94129,240647
1638,josecolella,1,0.00042,16705,6.94170,240647
1639,JosephAmalfitanoSSA,1,0.00042,16706,6.94212,240647
1640,josephlbarnett,1,0.00042,16707,6.94253,240647
1641,joshk,1,0.00042,16708,6.94295,240647
1642,joshuago,1,0.00042,16709,6.94337,240647
1643,joshunger,1,0.00042,16710,6.94378,240647
1644,joshushua,1,0.00042,16711,6.94420,240647
1645,josiasmontag,1,0.00042,16712,6.94461,240647
1646,joymufeng,1,0.00042,16713,6.94503,240647
1647,jpaugh,1,0.00042,16714,6.94544,240647
1648,jpierson,1,0.00042,16715,6.94586,240647
1649,jramosf,1,0.00042,16716,6.94627,240647
1650,jsamr,1,0.00042,16717,6.94669,240647
1651,jsdevel,1,0.00042,16718,6.94711,240647
1652,jsha,1,0.00042,16719,6.94752,240647
1653,jsonmaur,1,0.00042,16720,6.94794,240647
1654,jstrutz,1,0.00042,16721,6.94835,240647
1655,jsumners,1,0.00042,16722,6.94877,240647
1656,JuanjoSalvador,1,0.00042,16723,6.94918,240647
1657,junajan,1,0.00042,16724,6.94960,240647
1658,junosuarez,1,0.00042,16725,6.95001,240647
1659,justinmchase,1,0.00042,16726,6.95043,240647
1660,JustinRChou,1,0.00042,16727,6.95085,240647
1661,JustinTRoss,1,0.00042,16728,6.95126,240647
1662,jvican,1,0.00042,16729,6.95168,240647
1663,jviotti,1,0.00042,16730,6.95209,240647
1664,jwcarman,1,0.00042,16731,6.95251,240647
1665,jwKimo,1,0.00042,16732,6.95292,240647
1666,jysoo,1,0.00042,16733,6.95334,240647
1667,jyterencekim,1,0.00042,16734,6.95375,240647
1668,jzischkau,1,0.00042,16735,6.95417,240647
1669,Kamshak,1,0.00042,16736,6.95458,240647
1670,karataev,1,0.00042,16737,6.95500,240647
1671,kasunt84,1,0.00042,16738,6.95542,240647
1672,kazssym,1,0.00042,16739,6.95583,240647
1673,kazuki229,1,0.00042,16740,6.95625,240647
1674,kbariotis,1,0.00042,16741,6.95666,240647
1675,keinkonzept,1,0.00042,16742,6.95708,240647
1676,kellyrmilligan,1,0.00042,16743,6.95749,240647
1677,kevinmost,1,0.00042,16744,6.95791,240647
1678,keyten,1,0.00042,16745,6.95832,240647
1679,kilianc,1,0.00042,16746,6.95874,240647
1680,KillWolfVlad,1,0.00042,16747,6.95916,240647
1681,kira1928,1,0.00042,16748,6.95957,240647
1682,kjivan,1,0.00042,16749,6.95999,240647
1683,klamping,1,0.00042,16750,6.96040,240647
1684,klausbayrhammer,1,0.00042,16751,6.96082,240647
1685,Kmaschta,1,0.00042,16752,6.96123,240647
1686,knjk04,1,0.00042,16753,6.96165,240647
1687,knpwrs,1,0.00042,16754,6.96206,240647
1688,kobayashi,1,0.00042,16755,6.96248,240647
1689,koistya,1,0.00042,16756,6.96290,240647
1690,KonstaL,1,0.00042,16757,6.96331,240647
1691,kopylovvlad,1,0.00042,16758,6.96373,240647
1692,krenor,1,0.00042,16759,6.96414,240647
1693,KristofMorva,1,0.00042,16760,6.96456,240647
1694,kroeckx,1,0.00042,16761,6.96497,240647
1695,krzywiecki,1,0.00042,16762,6.96539,240647
1696,kshetline,1,0.00042,16763,6.96580,240647
1697,KSXGitHub,1,0.00042,16764,6.96622,240647
1698,kukat,1,0.00042,16765,6.96664,240647
1699,Kundan28,1,0.00042,16766,6.96705,240647
1700,kusold,1,0.00042,16767,6.96747,240647
1701,laggingreflex,1,0.00042,16768,6.96788,240647
1702,lamby,1,0.00042,16769,6.96830,240647
1703,Lange,1,0.00042,16770,6.96871,240647
1704,larrywest42,1,0.00042,16771,6.96913,240647
1705,laurentgoudet,1,0.00042,16772,6.96954,240647
1706,laurio,1,0.00042,16773,6.96996,240647
1707,lbogdan,1,0.00042,16774,6.97038,240647
1708,lehni,1,0.00042,16775,6.97079,240647
1709,lenisha,1,0.00042,16776,6.97121,240647
1710,lenovouser,1,0.00042,16777,6.97162,240647
1711,leventov,1,0.00042,16778,6.97204,240647
1712,levibotelho,1,0.00042,16779,6.97245,240647
1713,lewurm,1,0.00042,16780,6.97287,240647
1714,lionello,1,0.00042,16781,6.97328,240647
1715,liuhelen10,1,0.00042,16782,6.97370,240647
1716,LKI,1,0.00042,16783,6.97412,240647
1717,lm1,1,0.00042,16784,6.97453,240647
1718,loilo,1,0.00042,16785,6.97495,240647
1719,Lokua,1,0.00042,16786,6.97536,240647
1720,lopezcjf,1,0.00042,16787,6.97578,240647
1721,lorenzph,1,0.00042,16788,6.97619,240647
1722,lrlna,1,0.00042,16789,6.97661,240647
1723,ls-guillaume-rebesche,1,0.00042,16790,6.97702,240647
1724,LTMenezes,1,0.00042,16791,6.97744,240647
1725,lucalas,1,0.00042,16792,6.97786,240647
1726,luciferous,1,0.00042,16793,6.97827,240647
1727,luhenry,1,0.00042,16794,6.97869,240647
1728,luohao-brian,1,0.00042,16795,6.97910,240647
1729,lusarz,1,0.00042,16796,6.97952,240647
1730,Lusitaniae,1,0.00042,16797,6.97993,240647
1731,lydell,1,0.00042,16798,6.98035,240647
1732,lyzahn2,1,0.00042,16799,6.98076,240647
1733,m1guelpf,1,0.00042,16800,6.98118,240647
1734,m59peacemaker,1,0.00042,16801,6.98160,240647
1735,magicdawn,1,0.00042,16802,6.98201,240647
1736,magro,1,0.00042,16803,6.98243,240647
1737,maks-rafalko,1,0.00042,16804,6.98284,240647
1738,malthejorgensen,1,0.00042,16805,6.98326,240647
1739,malud,1,0.00042,16806,6.98367,240647
1740,Mamboleoo,1,0.00042,16807,6.98409,240647
1741,ManoelLobo,1,0.00042,16808,6.98450,240647
1742,manospasj,1,0.00042,16809,6.98492,240647
1743,manrueda,1,0.00042,16810,6.98534,240647
1744,manuelkollus,1,0.00042,16811,6.98575,240647
1745,marado,1,0.00042,16812,6.98617,240647
1746,MarcelGerber,1,0.00042,16813,6.98658,240647
1747,marceloverdijk,1,0.00042,16814,6.98700,240647
1748,marciovicente,1,0.00042,16815,6.98741,240647
1749,marclipovsky,1,0.00042,16816,6.98783,240647
1750,Marcono1234,1,0.00042,16817,6.98824,240647
1751,marcust,1,0.00042,16818,6.98866,240647
1752,marcuswhybrow,1,0.00042,16819,6.98908,240647
1753,marcysutton,1,0.00042,16820,6.98949,240647
1754,marklagendijk,1,0.00042,16821,6.98991,240647
1755,marshall007,1,0.00042,16822,6.99032,240647
1756,MartinKamenov,1,0.00042,16823,6.99074,240647
1757,Maskedman99,1,0.00042,16824,6.99115,240647
1758,masterots,1,0.00042,16825,6.99157,240647
1759,matanlurey,1,0.00042,16826,6.99198,240647
1760,mattbdean,1,0.00042,16827,6.99240,240647
1761,matthewayne,1,0.00042,16828,6.99282,240647
1762,matthewcm,1,0.00042,16829,6.99323,240647
1763,MattMcFarland,1,0.00042,16830,6.99365,240647
1764,mattnelson,1,0.00042,16831,6.99406,240647
1765,maxd,1,0.00042,16832,6.99448,240647
1766,Mazuh,1,0.00042,16833,6.99489,240647
1767,mbeaudru,1,0.00042,16834,6.99531,240647
1768,mborst,1,0.00042,16835,6.99572,240647
1769,MCAxiaz,1,0.00042,16836,6.99614,240647
1770,mciezadlo,1,0.00042,16837,6.99656,240647
1771,mduu,1,0.00042,16838,6.99697,240647
1772,meatlewis,1,0.00042,16839,6.99739,240647
1773,medikoo,1,0.00042,16840,6.99780,240647
1774,melquiadess,1,0.00042,16841,6.99822,240647
1775,mesaugat,1,0.00042,16842,6.99863,240647
1776,mgorabbani,1,0.00042,16843,6.99905,240647
1777,micha149,1,0.00042,16844,6.99946,240647
1778,michaelbjames,1,0.00042,16845,6.99988,240647
1779,MichaelDeBoey,1,0.00042,16846,7.00030,240647
1780,michaeljota,1,0.00042,16847,7.00071,240647
1781,michaelsavich,1,0.00042,16848,7.00113,240647
1782,MichaHoffmann,1,0.00042,16849,7.00154,240647
1783,Mickael-van-der-Beek,1,0.00042,16850,7.00196,240647
1784,Micua,1,0.00042,16851,7.00237,240647
1785,migueldeicaza,1,0.00042,16852,7.00279,240647
1786,migueloller,1,0.00042,16853,7.00320,240647
1787,Miha-x64,1,0.00042,16854,7.00362,240647
1788,mikemaccana,1,0.00042,16855,7.00403,240647
1789,mikhailshilkov,1,0.00042,16856,7.00445,240647
1790,Minilfat,1,0.00042,16857,7.00487,240647
1791,mirroredge,1,0.00042,16858,7.00528,240647
1792,mjw56,1,0.00042,16859,7.00570,240647
1793,mkantor,1,0.00042,16860,7.00611,240647
1794,mklement0,1,0.00042,16861,7.00653,240647
1795,mleibman,1,0.00042,16862,7.00694,240647
1796,mmedal,1,0.00042,16863,7.00736,240647
1797,mnpenner,1,0.00042,16864,7.00777,240647
1798,mofr,1,0.00042,16865,7.00819,240647
1799,mohamed-ismat,1,0.00042,16866,7.00861,240647
1800,moismat,1,0.00042,16867,7.00902,240647
1801,monkeym4ster,1,0.00042,16868,7.00944,240647
1802,morissette,1,0.00042,16869,7.00985,240647
1803,morningmemo,1,0.00042,16870,7.01027,240647
1804,motet-a,1,0.00042,16871,7.01068,240647
1805,motlin,1,0.00042,16872,7.01110,240647
1806,Mozilla-GitHub-Standards,1,0.00042,16873,7.01151,240647
1807,mpccolorado,1,0.00042,16874,7.01193,240647
1808,mperham,1,0.00042,16875,7.01235,240647
1809,mrblackus,1,0.00042,16876,7.01276,240647
1810,MrDesjardins,1,0.00042,16877,7.01318,240647
1811,mrjgreen,1,0.00042,16878,7.01359,240647
1812,mr-yamraj,1,0.00042,16879,7.01401,240647
1813,msebire,1,0.00042,16880,7.01442,240647
1814,msemtd,1,0.00042,16881,7.01484,240647
1815,mtotoWamkwe,1,0.00042,16882,7.01525,240647
1816,munificent,1,0.00042,16883,7.01567,240647
1817,mwindle,1,0.00042,16884,7.01609,240647
1818,mxstbr,1,0.00042,16885,7.01650,240647
1819,mydea,1,0.00042,16886,7.01692,240647
1820,mzabriskie,1,0.00042,16887,7.01733,240647
1821,mzeddd,1,0.00042,16888,7.01775,240647
1822,nanonyme,1,0.00042,16889,7.01816,240647
1823,Nargonath,1,0.00042,16890,7.01858,240647
1824,Natim,1,0.00042,16891,7.01899,240647
1825,nazrhyn,1,0.00042,16892,7.01941,240647
1826,nbarbettini,1,0.00042,16893,7.01983,240647
1827,nbaztec,1,0.00042,16894,7.02024,240647
1828,ncoghlan,1,0.00042,16895,7.02066,240647
1829,Neaox,1,0.00042,16896,7.02107,240647
1830,Nepomuceno,1,0.00042,16897,7.02149,240647
1831,Nettsentrisk,1,0.00042,16898,7.02190,240647
1832,neu5,1,0.00042,16899,7.02232,240647
1833,NeuralSandwich,1,0.00042,16900,7.02273,240647
1834,newyork-anthonyng,1,0.00042,16901,7.02315,240647
1835,Nicholas-Eng,1,0.00042,16902,7.02357,240647
1836,nimerritt,1,0.00042,16903,7.02398,240647
1837,nishp1,1,0.00042,16904,7.02440,240647
1838,niustephanie,1,0.00042,16905,7.02481,240647
1839,nivs,1,0.00042,16906,7.02523,240647
1840,njsubedi,1,0.00042,16907,7.02564,240647
1841,nkollar,1,0.00042,16908,7.02606,240647
1842,nkzawa,1,0.00042,16909,7.02647,240647
1843,nLight,1,0.00042,16910,7.02689,240647
1844,nmn,1,0.00042,16911,7.02731,240647
1845,nmschulte,1,0.00042,16912,7.02772,240647
1846,Nolanus,1,0.00042,16913,7.02814,240647
1847,noodleswww,1,0.00042,16914,7.02855,240647
1848,noopur-tiwari,1,0.00042,16915,7.02897,240647
1849,nornagon,1,0.00042,16916,7.02938,240647
1850,nottrobin,1,0.00042,16917,7.02980,240647
1851,noyesa,1,0.00042,16918,7.03021,240647
1852,nsoranzo,1,0.00042,16919,7.03063,240647
1853,nthcircle,1,0.00042,16920,7.03105,240647
1854,ntherning,1,0.00042,16921,7.03146,240647
1855,nurkiewicz,1,0.00042,16922,7.03188,240647
1856,nwoltman,1,0.00042,16923,7.03229,240647
1857,nykolaslima,1,0.00042,16924,7.03271,240647
1858,nyurik,1,0.00042,16925,7.03312,240647
1859,oconn,1,0.00042,16926,7.03354,240647
1860,odysseuscm,1,0.00042,16927,7.03395,240647
1861,ogix,1,0.00042,16928,7.03437,240647
1862,Oire,1,0.00042,16929,7.03479,240647
1863,okdistribute,1,0.00042,16930,7.03520,240647
1864,oldj,1,0.00042,16931,7.03562,240647
1865,omerson,1,0.00042,16932,7.03603,240647
1866,ompraash,1,0.00042,16933,7.03645,240647
1867,oporko,1,0.00042,16934,7.03686,240647
1868,Opticsponge,1,0.00042,16935,7.03728,240647
1869,oreissig,1,0.00042,16936,7.03769,240647
1870,Oseenix,1,0.00042,16937,7.03811,240647
1871,ossdev07,1,0.00042,16938,7.03853,240647
1872,oughter,1,0.00042,16939,7.03894,240647
1873,outofgamut,1,0.00042,16940,7.03936,240647
1874,Parcley,1,0.00042,16941,7.03977,240647
1875,pataar,1,0.00042,16942,7.04019,240647
1876,pauldraper,1,0.00042,16943,7.04060,240647
1877,paulkass,1,0.00042,16944,7.04102,240647
1878,paulmelnikow,1,0.00042,16945,7.04143,240647
1879,paulradzkov,1,0.00042,16946,7.04185,240647
1880,paustria,1,0.00042,16947,7.04227,240647
1881,pcornelissen,1,0.00042,16948,7.04268,240647
1882,PedroMiguelSS,1,0.00042,16949,7.04310,240647
1883,pedroprado010,1,0.00042,16950,7.04351,240647
1884,peitek,1,0.00042,16951,7.04393,240647
1885,PeteGillin,1,0.00042,16952,7.04434,240647
1886,peterlenagh,1,0.00042,16953,7.04476,240647
1887,petermbenjamin,1,0.00042,16954,7.04517,240647
1888,petermikitsh,1,0.00042,16955,7.04559,240647
1889,Philipp91,1,0.00042,16956,7.04601,240647
1890,philippgille,1,0.00042,16957,7.04642,240647
1891,phillipj,1,0.00042,16958,7.04684,240647
1892,Piccirello,1,0.00042,16959,7.04725,240647
1893,PiDelport,1,0.00042,16960,7.04767,240647
1894,pietvandongen,1,0.00042,16961,7.04808,240647
1895,pjhjohn,1,0.00042,16962,7.04850,240647
1896,pkallos,1,0.00042,16963,7.04891,240647
1897,PKief,1,0.00042,16964,7.04933,240647
1898,platinumazure,1,0.00042,16965,7.04975,240647
1899,plokhotnyuk,1,0.00042,16966,7.05016,240647
1900,poison,1,0.00042,16967,7.05058,240647
1901,PolinaRodimova,1,0.00042,16968,7.05099,240647
1902,portolucas,1,0.00042,16969,7.05141,240647
1903,praveenn-vbi,1,0.00042,16970,7.05182,240647
1904,prempalsingh,1,0.00042,16971,7.05224,240647
1905,pRizz,1,0.00042,16972,7.05265,240647
1906,protyposis,1,0.00042,16973,7.05307,240647
1907,ptrain,1,0.00042,16974,7.05348,240647
1908,puku0x,1,0.00042,16975,7.05390,240647
1909,pvoisin,1,0.00042,16976,7.05432,240647
1910,qerub,1,0.00042,16977,7.05473,240647
1911,qix,1,0.00042,16978,7.05515,240647
1912,qqbuby,1,0.00042,16979,7.05556,240647
1913,qw-in,1,0.00042,16980,7.05598,240647
1914,Qw-in,1,0.00042,16981,7.05639,240647
1915,qwwdfsad,1,0.00042,16982,7.05681,240647
1916,radiovisual,1,0.00042,16983,7.05722,240647
1917,rafrex,1,0.00042,16984,7.05764,240647
1918,Raghavan1993,1,0.00042,16985,7.05806,240647
1919,rah-gupta,1,0.00042,16986,7.05847,240647
1920,Rantanen,1,0.00042,16987,7.05889,240647
1921,redbmk,1,0.00042,16988,7.05930,240647
1922,redeyes2015,1,0.00042,16989,7.05972,240647
1923,reedfeng,1,0.00042,16990,7.06013,240647
1924,rellect,1,0.00042,16991,7.06055,240647
1925,remcowesterhoud,1,0.00042,16992,7.06096,240647
1926,remko,1,0.00042,16993,7.06138,240647
1927,renanpvaz,1,0.00042,16994,7.06180,240647
1928,renewooller,1,0.00042,16995,7.06221,240647
1929,reviewher,1,0.00042,16996,7.06263,240647
1930,revington,1,0.00042,16997,7.06304,240647
1931,rexxars,1,0.00042,16998,7.06346,240647
1932,rgeraldporter,1,0.00042,16999,7.06387,240647
1933,rgraffbrd,1,0.00042,17000,7.06429,240647
1934,rhelms,1,0.00042,17001,7.06470,240647
1935,rhmoller,1,0.00042,17002,7.06512,240647
1936,rhysmccaig,1,0.00042,17003,7.06554,240647
1937,ricardogama,1,0.00042,17004,7.06595,240647
1938,richardfearn,1,0.00042,17005,7.06637,240647
1939,RichardLitt,1,0.00042,17006,7.06678,240647
1940,rickyvetter,1,0.00042,17007,7.06720,240647
1941,rike422,1,0.00042,17008,7.06761,240647
1942,rivertam,1,0.00042,17009,7.06803,240647
1943,rjackson-dev-ops,1,0.00042,17010,7.06844,240647
1944,rjruizes,1,0.00042,17011,7.06886,240647
1945,rmariuzzo,1,0.00042,17012,7.06928,240647
1946,rmharrison,1,0.00042,17013,7.06969,240647
1947,RobDesideri,1,0.00042,17014,7.07011,240647
1948,robinkanters,1,0.00042,17015,7.07052,240647
1949,RoboBurned,1,0.00042,17016,7.07094,240647
1950,roboshoes,1,0.00042,17017,7.07135,240647
1951,rockymeza,1,0.00042,17018,7.07177,240647
1952,rodrigobdz,1,0.00042,17019,7.07218,240647
1953,roman01la,1,0.00042,17020,7.07260,240647
1954,RomanGotsiy,1,0.00042,17021,7.07302,240647
1955,roman-mazur,1,0.00042,17022,7.07343,240647
1956,romeovs,1,0.00042,17023,7.07385,240647
1957,rootsher,1,0.00042,17024,7.07426,240647
1958,rouanw,1,0.00042,17025,7.07468,240647
1959,roymiloh,1,0.00042,17026,7.07509,240647
1960,rszalski,1,0.00042,17027,7.07551,240647
1961,rtfpessoa,1,0.00042,17028,7.07592,240647
1962,rtsao,1,0.00042,17029,7.07634,240647
1963,rubycut,1,0.00042,17030,7.07676,240647
1964,RudarDaman,1,0.00042,17031,7.07717,240647
1965,rudolfolah,1,0.00042,17032,7.07759,240647
1966,Runrioter,1,0.00042,17033,7.07800,240647
1967,ruphin,1,0.00042,17034,7.07842,240647
1968,russellpwirtz,1,0.00042,17035,7.07883,240647
1969,rwaldron,1,0.00042,17036,7.07925,240647
1970,rwieruch,1,0.00042,17037,7.07966,240647
1971,ryancyq,1,0.00042,17038,7.08008,240647
1972,ryan-williams,1,0.00042,17039,7.08050,240647
1973,rybon,1,0.00042,17040,7.08091,240647
1974,ryouaki,1,0.00042,17041,7.08133,240647
1975,S2-,1,0.00042,17042,7.08174,240647
1976,saadq,1,0.00042,17043,7.08216,240647
1977,saadtazi,1,0.00042,17044,7.08257,240647
1978,SaeedPrez,1,0.00042,17045,7.08299,240647
1979,sam09,1,0.00042,17046,7.08340,240647
1980,samccone,1,0.00042,17047,7.08382,240647
1981,samdenty99,1,0.00042,17048,7.08424,240647
1982,samerbuna,1,0.00042,17049,7.08465,240647
1983,samliebow,1,0.00042,17050,7.08507,240647
1984,sandwichsudo,1,0.00042,17051,7.08548,240647
1985,Sanjo,1,0.00042,17052,7.08590,240647
1986,sanniassin,1,0.00042,17053,7.08631,240647
1987,santiagoaguiar,1,0.00042,17054,7.08673,240647
1988,sarangjo,1,0.00042,17055,7.08714,240647
1989,satansk,1,0.00042,17056,7.08756,240647
1990,satta,1,0.00042,17057,7.08798,240647
1991,sbley,1,0.00042,17058,7.08839,240647
1992,sbrl,1,0.00042,17059,7.08881,240647
1993,ScriptSmith,1,0.00042,17060,7.08922,240647
1994,seawatts,1,0.00042,17061,7.08964,240647
1995,sehrope,1,0.00042,17062,7.09005,240647
1996,seiyria,1,0.00042,17063,7.09047,240647
1997,sendilkumarn,1,0.00042,17064,7.09088,240647
1998,seratch,1,0.00042,17065,7.09130,240647
1999,serchavalos,1,0.00042,17066,7.09172,240647
2000,sergei-zelinsky,1,0.00042,17067,7.09213,240647
2001,sergiopantoja,1,0.00042,17068,7.09255,240647
2002,shaggygi,1,0.00042,17069,7.09296,240647
2003,shahmeet999,1,0.00042,17070,7.09338,240647
2004,shawninder,1,0.00042,17071,7.09379,240647
2005,shlomif,1,0.00042,17072,7.09421,240647
2006,siamak,1,0.00042,17073,7.09462,240647
2007,sibelius,1,0.00042,17074,7.09504,240647
2008,sibiraj-s,1,0.00042,17075,7.09546,240647
2009,sidps,1,0.00042,17076,7.09587,240647
2010,Sieabah,1,0.00042,17077,7.09629,240647
2011,sigmundch,1,0.00042,17078,7.09670,240647
2012,silvermanj7,1,0.00042,17079,7.09712,240647
2013,simeg,1,0.00042,17080,7.09753,240647
2014,sjrd,1,0.00042,17081,7.09795,240647
2015,skjolber,1,0.00042,17082,7.09836,240647
2016,skotniczny,1,0.00042,17083,7.09878,240647
2017,skyline-123,1,0.00042,17084,7.09920,240647
2018,skyzyx,1,0.00042,17085,7.09961,240647
2019,slavanga,1,0.00042,17086,7.10003,240647
2020,sliceofbytes,1,0.00042,17087,7.10044,240647
2021,SomeoneWeird,1,0.00042,17088,7.10086,240647
2022,sondrele,1,0.00042,17089,7.10127,240647
2023,sothawo,1,0.00042,17090,7.10169,240647
2024,spegelref,1,0.00042,17091,7.10210,240647
2025,sprockow,1,0.00042,17092,7.10252,240647
2026,spshant,1,0.00042,17093,7.10294,240647
2027,sqrthree,1,0.00042,17094,7.10335,240647
2028,srn,1,0.00042,17095,7.10377,240647
2029,Standard8,1,0.00042,17096,7.10418,240647
2030,StefMa,1,0.00042,17097,7.10460,240647
2031,stephengroat,1,0.00042,17098,7.10501,240647
2032,stephlag,1,0.00042,17099,7.10543,240647
2033,steveklabnik,1,0.00042,17100,7.10584,240647
2034,stevenbenitez,1,0.00042,17101,7.10626,240647
2035,stevenschlansker,1,0.00042,17102,7.10667,240647
2036,steve-taylor,1,0.00042,17103,7.10709,240647
2037,stovocor,1,0.00042,17104,7.10751,240647
2038,sttk,1,0.00042,17105,7.10792,240647
2039,sumanvyj,1,0.00042,17106,7.10834,240647
2040,sunorry,1,0.00042,17107,7.10875,240647
2041,svetlyak40wt,1,0.00042,17108,7.10917,240647
2042,sYnfo,1,0.00042,17109,7.10958,240647
2043,Syrok,1,0.00042,17110,7.11000,240647
2044,szepeviktor,1,0.00042,17111,7.11041,240647
2045,tanyabrassie,1,0.00042,17112,7.11083,240647
2046,TATDK,1,0.00042,17113,7.11125,240647
2047,taylorhutchison,1,0.00042,17114,7.11166,240647
2048,tbartley,1,0.00042,17115,7.11208,240647
2049,tdg5,1,0.00042,17116,7.11249,240647
2050,tdhooper,1,0.00042,17117,7.11291,240647
2051,teameh,1,0.00042,17118,7.11332,240647
2052,TechDimension,1,0.00042,17119,7.11374,240647
2053,teeram,1,0.00042,17120,7.11415,240647
2054,testcenter,1,0.00042,17121,7.11457,240647
2055,tgallacher,1,0.00042,17122,7.11499,240647
2056,ThaddeusJiang,1,0.00042,17123,7.11540,240647
2057,tharunjose,1,0.00042,17124,7.11582,240647
2058,thatJavaNerd,1,0.00042,17125,7.11623,240647
2059,thebergamo,1,0.00042,17126,7.11665,240647
2060,TheBusCantSwim,1,0.00042,17127,7.11706,240647
2061,TheInnerParty,1,0.00042,17128,7.11748,240647
2062,theLine,1,0.00042,17129,7.11789,240647
2063,theromis,1,0.00042,17130,7.11831,240647
2064,TheSharpieOne,1,0.00042,17131,7.11873,240647
2065,the-vampiire,1,0.00042,17132,7.11914,240647
2066,thibautRe,1,0.00042,17133,7.11956,240647
2067,ThomasSimoens,1,0.00042,17134,7.11997,240647
2068,thommymo,1,0.00042,17135,7.12039,240647
2069,tiangolo,1,0.00042,17136,7.12080,240647
2070,timandy,1,0.00042,17137,7.12122,240647
2071,Timer,1,0.00042,17138,7.12163,240647
2072,timkindberg,1,0.00042,17139,7.12205,240647
2073,Timokasse,1,0.00042,17140,7.12247,240647
2074,TimonVS,1,0.00042,17141,7.12288,240647
2075,tj,1,0.00042,17142,7.12330,240647
2076,tjmehta,1,0.00042,17143,7.12371,240647
2077,tlantz,1,0.00042,17144,7.12413,240647
2078,tnunes,1,0.00042,17145,7.12454,240647
2079,TomK32,1,0.00042,17146,7.12496,240647
2080,tommagnusson,1,0.00042,17147,7.12537,240647
2081,TomyJaya,1,0.00042,17148,7.12579,240647
2082,tonybaloney,1,0.00042,17149,7.12621,240647
2083,Treora,1,0.00042,17150,7.12662,240647
2084,trierra,1,0.00042,17151,7.12704,240647
2085,trodrigues,1,0.00042,17152,7.12745,240647
2086,truelixin,1,0.00042,17153,7.12787,240647
2087,ttulka,1,0.00042,17154,7.12828,240647
2088,tugrul,1,0.00042,17155,7.12870,240647
2089,TundraFizz,1,0.00042,17156,7.12911,240647
2090,tvillaluz,1,0.00042,17157,7.12953,240647
2091,twillouer,1,0.00042,17158,7.12995,240647
2092,twk-b,1,0.00042,17159,7.13036,240647
2093,twlkyao,1,0.00042,17160,7.13078,240647
2094,tyrsius,1,0.00042,17161,7.13119,240647
2095,ulope,1,0.00042,17162,7.13161,240647
2096,unlimitedsola,1,0.00042,17163,7.13202,240647
2097,user890104,1,0.00042,17164,7.13244,240647
2098,uweschaefer,1,0.00042,17165,7.13285,240647
2099,ValentinTrinque,1,0.00042,17166,7.13327,240647
2100,Vampire,1,0.00042,17167,7.13369,240647
2101,vanbujm,1,0.00042,17168,7.13410,240647
2102,vanta,1,0.00042,17169,7.13452,240647
2103,vanthome,1,0.00042,17170,7.13493,240647
2104,vegetableman,1,0.00042,17171,7.13535,240647
2105,vernondegoede,1,0.00042,17172,7.13576,240647
2106,victorwangyang,1,0.00042,17173,7.13618,240647
2107,vinaydate,1,0.00042,17174,7.13659,240647
2108,vitaliy-bobrov,1,0.00042,17175,7.13701,240647
2109,vkhv,1,0.00042,17176,7.13743,240647
2110,vladgolubev,1,0.00042,17177,7.13784,240647
2111,vmalloc,1,0.00042,17178,7.13826,240647
2112,vmosyaykin,1,0.00042,17179,7.13867,240647
2113,vovkvlad,1,0.00042,17180,7.13909,240647
2114,wallali,1,0.00042,17181,7.13950,240647
2115,Wang-Sen,1,0.00042,17182,7.13992,240647
2116,warapitiya,1,0.00042,17183,7.14033,240647
2117,warrenseymour,1,0.00042,17184,7.14075,240647
2118,webprofusion-chrisc,1,0.00042,17185,7.14117,240647
2119,weiluntong,1,0.00042,17186,7.14158,240647
2120,weswigham,1,0.00042,17187,7.14200,240647
2121,WilcoFiers,1,0.00042,17188,7.14241,240647
2122,willbeaufoy,1,0.00042,17189,7.14283,240647
2123,willfarrell,1,0.00042,17190,7.14324,240647
2124,williamdes,1,0.00042,17191,7.14366,240647
2125,william-lohan,1,0.00042,17192,7.14407,240647
2126,Willv19,1,0.00042,17193,7.14449,240647
2127,wilmol,1,0.00042,17194,7.14491,240647
2128,wizawu,1,0.00042,17195,7.14532,240647
2129,wla80,1,0.00042,17196,7.14574,240647
2130,WLun001,1,0.00042,17197,7.14615,240647
2131,wojtekmaj,1,0.00042,17198,7.14657,240647
2132,woloski,1,0.00042,17199,7.14698,240647
2133,worldsense-tms,1,0.00042,17200,7.14740,240647
2134,WORMSS,1,0.00042,17201,7.14781,240647
2135,worthy7,1,0.00042,17202,7.14823,240647
2136,WouterG,1,0.00042,17203,7.14865,240647
2137,Wykks,1,0.00042,17204,7.14906,240647
2138,xdumaine,1,0.00042,17205,7.14948,240647
2139,xeno-by,1,0.00042,17206,7.14989,240647
2140,xfh,1,0.00042,17207,7.15031,240647
2141,xied75,1,0.00042,17208,7.15072,240647
2142,xobotyi,1,0.00042,17209,7.15114,240647
2143,Xorlev,1,0.00042,17210,7.15155,240647
2144,Xuanwo,1,0.00042,17211,7.15197,240647
2145,YairHalberstadt,1,0.00042,17212,7.15239,240647
2146,yang-xia,1,0.00042,17213,7.15280,240647
2147,yanick,1,0.00042,17214,7.15322,240647
2148,yankouskia,1,0.00042,17215,7.15363,240647
2149,yanxyz,1,0.00042,17216,7.15405,240647
2150,yaodingyd,1,0.00042,17217,7.15446,240647
2151,Yasumoto,1,0.00042,17218,7.15488,240647
2152,yavorski,1,0.00042,17219,7.15529,240647
2153,yaziza,1,0.00042,17220,7.15571,240647
2154,yehezkielbs,1,0.00042,17221,7.15612,240647
2155,yjcxy12,1,0.00042,17222,7.15654,240647
2156,yorkie,1,0.00042,17223,7.15696,240647
2157,yrodiere,1,0.00042,17224,7.15737,240647
2158,ytRino,1,0.00042,17225,7.15779,240647
2159,yuj,1,0.00042,17226,7.15820,240647
2160,yukiwongky,1,0.00042,17227,7.15862,240647
2161,yume-chan,1,0.00042,17228,7.15903,240647
2162,yvele,1,0.00042,17229,7.15945,240647
2163,yxl,1,0.00042,17230,7.15986,240647
2164,zackify,1,0.00042,17231,7.16028,240647
2165,zakhenry,1,0.00042,17232,7.16070,240647
2166,zakness,1,0.00042,17233,7.16111,240647
2167,zce,1,0.00042,17234,7.16153,240647
2168,zdroid,1,0.00042,17235,7.16194,240647
2169,zerok,1,0.00042,17236,7.16236,240647
2170,zhaosiyang,1,0.00042,17237,7.16277,240647
2171,zhengjunxin,1,0.00042,17238,7.16319,240647
2172,ZhitongLei,1,0.00042,17239,7.16360,240647
2173,zsmb13,1,0.00042,17240,7.16402,240647
2174,zuohuadong,1,0.00042,17241,7.16444,240647
2175,zxqfox,1,0.00042,17242,7.16485,240647
