rank_number,actor,commits,percent,cumulative_sum,cumulative_percent,all_commits
1,blesh,2576,0.94034,2576,0.94034,273944
2,benlesh,1466,0.53515,4042,1.47548,273944
3,LutzJaenicke,1116,0.40738,5158,1.88287,273944
4,dot-asm,896,0.32707,6054,2.20994,273944
5,snhenson,800,0.29203,6854,2.50197,273944
6,devversion,798,0.29130,7652,2.79327,273944
7,hughbe,638,0.23289,8290,3.02617,273944
8,JonHanna,622,0.22705,8912,3.25322,273944
9,fellows3,565,0.20625,9477,3.45947,273944
10,ichernev,473,0.17266,9950,3.63213,273944
11,bernd-edlinger,414,0.15113,10364,3.78325,273944
12,jimfb,410,0.14967,10774,3.93292,273944
13,btford,380,0.13871,11154,4.07164,273944
14,paulidale,377,0.13762,11531,4.20925,273944
15,som-snytt,348,0.12703,11879,4.33629,273944
16,mlaval,302,0.11024,12181,4.44653,273944
17,marclaval,300,0.10951,12481,4.55604,273944
18,simov,300,0.10951,12781,4.66555,273944
19,evmar,286,0.10440,13067,4.76995,273944
20,PaulGap,271,0.09893,13338,4.86888,273944
21,inder123,266,0.09710,13604,4.96598,273944
22,kroeckx,252,0.09199,13856,5.05797,273944
23,mary-poppins,245,0.08943,14101,5.14740,273944
24,ChrisMaddock,243,0.08870,14344,5.23611,273944
25,wardbell,238,0.08688,14582,5.32299,273944
26,mspncp,224,0.08177,14806,5.40475,273944
27,justinvp,191,0.06972,14997,5.47448,273944
28,sjtrimble,161,0.05877,15158,5.53325,273944
29,FdaSilvaYY,157,0.05731,15315,5.59056,273944
30,cexbrayat,147,0.05366,15462,5.64422,273944
31,AtsushiKan,146,0.05330,15608,5.69751,273944
32,twbs-grunt,145,0.05293,15753,5.75045,273944
33,jamesqo,130,0.04745,15883,5.79790,273944
34,pat270,115,0.04198,15998,5.83988,273944
35,vsn4ik,113,0.04125,16111,5.88113,273944
36,jnizet,111,0.04052,16222,5.92165,273944
37,ysds,111,0.04052,16333,5.96217,273944
38,janekdb,109,0.03979,16442,6.00196,273944
39,jteplitz602,107,0.03906,16549,6.04102,273944
40,pshrmn,107,0.03906,16656,6.08007,273944
41,marek-safar,105,0.03833,16761,6.11840,273944
42,gijsbotje,103,0.03760,16864,6.15600,273944
43,m5o,102,0.03723,16966,6.19324,273944
44,gotwarlost,101,0.03687,17067,6.23011,273944
45,DABH,99,0.03614,17166,6.26624,273944
46,trotyl,99,0.03614,17265,6.30238,273944
47,oznetmaster,98,0.03577,17363,6.33816,273944
48,saper,98,0.03577,17461,6.37393,273944
49,hrhino,97,0.03541,17558,6.40934,273944
50,InfoHunter,93,0.03395,17651,6.44329,273944
51,MarcoRossignoli,93,0.03395,17744,6.47724,273944
52,sepidehkh,92,0.03358,17836,6.51082,273944
53,robwormald,91,0.03322,17927,6.54404,273944
54,fitzgen,90,0.03285,18017,6.57689,273944
55,abetomo,81,0.02957,18098,6.60646,273944
56,Maxwe11,81,0.02957,18179,6.63603,273944
57,pauli-oracle,78,0.02847,18257,6.66450,273944
58,chembu,74,0.02701,18331,6.69151,273944
59,hnrch02,74,0.02701,18405,6.71853,273944
60,zalog,74,0.02701,18479,6.74554,273944
61,joshlemer,71,0.02592,18550,6.77146,273944
62,jenniferfell,70,0.02555,18620,6.79701,273944
63,sepidehMS,70,0.02555,18690,6.82256,273944
64,timrwood,70,0.02555,18760,6.84811,273944
65,mkarg,69,0.02519,18829,6.87330,273944
66,alexindigo,68,0.02482,18897,6.89813,273944
67,falsyvalues,66,0.02409,18963,6.92222,273944
68,Herst,66,0.02409,19029,6.94631,273944
69,nateprewitt,64,0.02336,19093,6.96967,273944
70,Clockwork-Muse,63,0.02300,19156,6.99267,273944
71,kevmoo,63,0.02300,19219,7.01567,273944
72,NthPortal,62,0.02263,19281,7.03830,273944
73,AlexRadch,60,0.02190,19341,7.06020,273944
74,goto-bus-stop,60,0.02190,19401,7.08210,273944
75,Wraith2,60,0.02190,19461,7.10401,273944
76,RyanZim,58,0.02117,19519,7.12518,273944
77,benlaurie,57,0.02081,19576,7.14599,273944
78,PeEllAvaj,57,0.02081,19633,7.16679,273944
79,jfmengels,56,0.02044,19689,7.18724,273944
80,madler,56,0.02044,19745,7.20768,273944
81,milessabin,56,0.02044,19801,7.22812,273944
82,EgorBo,55,0.02008,19856,7.24820,273944
83,hackcraft,55,0.02008,19911,7.26827,273944
84,jsfb,55,0.02008,19966,7.28835,273944
85,caesar1995,54,0.01971,20020,7.30806,273944
86,threepointone,54,0.01971,20074,7.32778,273944
87,Varunram,54,0.01971,20128,7.34749,273944
88,bershanskiy,53,0.01935,20181,7.36683,273944
89,kwalrath,53,0.01935,20234,7.38618,273944
90,Ichoran,52,0.01898,20286,7.40516,273944
91,openssl-machine,52,0.01898,20338,7.42415,273944
92,ghedo,51,0.01862,20389,7.44276,273944
93,martine,51,0.01862,20440,7.46138,273944
94,Splaktar,51,0.01862,20491,7.48000,273944
95,shahata,50,0.01825,20541,7.49825,273944
96,ashawley,49,0.01789,20590,7.51613,273944
97,nylen,47,0.01716,20637,7.53329,273944
98,Brianmanden,46,0.01679,20683,7.55008,273944
99,cellog,45,0.01643,20728,7.56651,273944
100,paulirish,45,0.01643,20773,7.58294,273944
101,arschmitz,44,0.01606,20817,7.59900,273944
102,eed3si9n,44,0.01606,20861,7.61506,273944
103,jteplitz,44,0.01606,20905,7.63112,273944
104,staabm,44,0.01606,20949,7.64718,273944
105,wojtask9,44,0.01606,20993,7.66325,273944
106,bbbrumley,43,0.01570,21036,7.67894,273944
107,beldmit,43,0.01570,21079,7.69464,273944
108,d10,43,0.01570,21122,7.71033,273944
109,mkeskells,43,0.01570,21165,7.72603,273944
110,CaerusKaru,42,0.01533,21207,7.74136,273944
111,iamandrewluca,42,0.01533,21249,7.75669,273944
112,DzmitryShylovich,41,0.01497,21290,7.77166,273944
113,Toxicable,41,0.01497,21331,7.78663,273944
114,amcdnl,39,0.01424,21370,7.80086,273944
115,evanvosberg,39,0.01424,21409,7.81510,273944
116,joyent-automation,39,0.01424,21448,7.82934,273944
117,PascalPrecht,39,0.01424,21487,7.84357,273944
118,WilliamKoza,39,0.01424,21526,7.85781,273944
119,florianlacreuse,38,0.01387,21564,7.87168,273944
120,kohei-takata,38,0.01387,21602,7.88555,273944
121,Philippus,38,0.01387,21640,7.89942,273944
122,santoshyadav198613,38,0.01387,21678,7.91330,273944
123,elas7,37,0.01351,21715,7.92680,273944
124,joroKr21,37,0.01351,21752,7.94031,273944
125,bassjobsen,36,0.01314,21788,7.95345,273944
126,coreyfarrell,36,0.01314,21824,7.96659,273944
127,spion,36,0.01314,21860,7.97973,273944
128,blikblum,35,0.01278,21895,7.99251,273944
129,pvdlg,35,0.01278,21930,8.00529,273944
130,keyz,33,0.01205,21963,8.01733,273944
131,sokket,33,0.01205,21996,8.02938,273944
132,martijnhoekstra,32,0.01168,22028,8.04106,273944
133,Quy,32,0.01168,22060,8.05274,273944
134,alekitto,31,0.01132,22091,8.06406,273944
135,hankduan,31,0.01132,22122,8.07537,273944
136,BendingBender,30,0.01095,22152,8.08632,273944
137,codecalm,30,0.01095,22182,8.09728,273944
138,StephenFluin,30,0.01095,22212,8.10823,273944
139,WinCPP,30,0.01095,22242,8.11918,273944
140,GeoSot,29,0.01059,22271,8.12976,273944
141,mleguen,29,0.01059,22300,8.14035,273944
142,soc,29,0.01059,22329,8.15094,273944
143,alfaproject,28,0.01022,22357,8.16116,273944
144,cironunes,28,0.01022,22385,8.17138,273944
145,FrederikSchlemmer,28,0.01022,22413,8.18160,273944
146,petetnt,28,0.01022,22441,8.19182,273944
147,svick,28,0.01022,22469,8.20204,273944
148,willshowell,28,0.01022,22497,8.21226,273944
149,AfsanehR,27,0.00986,22524,8.22212,273944
150,Dmitry-Me,27,0.00986,22551,8.23197,273944
151,LinusU,27,0.00986,22578,8.24183,273944
152,lucascono,27,0.00986,22605,8.25169,273944
153,m-amr,27,0.00986,22632,8.26154,273944
154,manekinekko,27,0.00986,22659,8.27140,273944
155,sts-ryan-holton,27,0.00986,22686,8.28125,273944
156,tracyjordan,27,0.00986,22713,8.29111,273944
157,tspaeth,27,0.00986,22740,8.30097,273944
158,vanduynslagerp,27,0.00986,22767,8.31082,273944
159,wKoza,27,0.00986,22794,8.32068,273944
160,carlossanlop,26,0.00949,22820,8.33017,273944
161,dcherman,26,0.00949,22846,8.33966,273944
162,Jasper-M,26,0.00949,22872,8.34915,273944
163,keyanzhang,26,0.00949,22898,8.35864,273944
164,tromey,26,0.00949,22924,8.36813,273944
165,yujayee,26,0.00949,22950,8.37762,273944
166,chalin,25,0.00913,22975,8.38675,273944
167,felixmulder,25,0.00913,23000,8.39588,273944
168,tony19,25,0.00913,23025,8.40500,273944
169,zamont,25,0.00913,23050,8.41413,273944
170,iamdustan,24,0.00876,23074,8.42289,273944
171,StevenBlack,24,0.00876,23098,8.43165,273944
172,tu4mo,24,0.00876,23122,8.44041,273944
173,chenglou,23,0.00840,23145,8.44881,273944
174,danbev,23,0.00840,23168,8.45720,273944
175,ivanzotov,23,0.00840,23191,8.46560,273944
176,juleskremer,23,0.00840,23214,8.47399,273944
177,satano,23,0.00840,23237,8.48239,273944
178,alfonso-presa,22,0.00803,23259,8.49042,273944
179,axelheer,22,0.00803,23281,8.49845,273944
180,jiayi11,22,0.00803,23303,8.50648,273944
181,mattez,22,0.00803,23325,8.51451,273944
182,mhatvan,22,0.00803,23347,8.52254,273944
183,sarunint,22,0.00803,23369,8.53058,273944
184,vcsjones,22,0.00803,23391,8.53861,273944
185,viktorklang,22,0.00803,23413,8.54664,273944
186,chandanndeep,21,0.00767,23434,8.55430,273944
187,chicoxyzzy,21,0.00767,23455,8.56197,273944
188,ericmartinezr,21,0.00767,23476,8.56963,273944
189,krytarowski,21,0.00767,23497,8.57730,273944
190,philipp-spiess,21,0.00767,23518,8.58497,273944
191,Potapy4,21,0.00767,23539,8.59263,273944
192,SekibOmazic,21,0.00767,23560,8.60030,273944
193,sunn-e,21,0.00767,23581,8.60796,273944
194,timruffles,21,0.00767,23602,8.61563,273944
195,tmorehouse,21,0.00767,23623,8.62330,273944
196,xiaoyinl,21,0.00767,23644,8.63096,273944
197,yungsters,21,0.00767,23665,8.63863,273944
198,bbowyersmyth,20,0.00730,23685,8.64593,273944
199,Drawaes,20,0.00730,23705,8.65323,273944
200,ericmdantas,20,0.00730,23725,8.66053,273944
201,jcblw,20,0.00730,23745,8.66783,273944
202,neilhem,20,0.00730,23765,8.67513,273944
203,OmicronPersei,20,0.00730,23785,8.68243,273944
204,raphamorim,20,0.00730,23805,8.68973,273944
205,scotttrinh,20,0.00730,23825,8.69703,273944
206,sezeresen,20,0.00730,23845,8.70433,273944
207,sjrd,20,0.00730,23865,8.71163,273944
208,willdean,20,0.00730,23885,8.71894,273944
209,719media,19,0.00694,23904,8.72587,273944
210,aickin,19,0.00694,23923,8.73281,273944
211,baooab,19,0.00694,23942,8.73974,273944
212,cebor,19,0.00694,23961,8.74668,273944
213,gionkunz,19,0.00694,23980,8.75361,273944
214,m-alzam,19,0.00694,23999,8.76055,273944
215,marcin-wosinek,19,0.00694,24018,8.76749,273944
216,pdehaan,19,0.00694,24037,8.77442,273944
217,pentp,19,0.00694,24056,8.78136,273944
218,rafaelss95,19,0.00694,24075,8.78829,273944
219,ttowncompiled,19,0.00694,24094,8.79523,273944
220,alexwolfe,18,0.00657,24112,8.80180,273944
221,andreasschroth,18,0.00657,24130,8.80837,273944
222,caesar-chen,18,0.00657,24148,8.81494,273944
223,garhbod,18,0.00657,24166,8.82151,273944
224,jaypinho,18,0.00657,24184,8.82808,273944
225,jeremyvii,18,0.00657,24202,8.83465,273944
226,JustinRChou,18,0.00657,24220,8.84122,273944
227,jvican,18,0.00657,24238,8.84779,273944
228,kadimi,18,0.00657,24256,8.85436,273944
229,kittenking,18,0.00657,24274,8.86094,273944
230,laskoviymishka,18,0.00657,24292,8.86751,273944
231,royklutman,18,0.00657,24310,8.87408,273944
232,sendilkumarn,18,0.00657,24328,8.88065,273944
233,clydin,17,0.00621,24345,8.88685,273944
234,dmjones,17,0.00621,24362,8.89306,273944
235,dota17,17,0.00621,24379,8.89926,273944
236,github-john-doe,17,0.00621,24396,8.90547,273944
237,helmutgranda,17,0.00621,24413,8.91168,273944
238,jbhensley,17,0.00621,24430,8.91788,273944
239,jcouv,17,0.00621,24447,8.92409,273944
240,marocchino,17,0.00621,24464,8.93029,273944
241,matbech,17,0.00621,24481,8.93650,273944
242,mikesherov,17,0.00621,24498,8.94270,273944
243,ochafik,17,0.00621,24515,8.94891,273944
244,piperchester,17,0.00621,24532,8.95511,273944
245,rhenium,17,0.00621,24549,8.96132,273944
246,shuhei,17,0.00621,24566,8.96753,273944
247,sjelin,17,0.00621,24583,8.97373,273944
248,stevermeister,17,0.00621,24600,8.97994,273944
249,syranide,17,0.00621,24617,8.98614,273944
250,tkesgar,17,0.00621,24634,8.99235,273944
251,valorkin,17,0.00621,24651,8.99855,273944
252,arjantijms,16,0.00584,24667,9.00440,273944
253,bastienmoulia,16,0.00584,24683,9.01024,273944
254,bradlygreen,16,0.00584,24699,9.01608,273944
255,chris-smith-zocdoc,16,0.00584,24715,9.02192,273944
256,exoego,16,0.00584,24731,9.02776,273944
257,Goodwine,16,0.00584,24747,9.03360,273944
258,grant-d,16,0.00584,24763,9.03944,273944
259,hoyosjs,16,0.00584,24779,9.04528,273944
260,jackmu95,16,0.00584,24795,9.05112,273944
261,jasonLaster,16,0.00584,24811,9.05696,273944
262,jchawkins725,16,0.00584,24827,9.06280,273944
263,JoseIgor,16,0.00584,24843,9.06864,273944
264,leshasmp,16,0.00584,24859,9.07448,273944
265,lunaruan,16,0.00584,24875,9.08032,273944
266,midzer,16,0.00584,24891,9.08616,273944
267,okazou,16,0.00584,24907,9.09200,273944
268,Puigcerber,16,0.00584,24923,9.09784,273944
269,rdarcy1,16,0.00584,24939,9.10369,273944
270,rxaviers,16,0.00584,24955,9.10953,273944
271,shaneparsons,16,0.00584,24971,9.11537,273944
272,stevehobbsdev,16,0.00584,24987,9.12121,273944
273,TylerBrinkley,16,0.00584,25003,9.12705,273944
274,tylermcginnis,16,0.00584,25019,9.13289,273944
275,vatsan-madhavan,16,0.00584,25035,9.13873,273944
276,vivian-hu,16,0.00584,25051,9.14457,273944
277,wackerm,16,0.00584,25067,9.15041,273944
278,ymeine,16,0.00584,25083,9.15625,273944
279,arvind0598,15,0.00548,25098,9.16173,273944
280,danielsogl,15,0.00548,25113,9.16720,273944
281,dherges,15,0.00548,25128,9.17268,273944
282,drpicox,15,0.00548,25143,9.17815,273944
283,gjungb,15,0.00548,25158,9.18363,273944
284,jahanzaibsuleman07,15,0.00548,25173,9.18910,273944
285,johndoe31415,15,0.00548,25188,9.19458,273944
286,kutyel,15,0.00548,25203,9.20006,273944
287,kvlsrg,15,0.00548,25218,9.20553,273944
288,lacolaco,15,0.00548,25233,9.21101,273944
289,LittleHuba,15,0.00548,25248,9.21648,273944
290,malkomich,15,0.00548,25263,9.22196,273944
291,rheh,15,0.00548,25278,9.22743,273944
292,spacebark,15,0.00548,25293,9.23291,273944
293,Starsam80,15,0.00548,25308,9.23838,273944
294,stevenaw,15,0.00548,25323,9.24386,273944
295,vanillajonathan,15,0.00548,25338,9.24934,273944
296,wenzhixin,15,0.00548,25353,9.25481,273944
297,yuyokk,15,0.00548,25368,9.26029,273944
298,georgewilde,14,0.00511,25382,9.26540,273944
299,hepin1989,14,0.00511,25396,9.27051,273944
300,JaZo,14,0.00511,25410,9.27562,273944
301,juergba,14,0.00511,25424,9.28073,273944
302,jvitela,14,0.00511,25438,9.28584,273944
303,KatherineGShaw,14,0.00511,25452,9.29095,273944
304,kukac7,14,0.00511,25466,9.29606,273944
305,LoicGoyet,14,0.00511,25480,9.30117,273944
306,michaelgeorgeattard,14,0.00511,25494,9.30628,273944
307,mspae,14,0.00511,25508,9.31139,273944
308,nchikanov,14,0.00511,25522,9.31650,273944
309,NikolayPianikov,14,0.00511,25536,9.32161,273944
310,roji,14,0.00511,25550,9.32672,273944
311,spencer1573,14,0.00511,25564,9.33183,273944
312,ssskip,14,0.00511,25578,9.33694,273944
313,vannitotaro,14,0.00511,25592,9.34206,273944
314,x64architecture,14,0.00511,25606,9.34717,273944
315,yangshun,14,0.00511,25620,9.35228,273944
316,yeiacatl,14,0.00511,25634,9.35739,273944
317,adeora,13,0.00475,25647,9.36213,273944
318,alfredmyers,13,0.00475,25660,9.36688,273944
319,atomiomi,13,0.00475,25673,9.37162,273944
320,benbraou,13,0.00475,25686,9.37637,273944
321,BobChao87,13,0.00475,25699,9.38111,273944
322,EasySec,13,0.00475,25712,9.38586,273944
323,guidovranken,13,0.00475,25725,9.39061,273944
324,isaacl,13,0.00475,25738,9.39535,273944
325,jamiekrug,13,0.00475,25751,9.40010,273944
326,jesselpalmer,13,0.00475,25764,9.40484,273944
327,jkotalik,13,0.00475,25777,9.40959,273944
328,JLHwung,13,0.00475,25790,9.41433,273944
329,Kikobeats,13,0.00475,25803,9.41908,273944
330,KostaVlev,13,0.00475,25816,9.42382,273944
331,LeonardoBraga,13,0.00475,25829,9.42857,273944
332,omsmith,13,0.00475,25842,9.43331,273944
333,paulmillr,13,0.00475,25855,9.43806,273944
334,PeteGillin,13,0.00475,25868,9.44281,273944
335,prateekgoel,13,0.00475,25881,9.44755,273944
336,simonihmig,13,0.00475,25894,9.45230,273944
337,splincode,13,0.00475,25907,9.45704,273944
338,sreeramu,13,0.00475,25920,9.46179,273944
339,StringEpsilon,13,0.00475,25933,9.46653,273944
340,tamascsaba,13,0.00475,25946,9.47128,273944
341,TedSander,13,0.00475,25959,9.47602,273944
342,teropa,13,0.00475,25972,9.48077,273944
343,textbook,13,0.00475,25985,9.48552,273944
344,tjvantoll,13,0.00475,25998,9.49026,273944
345,vatsan-madhavan-msft,13,0.00475,26011,9.49501,273944
346,agnosticdev,12,0.00438,26023,9.49939,273944
347,allanrenucci,12,0.00438,26035,9.50377,273944
348,asnowwolf,12,0.00438,26047,9.50815,273944
349,bgw,12,0.00438,26059,9.51253,273944
350,bnjmnt4n,12,0.00438,26071,9.51691,273944
351,brigand,12,0.00438,26083,9.52129,273944
352,craigmichaelmartin,12,0.00438,26095,9.52567,273944
353,dannyskoog,12,0.00438,26107,9.53005,273944
354,dennisdietrich,12,0.00438,26119,9.53443,273944
355,dmytroyarmak,12,0.00438,26131,9.53881,273944
356,ericcarraway,12,0.00438,26143,9.54319,273944
357,escardin,12,0.00438,26155,9.54757,273944
358,FiveTimesTheFun,12,0.00438,26167,9.55195,273944
359,gfoidl,12,0.00438,26179,9.55633,273944
360,heikojansen,12,0.00438,26191,9.56071,273944
361,iamchenxin,12,0.00438,26203,9.56509,273944
362,ikarienator,12,0.00438,26215,9.56947,273944
363,janhenke,12,0.00438,26227,9.57385,273944
364,jrumandal,12,0.00438,26239,9.57823,273944
365,julianobrasil,12,0.00438,26251,9.58262,273944
366,juristr,12,0.00438,26263,9.58700,273944
367,makr,12,0.00438,26275,9.59138,273944
368,MrWolfZ,12,0.00438,26287,9.59576,273944
369,mscdex,12,0.00438,26299,9.60014,273944
370,pickfire,12,0.00438,26311,9.60452,273944
371,romanlex,12,0.00438,26323,9.60890,273944
372,schnittstabil,12,0.00438,26335,9.61328,273944
373,tanmay21,12,0.00438,26347,9.61766,273944
374,Teamop,12,0.00438,26359,9.62204,273944
375,TechDavid,12,0.00438,26371,9.62642,273944
376,tojimjiang,12,0.00438,26383,9.63080,273944
377,vamsivarikuti,12,0.00438,26395,9.63518,273944
378,viktor17492,12,0.00438,26407,9.63956,273944
379,alrra,11,0.00402,26418,9.64358,273944
380,apechimp,11,0.00402,26429,9.64759,273944
381,BeastCode,11,0.00402,26440,9.65161,273944
382,beaugunderson,11,0.00402,26451,9.65562,273944
383,bowenni,11,0.00402,26462,9.65964,273944
384,brenuart,11,0.00402,26473,9.66365,273944
385,CaselIT,11,0.00402,26484,9.66767,273944
386,chrismbarr,11,0.00402,26495,9.67168,273944
387,DaiMichael,11,0.00402,26506,9.67570,273944
388,ejpbruel,11,0.00402,26517,9.67972,273944
389,elidoran,11,0.00402,26528,9.68373,273944
390,geoffbass,11,0.00402,26539,9.68775,273944
391,hazendaz,11,0.00402,26550,9.69176,273944
392,hughsk,11,0.00402,26561,9.69578,273944
393,hzoo,11,0.00402,26572,9.69979,273944
394,is2ei,11,0.00402,26583,9.70381,273944
395,Isthu,11,0.00402,26594,9.70782,273944
396,justsml,11,0.00402,26605,9.71184,273944
397,jutaz,11,0.00402,26616,9.71585,273944
398,juthilo,11,0.00402,26627,9.71987,273944
399,MatiasPuhakka,11,0.00402,26638,9.72389,273944
400,matthewjh,11,0.00402,26649,9.72790,273944
401,maxogden,11,0.00402,26660,9.73192,273944
402,nesinervink,11,0.00402,26671,9.73593,273944
403,nicohvi,11,0.00402,26682,9.73995,273944
404,octref,11,0.00402,26693,9.74396,273944
405,pascal-cuoq,11,0.00402,26704,9.74798,273944
406,philippevk,11,0.00402,26715,9.75199,273944
407,PikadudeNo1,11,0.00402,26726,9.75601,273944
408,rupl,11,0.00402,26737,9.76002,273944
409,shinnn,11,0.00402,26748,9.76404,273944
410,StanislavUshakov,11,0.00402,26759,9.76805,273944
411,wgao19,11,0.00402,26770,9.77207,273944
412,whawker,11,0.00402,26781,9.77609,273944
413,alireza-mh,10,0.00365,26791,9.77974,273944
414,aorinevo,10,0.00365,26801,9.78339,273944
415,atefBB,10,0.00365,26811,9.78704,273944
416,bbolli,10,0.00365,26821,9.79069,273944
417,bertyhell,10,0.00365,26831,9.79434,273944
418,bhamodi,10,0.00365,26841,9.79799,273944
419,bmarkov,10,0.00365,26851,9.80164,273944
420,Bugcheckers,10,0.00365,26861,9.80529,273944
421,catchsudheera,10,0.00365,26871,9.80894,273944
422,cody,10,0.00365,26881,9.81259,273944
423,cyrilletuzi,10,0.00365,26891,9.81624,273944
424,Degubi,10,0.00365,26901,9.81989,273944
425,Dreamescaper,10,0.00365,26911,9.82354,273944
426,drskullster,10,0.00365,26921,9.82719,273944
427,FireAlkazar,10,0.00365,26931,9.83084,273944
428,flyyang,10,0.00365,26941,9.83449,273944
429,fmalcher,10,0.00365,26951,9.83814,273944
430,graveto,10,0.00365,26961,9.84179,273944
431,jamiebuilds,10,0.00365,26971,9.84544,273944
432,jaredly,10,0.00365,26981,9.84909,273944
433,johanlef,10,0.00365,26991,9.85274,273944
434,JohannesHoppe,10,0.00365,27001,9.85639,273944
435,keertip,10,0.00365,27011,9.86004,273944
436,khellang,10,0.00365,27021,9.86369,273944
437,martinsik,10,0.00365,27031,9.86735,273944
438,max-b,10,0.00365,27041,9.87100,273944
439,MaximilianTews,10,0.00365,27051,9.87465,273944
440,MaximLipnin,10,0.00365,27061,9.87830,273944
441,meeque,10,0.00365,27071,9.88195,273944
442,MisatoTremor,10,0.00365,27081,9.88560,273944
443,mojavelinux,10,0.00365,27091,9.88925,273944
444,morrissey-ingenious,10,0.00365,27101,9.89290,273944
445,mpociecha,10,0.00365,27111,9.89655,273944
446,namiltd,10,0.00365,27121,9.90020,273944
447,nattress,10,0.00365,27131,9.90385,273944
448,Pereida,10,0.00365,27141,9.90750,273944
449,pfmooney,10,0.00365,27151,9.91115,273944
450,piotrtomiak,10,0.00365,27161,9.91480,273944
451,PiPeep,10,0.00365,27171,9.91845,273944
452,samjulien,10,0.00365,27181,9.92210,273944
453,simPod,10,0.00365,27191,9.92575,273944
454,the-dwyer,10,0.00365,27201,9.92940,273944
455,urish,10,0.00365,27211,9.93305,273944
456,valery1707,10,0.00365,27221,9.93670,273944
457,vargaz,10,0.00365,27231,9.94035,273944
458,vweevers,10,0.00365,27241,9.94400,273944
459,WilliamCollishaw,10,0.00365,27251,9.94765,273944
460,xcatliu,10,0.00365,27261,9.95130,273944
461,aavmurphy,9,0.00329,27270,9.95459,273944
462,aisera-mikowski,9,0.00329,27279,9.95787,273944
463,AlmeroSteyn,9,0.00329,27288,9.96116,273944
464,angelsanz,9,0.00329,27297,9.96445,273944
465,antonmoiseev,9,0.00329,27306,9.96773,273944
466,bkyarger,9,0.00329,27315,9.97102,273944
467,Borkason,9,0.00329,27324,9.97430,273944
468,boyter,9,0.00329,27333,9.97759,273944
469,bradwestfall,9,0.00329,27342,9.98087,273944
470,Brocco,9,0.00329,27351,9.98416,273944
471,caiquecastro,9,0.00329,27360,9.98744,273944
472,chrisblossom,9,0.00329,27369,9.99073,273944
473,Corbzilla,9,0.00329,27378,9.99401,273944
474,crandmck,9,0.00329,27387,9.99730,273944
475,cscott,9,0.00329,27396,10.00058,273944
476,Delagen,9,0.00329,27405,10.00387,273944
477,denisx,9,0.00329,27414,10.00715,273944
478,dercodercom,9,0.00329,27423,10.01044,273944
479,dulybon1,9,0.00329,27432,10.01373,273944
480,eddiemonge,9,0.00329,27441,10.01701,273944
481,ejball,9,0.00329,27450,10.02030,273944
482,ericnakagawa,9,0.00329,27459,10.02358,273944
483,ExE-Boss,9,0.00329,27468,10.02687,273944
484,EzyHow,9,0.00329,27477,10.03015,273944
485,FezVrasta,9,0.00329,27486,10.03344,273944
486,florisverburg,9,0.00329,27495,10.03672,273944
487,gabrielmaldi,9,0.00329,27504,10.04001,273944
488,Gnbrkm41,9,0.00329,27513,10.04329,273944
489,gricey432,9,0.00329,27522,10.04658,273944
490,hannahhoward,9,0.00329,27531,10.04986,273944
491,H--o-l,9,0.00329,27540,10.05315,273944
492,howardcox,9,0.00329,27549,10.05643,273944
493,hterkelsen,9,0.00329,27558,10.05972,273944
494,ItaloBC,9,0.00329,27567,10.06301,273944
495,jarstelfox,9,0.00329,27576,10.06629,273944
496,jddxf,9,0.00329,27585,10.06958,273944
497,jipexu,9,0.00329,27594,10.07286,273944
498,jmm,9,0.00329,27603,10.07615,273944
499,jorrit,9,0.00329,27612,10.07943,273944
500,julian-hecker,9,0.00329,27621,10.08272,273944
501,kseamon,9,0.00329,27630,10.08600,273944
502,laggingreflex,9,0.00329,27639,10.08929,273944
503,LayZeeDK,9,0.00329,27648,10.09257,273944
504,luhenry,9,0.00329,27657,10.09586,273944
505,MartinKolarik,9,0.00329,27666,10.09914,273944
506,mbehrlich,9,0.00329,27675,10.10243,273944
507,mysticatea,9,0.00329,27684,10.10572,273944
508,nietras,9,0.00329,27693,10.10900,273944
509,noloader,9,0.00329,27702,10.11229,273944
510,oBusk,9,0.00329,27711,10.11557,273944
511,pablocrivella,9,0.00329,27720,10.11886,273944
512,palerdot,9,0.00329,27729,10.12214,273944
513,parammittal16,9,0.00329,27738,10.12543,273944
514,performantdata,9,0.00329,27747,10.12871,273944
515,pixelastic,9,0.00329,27756,10.13200,273944
516,PowerKiKi,9,0.00329,27765,10.13528,273944
517,pravdomil,9,0.00329,27774,10.13857,273944
518,Raynos,9,0.00329,27783,10.14185,273944
519,rickbeerendonk,9,0.00329,27792,10.14514,273944
520,rorygraves,9,0.00329,27801,10.14842,273944
521,Rychu-Pawel,9,0.00329,27810,10.15171,273944
522,sabruss,9,0.00329,27819,10.15500,273944
523,sam1013,9,0.00329,27828,10.15828,273944
524,schwastek,9,0.00329,27837,10.16157,273944
525,shiftylogic,9,0.00329,27846,10.16485,273944
526,SpicyDwarf,9,0.00329,27855,10.16814,273944
527,stakx,9,0.00329,27864,10.17142,273944
528,steelsojka,9,0.00329,27873,10.17471,273944
529,Suresh918,9,0.00329,27882,10.17799,273944
530,thlorenz,9,0.00329,27891,10.18128,273944
531,thymikee,9,0.00329,27900,10.18456,273944
532,tomarak,9,0.00329,27909,10.18785,273944
533,tommcdon,9,0.00329,27918,10.19113,273944
534,triska,9,0.00329,27927,10.19442,273944
535,troydemonbreun,9,0.00329,27936,10.19770,273944
536,vokoshyv,9,0.00329,27945,10.20099,273944
537,vsmenon,9,0.00329,27954,10.20428,273944
538,yasuf,9,0.00329,27963,10.20756,273944
539,Yerkon,9,0.00329,27972,10.21085,273944
540,yiminghe,9,0.00329,27981,10.21413,273944
541,YuliaTsareva,9,0.00329,27990,10.21742,273944
542,zackarychapple,9,0.00329,27999,10.22070,273944
543,zgmnkv,9,0.00329,28008,10.22399,273944
544,zkat,9,0.00329,28017,10.22727,273944
545,abalad,8,0.00292,28025,10.23019,273944
546,abhaynikam,8,0.00292,28033,10.23311,273944
547,aesopwolf,8,0.00292,28041,10.23603,273944
548,agcolom,8,0.00292,28049,10.23895,273944
549,ajcvickers,8,0.00292,28057,10.24187,273944
550,AlbertWillemsen-Centric,8,0.00292,28065,10.24479,273944
551,alcfeoh,8,0.00292,28073,10.24771,273944
552,andrius-pra,8,0.00292,28081,10.25064,273944
553,anenviousguest,8,0.00292,28089,10.25356,273944
554,anjoshigor,8,0.00292,28097,10.25648,273944
555,apetrosian,8,0.00292,28105,10.25940,273944
556,arizzitano,8,0.00292,28113,10.26232,273944
557,awiseman,8,0.00292,28121,10.26524,273944
558,bamnet,8,0.00292,28129,10.26816,273944
559,BBlackwo,8,0.00292,28137,10.27108,273944
560,bernard-lin,8,0.00292,28145,10.27400,273944
561,b-laporte,8,0.00292,28153,10.27692,273944
562,blove,8,0.00292,28161,10.27984,273944
563,brad,8,0.00292,28169,10.28276,273944
564,campersau,8,0.00292,28177,10.28568,273944
565,Chainhelen,8,0.00292,28185,10.28860,273944
566,chrisjlee,8,0.00292,28193,10.29152,273944
567,christophehurpeau,8,0.00292,28201,10.29444,273944
568,copynpaste,8,0.00292,28209,10.29736,273944
569,davidkaya,8,0.00292,28217,10.30028,273944
570,david-lallement,8,0.00292,28225,10.30320,273944
571,david-proctor,8,0.00292,28233,10.30612,273944
572,davidreher,8,0.00292,28241,10.30904,273944
573,dekajp,8,0.00292,28249,10.31196,273944
574,dominykas,8,0.00292,28257,10.31488,273944
575,ennru,8,0.00292,28265,10.31780,273944
576,Fank,8,0.00292,28273,10.32072,273944
577,FuzzySockets,8,0.00292,28281,10.32364,273944
578,galczo5,8,0.00292,28289,10.32656,273944
579,gareth,8,0.00292,28297,10.32948,273944
580,gordonmzhu,8,0.00292,28305,10.33240,273944
581,gregersrygg,8,0.00292,28313,10.33532,273944
582,hkdobrev,8,0.00292,28321,10.33824,273944
583,hpshelton,8,0.00292,28329,10.34116,273944
584,jacob314,8,0.00292,28337,10.34408,273944
585,jainanuj0812,8,0.00292,28345,10.34701,273944
586,janrieke,8,0.00292,28353,10.34993,273944
587,janvanhelvoort,8,0.00292,28361,10.35285,273944
588,jarrettmeyer,8,0.00292,28369,10.35577,273944
589,JasonEtco,8,0.00292,28377,10.35869,273944
590,javatutorials2016,8,0.00292,28385,10.36161,273944
591,jbowtie,8,0.00292,28393,10.36453,273944
592,jisaacks,8,0.00292,28401,10.36745,273944
593,josepot,8,0.00292,28409,10.37037,273944
594,joshudson,8,0.00292,28417,10.37329,273944
595,kchia,8,0.00292,28425,10.37621,273944
596,kdinev,8,0.00292,28433,10.37913,273944
597,keithamus,8,0.00292,28441,10.38205,273944
598,kzys,8,0.00292,28449,10.38497,273944
599,LaurentBarbareau,8,0.00292,28457,10.38789,273944
600,lemmaa,8,0.00292,28465,10.39081,273944
601,loganaden,8,0.00292,28473,10.39373,273944
602,MaggieTsang,8,0.00292,28481,10.39665,273944
603,marcysutton,8,0.00292,28489,10.39957,273944
604,matthewjohnston4,8,0.00292,28497,10.40249,273944
605,mdewree,8,0.00292,28505,10.40541,273944
606,Meligy,8,0.00292,28513,10.40833,273944
607,mitermayer,8,0.00292,28521,10.41125,273944
608,mvastola,8,0.00292,28529,10.41417,273944
609,nakupanda,8,0.00292,28537,10.41709,273944
610,NattyNarwhal,8,0.00292,28545,10.42001,273944
611,null-reference,8,0.00292,28553,10.42293,273944
612,obenbrahim,8,0.00292,28561,10.42585,273944
613,odd,8,0.00292,28569,10.42877,273944
614,Omnichronous,8,0.00292,28577,10.43169,273944
615,operatino,8,0.00292,28585,10.43461,273944
616,paplorinc,8,0.00292,28593,10.43753,273944
617,parjong,8,0.00292,28601,10.44045,273944
618,pgiraud,8,0.00292,28609,10.44338,273944
619,Prithvirajbilla,8,0.00292,28617,10.44630,273944
620,psimyn,8,0.00292,28625,10.44922,273944
621,purezen,8,0.00292,28633,10.45214,273944
622,pwolaq,8,0.00292,28641,10.45506,273944
623,raunofreiberg,8,0.00292,28649,10.45798,273944
624,rickhanlonii,8,0.00292,28657,10.46090,273944
625,RobiFerentz,8,0.00292,28665,10.46382,273944
626,sjurba,8,0.00292,28673,10.46674,273944
627,softchris,8,0.00292,28681,10.46966,273944
628,spectre6000,8,0.00292,28689,10.47258,273944
629,stevezhu,8,0.00292,28697,10.47550,273944
630,sveinpg,8,0.00292,28705,10.47842,273944
631,thanhpd,8,0.00292,28713,10.48134,273944
632,v-afrafi,8,0.00292,28721,10.48426,273944
633,valexiev,8,0.00292,28729,10.48718,273944
634,vdyckn,8,0.00292,28737,10.49010,273944
635,voloda,8,0.00292,28745,10.49302,273944
636,vvakame,8,0.00292,28753,10.49594,273944
637,Xerkus,8,0.00292,28761,10.49886,273944
638,a0viedo,7,0.00256,28768,10.50142,273944
639,aaabramov,7,0.00256,28775,10.50397,273944
640,acidrums4,7,0.00256,28782,10.50653,273944
641,adamdbradley,7,0.00256,28789,10.50908,273944
642,afholderman,7,0.00256,28796,10.51164,273944
643,akolinski,7,0.00256,28803,10.51419,273944
644,alexischr,7,0.00256,28810,10.51675,273944
645,alexzuza,7,0.00256,28817,10.51930,273944
646,alirezamirian,7,0.00256,28824,10.52186,273944
647,alisd23,7,0.00256,28831,10.52441,273944
648,andyklimczak,7,0.00256,28838,10.52697,273944
649,anurse,7,0.00256,28845,10.52952,273944
650,bchavez,7,0.00256,28852,10.53208,273944
651,bpschoch,7,0.00256,28859,10.53463,273944
652,chiraggmodi,7,0.00256,28866,10.53719,273944
653,chocolateboy,7,0.00256,28873,10.53975,273944
654,ChrissBott,7,0.00256,28880,10.54230,273944
655,constructor-igor,7,0.00256,28887,10.54486,273944
656,coolaj86,7,0.00256,28894,10.54741,273944
657,dickwall,7,0.00256,28901,10.54997,273944
658,diego-santacruz,7,0.00256,28908,10.55252,273944
659,DominikTrenz,7,0.00256,28915,10.55508,273944
660,dutchenkoOleg,7,0.00256,28922,10.55763,273944
661,DWand,7,0.00256,28929,10.56019,273944
662,elbywan,7,0.00256,28936,10.56274,273944
663,emilio-martinez,7,0.00256,28943,10.56530,273944
664,endrih,7,0.00256,28950,10.56785,273944
665,felixrabe,7,0.00256,28957,10.57041,273944
666,fpipita,7,0.00256,28964,10.57296,273944
667,FrankiePo,7,0.00256,28971,10.57552,273944
668,FrozenPandaz,7,0.00256,28978,10.57807,273944
669,gbasler,7,0.00256,28985,10.58063,273944
670,gcichosz,7,0.00256,28992,10.58318,273944
671,gijsroge,7,0.00256,28999,10.58574,273944
672,gmethvin,7,0.00256,29006,10.58830,273944
673,graue,7,0.00256,29013,10.59085,273944
674,gucong3000,7,0.00256,29020,10.59341,273944
675,HamsterExAstris,7,0.00256,29027,10.59596,273944
676,hannob,7,0.00256,29034,10.59852,273944
677,Hibernate-CI,7,0.00256,29041,10.60107,273944
678,hubot,7,0.00256,29048,10.60363,273944
679,Ismaile7,7,0.00256,29055,10.60618,273944
680,JaKXz,7,0.00256,29062,10.60874,273944
681,jbduncan,7,0.00256,29069,10.61129,273944
682,JCA122204,7,0.00256,29076,10.61385,273944
683,jedmao,7,0.00256,29083,10.61640,273944
684,jerone,7,0.00256,29090,10.61896,273944
685,jithil-kore,7,0.00256,29097,10.62151,273944
686,jnordberg,7,0.00256,29104,10.62407,273944
687,jodytate,7,0.00256,29111,10.62662,273944
688,joneff,7,0.00256,29118,10.62918,273944
689,jontewks,7,0.00256,29125,10.63173,273944
690,JordyvanDortmont,7,0.00256,29132,10.63429,273944
691,josteink,7,0.00256,29139,10.63685,273944
692,kanielc,7,0.00256,29146,10.63940,273944
693,KELiON,7,0.00256,29153,10.64196,273944
694,Kerumen,7,0.00256,29160,10.64451,273944
695,kevdotbadger,7,0.00256,29167,10.64707,273944
696,KevinJannis,7,0.00256,29174,10.64962,273944
697,laumair,7,0.00256,29181,10.65218,273944
698,lauxjpn,7,0.00256,29188,10.65473,273944
699,lrlna,7,0.00256,29195,10.65729,273944
700,lukaszzdanikowski,7,0.00256,29202,10.65984,273944
701,madmir,7,0.00256,29209,10.66240,273944
702,markgoho,7,0.00256,29216,10.66495,273944
703,MatheusRV,7,0.00256,29223,10.66751,273944
704,matthewdunsdon,7,0.00256,29230,10.67006,273944
705,maxiloc,7,0.00256,29237,10.67262,273944
706,mbroadst,7,0.00256,29244,10.67517,273944
707,michael-letcher,7,0.00256,29251,10.67773,273944
708,Micua,7,0.00256,29258,10.68029,273944
709,mihaerzen,7,0.00256,29265,10.68284,273944
710,mreinstein,7,0.00256,29272,10.68540,273944
711,mrmeku,7,0.00256,29279,10.68795,273944
712,mxstbr,7,0.00256,29286,10.69051,273944
713,nategraf,7,0.00256,29293,10.69306,273944
714,ngyikp,7,0.00256,29300,10.69562,273944
715,nicketson,7,0.00256,29307,10.69817,273944
716,NiklasMehner,7,0.00256,29314,10.70073,273944
717,nunoarruda,7,0.00256,29321,10.70328,273944
718,overlookmotel,7,0.00256,29328,10.70584,273944
719,panchenko,7,0.00256,29335,10.70839,273944
720,philippsimon,7,0.00256,29342,10.71095,273944
721,pkaminski,7,0.00256,29349,10.71350,273944
722,raajtram,7,0.00256,29356,10.71606,273944
723,ReadmeCritic,7,0.00256,29363,10.71861,273944
724,renanmontebelo,7,0.00256,29370,10.72117,273944
725,rricard,7,0.00256,29377,10.72372,273944
726,ruedap,7,0.00256,29384,10.72628,273944
727,SamuelEnglard,7,0.00256,29391,10.72884,273944
728,saucecontrol,7,0.00256,29398,10.73139,273944
729,sean-gilliam,7,0.00256,29405,10.73395,273944
730,sebkur,7,0.00256,29412,10.73650,273944
731,shaedrich,7,0.00256,29419,10.73906,273944
732,skmedix,7,0.00256,29426,10.74161,273944
733,steveluscher,7,0.00256,29433,10.74417,273944
734,Stranger6667,7,0.00256,29440,10.74672,273944
735,suguru03,7,0.00256,29447,10.74928,273944
736,thelgevold,7,0.00256,29454,10.75183,273944
737,tiesont,7,0.00256,29461,10.75439,273944
738,unaccomplished,7,0.00256,29468,10.75694,273944
739,voithos,7,0.00256,29475,10.75950,273944
740,watfordgnf,7,0.00256,29482,10.76205,273944
741,williamboman,7,0.00256,29489,10.76461,273944
742,yui-knk,7,0.00256,29496,10.76716,273944
743,zenorocha,7,0.00256,29503,10.76972,273944
744,zetsnotdead,7,0.00256,29510,10.77227,273944
745,aceofspades,6,0.00219,29516,10.77446,273944
746,adboul,6,0.00219,29522,10.77666,273944
747,addaleax,6,0.00219,29528,10.77885,273944
748,ad-si,6,0.00219,29534,10.78104,273944
749,alexeyraspopov,6,0.00219,29540,10.78323,273944
750,AndreasCag,6,0.00219,29546,10.78542,273944
751,andrewaustin,6,0.00219,29552,10.78761,273944
752,andrewpucci,6,0.00219,29558,10.78980,273944
753,ankitml,6,0.00219,29564,10.79199,273944
754,AnSavvides,6,0.00219,29570,10.79418,273944
755,aravindfz,6,0.00219,29576,10.79637,273944
756,arcanis,6,0.00219,29582,10.79856,273944
757,arjunyel,6,0.00219,29588,10.80075,273944
758,arthurvr,6,0.00219,29594,10.80294,273944
759,asbjornu,6,0.00219,29600,10.80513,273944
760,awerlang,6,0.00219,29606,10.80732,273944
761,bampakoa,6,0.00219,29612,10.80951,273944
762,blackdwarf,6,0.00219,29618,10.81170,273944
763,boneskull,6,0.00219,29624,10.81389,273944
764,Brooooooklyn,6,0.00219,29630,10.81608,273944
765,Castaglia,6,0.00219,29636,10.81827,273944
766,catenacyber,6,0.00219,29642,10.82046,273944
767,ceedubs,6,0.00219,29648,10.82265,273944
768,chenyuzhcy,6,0.00219,29654,10.82484,273944
769,chigix,6,0.00219,29660,10.82703,273944
770,choeller,6,0.00219,29666,10.82922,273944
771,ChrisDahmCS,6,0.00219,29672,10.83141,273944
772,Coeur,6,0.00219,29678,10.83360,273944
773,croaky,6,0.00219,29684,10.83579,273944
774,cscport,6,0.00219,29690,10.83798,273944
775,ctavan,6,0.00219,29696,10.84017,273944
776,Cuel,6,0.00219,29702,10.84236,273944
777,danielrasmuson,6,0.00219,29708,10.84455,273944
778,dejour,6,0.00219,29714,10.84674,273944
779,denisname,6,0.00219,29720,10.84893,273944
780,derekstraka,6,0.00219,29726,10.85112,273944
781,dhoehna,6,0.00219,29732,10.85331,273944
782,donroyco,6,0.00219,29738,10.85550,273944
783,dsbos,6,0.00219,29744,10.85769,273944
784,dustinsoftware,6,0.00219,29750,10.85988,273944
785,eanova,6,0.00219,29756,10.86207,273944
786,EdwinEngelen,6,0.00219,29762,10.86426,273944
787,ekilah,6,0.00219,29768,10.86645,273944
788,erikkemperman,6,0.00219,29774,10.86864,273944
789,FantasticFiasco,6,0.00219,29780,10.87083,273944
790,fiddur,6,0.00219,29786,10.87303,273944
791,flexbox,6,0.00219,29792,10.87522,273944
792,Flounn,6,0.00219,29798,10.87741,273944
793,focusaurus,6,0.00219,29804,10.87960,273944
794,forivall,6,0.00219,29810,10.88179,273944
795,GantMan,6,0.00219,29816,10.88398,273944
796,gary-b,6,0.00219,29822,10.88617,273944
797,GCichosz,6,0.00219,29828,10.88836,273944
798,ghetolay,6,0.00219,29834,10.89055,273944
799,giampierobono,6,0.00219,29840,10.89274,273944
800,Gillespie59,6,0.00219,29846,10.89493,273944
801,gonzalo-roberto-diaz,6,0.00219,29852,10.89712,273944
802,h7lin,6,0.00219,29858,10.89931,273944
803,hanumanthan,6,0.00219,29864,10.90150,273944
804,hartraft,6,0.00219,29870,10.90369,273944
805,heathkit,6,0.00219,29876,10.90588,273944
806,hendore,6,0.00219,29882,10.90807,273944
807,henryw4k,6,0.00219,29888,10.91026,273944
808,HNDeploys,6,0.00219,29894,10.91245,273944
809,Hongbo-Miao,6,0.00219,29900,10.91464,273944
810,hudochenkov,6,0.00219,29906,10.91683,273944
811,IAfanasov,6,0.00219,29912,10.91902,273944
812,iamam34,6,0.00219,29918,10.92121,273944
813,iansu,6,0.00219,29924,10.92340,273944
814,IAPark,6,0.00219,29930,10.92559,273944
815,icambron,6,0.00219,29936,10.92778,273944
816,ikopylov,6,0.00219,29942,10.92997,273944
817,iSazonov,6,0.00219,29948,10.93216,273944
818,Izhaki,6,0.00219,29954,10.93435,273944
819,jabbrass,6,0.00219,29960,10.93654,273944
820,jackson-huang,6,0.00219,29966,10.93873,273944
821,JamesMGreene,6,0.00219,29972,10.94092,273944
822,jannickfahlbusch,6,0.00219,29978,10.94311,273944
823,jasonhodges,6,0.00219,29984,10.94530,273944
824,jfo84,6,0.00219,29990,10.94749,273944
825,jfreyre,6,0.00219,29996,10.94968,273944
826,jnsencha,6,0.00219,30002,10.95187,273944
827,joelmheim,6,0.00219,30008,10.95406,273944
828,JonyD,6,0.00219,30014,10.95625,273944
829,jordan-amman,6,0.00219,30020,10.95844,273944
830,josephlin55555,6,0.00219,30026,10.96063,273944
831,jugglinmike,6,0.00219,30032,10.96282,273944
832,justindujardin,6,0.00219,30038,10.96501,273944
833,KaoruToda,6,0.00219,30044,10.96720,273944
834,kevinoid,6,0.00219,30050,10.96940,273944
835,kibertoad,6,0.00219,30056,10.97159,273944
836,kristinavavrova,6,0.00219,30062,10.97378,273944
837,ksvitkovsky,6,0.00219,30068,10.97597,273944
838,kytart,6,0.00219,30074,10.97816,273944
839,lightningtgc,6,0.00219,30080,10.98035,273944
840,liias,6,0.00219,30086,10.98254,273944
841,lukeapage,6,0.00219,30092,10.98473,273944
842,luqun,6,0.00219,30098,10.98692,273944
843,machineloop,6,0.00219,30104,10.98911,273944
844,madeinfree,6,0.00219,30110,10.99130,273944
845,magee,6,0.00219,30116,10.99349,273944
846,makky3939,6,0.00219,30122,10.99568,273944
847,maksimr,6,0.00219,30128,10.99787,273944
848,manishbansal8843,6,0.00219,30134,11.00006,273944
849,marcosfreitas,6,0.00219,30140,11.00225,273944
850,marcuswarrenca,6,0.00219,30146,11.00444,273944
851,marijaselakovic,6,0.00219,30152,11.00663,273944
852,mattdesl,6,0.00219,30158,11.00882,273944
853,mckramer,6,0.00219,30164,11.01101,273944
854,mcr,6,0.00219,30170,11.01320,273944
855,mernst,6,0.00219,30176,11.01539,273944
856,mertkahyaoglu,6,0.00219,30182,11.01758,273944
857,mhartington,6,0.00219,30188,11.01977,273944
858,MhdTlb,6,0.00219,30194,11.02196,273944
859,mikec,6,0.00219,30200,11.02415,273944
860,MisinformedDNA,6,0.00219,30206,11.02634,273944
861,mjomble,6,0.00219,30212,11.02853,273944
862,monoblaine,6,0.00219,30218,11.03072,273944
863,Morishiri,6,0.00219,30224,11.03291,273944
864,mr21,6,0.00219,30230,11.03510,273944
865,Mr21,6,0.00219,30236,11.03729,273944
866,mrscobbler,6,0.00219,30242,11.03948,273944
867,MTechDE,6,0.00219,30248,11.04167,273944
868,nali,6,0.00219,30254,11.04386,273944
869,nicjansma,6,0.00219,30260,11.04605,273944
870,nik72619c,6,0.00219,30266,11.04824,273944
871,ning-github,6,0.00219,30272,11.05043,273944
872,not-an-aardvark,6,0.00219,30278,11.05262,273944
873,not-for-me,6,0.00219,30284,11.05481,273944
874,novemberborn,6,0.00219,30290,11.05700,273944
875,obinnangini,6,0.00219,30296,11.05919,273944
876,oliversalzburg,6,0.00219,30302,11.06138,273944
877,panva,6,0.00219,30308,11.06358,273944
878,pshields,6,0.00219,30314,11.06577,273944
879,rainerjung,6,0.00219,30320,11.06796,273944
880,raycoll,6,0.00219,30326,11.07015,273944
881,reggi,6,0.00219,30332,11.07234,273944
882,Richienb,6,0.00219,30338,11.07453,273944
883,risan,6,0.00219,30344,11.07672,273944
884,rkatka,6,0.00219,30350,11.07891,273944
885,roblarsen,6,0.00219,30356,11.08110,273944
886,rriggin,6,0.00219,30362,11.08329,273944
887,rtstewart,6,0.00219,30368,11.08548,273944
888,sambitdash,6,0.00219,30374,11.08767,273944
889,sandydoo,6,0.00219,30380,11.08986,273944
890,satsukitv,6,0.00219,30386,11.09205,273944
891,schen381,6,0.00219,30392,11.09424,273944
892,SerayaEryn,6,0.00219,30398,11.09643,273944
893,shefalisinha,6,0.00219,30404,11.09862,273944
894,shime,6,0.00219,30410,11.10081,273944
895,sjbarker,6,0.00219,30416,11.10300,273944
896,skiritsis,6,0.00219,30422,11.10519,273944
897,skreborn,6,0.00219,30428,11.10738,273944
898,snout-o,6,0.00219,30434,11.10957,273944
899,sqal,6,0.00219,30440,11.11176,273944
900,SteveMarquess,6,0.00219,30446,11.11395,273944
901,stevenyxu,6,0.00219,30452,11.11614,273944
902,Suremaker,6,0.00219,30458,11.11833,273944
903,Swardu,6,0.00219,30464,11.12052,273944
904,TanaseHagi,6,0.00219,30470,11.12271,273944
905,TehShrike,6,0.00219,30476,11.12490,273944
906,thekiba,6,0.00219,30482,11.12709,273944
907,thekondrashov,6,0.00219,30488,11.12928,273944
908,theofidry,6,0.00219,30494,11.13147,273944
909,think2011,6,0.00219,30500,11.13366,273944
910,tieppt,6,0.00219,30506,11.13585,273944
911,tjh-omc,6,0.00219,30512,11.13804,273944
912,Tobbe,6,0.00219,30518,11.14023,273944
913,tshinnic,6,0.00219,30524,11.14242,273944
914,victor-homyakov,6,0.00219,30530,11.14461,273944
915,vlazar,6,0.00219,30536,11.14680,273944
916,vsalvis,6,0.00219,30542,11.14899,273944
917,webmaxru,6,0.00219,30548,11.15118,273944
918,wolfika,6,0.00219,30554,11.15337,273944
919,wytesk133,6,0.00219,30560,11.15556,273944
920,xphong,6,0.00219,30566,11.15775,273944
921,yaakov-h,6,0.00219,30572,11.15995,273944
922,YohDeadfall,6,0.00219,30578,11.16214,273944
923,yursha,6,0.00219,30584,11.16433,273944
924,zachleat,6,0.00219,30590,11.16652,273944
925,zackhall,6,0.00219,30596,11.16871,273944
926,zapashcanon,6,0.00219,30602,11.17090,273944
927,Zizzamia,6,0.00219,30608,11.17309,273944
928,A7xSV,5,0.00183,30613,11.17491,273944
929,aaronabramov,5,0.00183,30618,11.17674,273944
930,aashishnagpal,5,0.00183,30623,11.17856,273944
931,ababkov,5,0.00183,30628,11.18039,273944
932,abitdodgy,5,0.00183,30633,11.18221,273944
933,acheevbhagat,5,0.00183,30638,11.18404,273944
934,Agrumas,5,0.00183,30643,11.18586,273944
935,ajfranzoia,5,0.00183,30648,11.18769,273944
936,alaatm,5,0.00183,30653,11.18951,273944
937,alanorth,5,0.00183,30658,11.19134,273944
938,alexandercastillo,5,0.00183,30663,11.19316,273944
939,alexzherdev,5,0.00183,30668,11.19499,273944
940,amitauras,5,0.00183,30673,11.19681,273944
941,amogilev,5,0.00183,30678,11.19864,273944
942,a-moses,5,0.00183,30683,11.20046,273944
943,anantoghosh,5,0.00183,30688,11.20229,273944
944,anatoliykmetyuk,5,0.00183,30693,11.20411,273944
945,anthonylangsworth,5,0.00183,30698,11.20594,273944
946,arechsteiner,5,0.00183,30703,11.20777,273944
947,aTable,5,0.00183,30708,11.20959,273944
948,avindra,5,0.00183,30713,11.21142,273944
949,bborowin,5,0.00183,30718,11.21324,273944
950,bclinkinbeard,5,0.00183,30723,11.21507,273944
951,beeman,5,0.00183,30728,11.21689,273944
952,belugabehr,5,0.00183,30733,11.21872,273944
953,benson-basis,5,0.00183,30738,11.22054,273944
954,binki,5,0.00183,30743,11.22237,273944
955,bukka,5,0.00183,30748,11.22419,273944
956,caleb,5,0.00183,30753,11.22602,273944
957,CassanD,5,0.00183,30758,11.22784,273944
958,CDAGaming,5,0.00183,30763,11.22967,273944
959,cdberry-zz,5,0.00183,30768,11.23149,273944
960,chrisguttandin,5,0.00183,30773,11.23332,273944
961,Chrisui,5,0.00183,30778,11.23514,273944
962,colinwren,5,0.00183,30783,11.23697,273944
963,CompuIves,5,0.00183,30788,11.23879,273944
964,connorwyatt,5,0.00183,30793,11.24062,273944
965,cotequeiroz,5,0.00183,30798,11.24244,273944
966,dancourse,5,0.00183,30803,11.24427,273944
967,dantman,5,0.00183,30808,11.24609,273944
968,dapperAuteur,5,0.00183,30813,11.24792,273944
969,davidlormor,5,0.00183,30818,11.24974,273944
970,dcorb,5,0.00183,30823,11.25157,273944
971,DenrizSusam,5,0.00183,30828,11.25339,273944
972,dguzzo,5,0.00183,30833,11.25522,273944
973,diegomura,5,0.00183,30838,11.25705,273944
974,dkg,5,0.00183,30843,11.25887,273944
975,dmitriz,5,0.00183,30848,11.26070,273944
976,douglasduteil,5,0.00183,30853,11.26252,273944
977,DropsOfSerenity,5,0.00183,30858,11.26435,273944
978,dschenkelman,5,0.00183,30863,11.26617,273944
979,DylanPiercey,5,0.00183,30868,11.26800,273944
980,ehasis,5,0.00183,30873,11.26982,273944
981,eps1lon,5,0.00183,30878,11.27165,273944
982,EtaiG,5,0.00183,30883,11.27347,273944
983,etsuo,5,0.00183,30888,11.27530,273944
984,fat,5,0.00183,30893,11.27712,273944
985,finnhakansson,5,0.00183,30898,11.27895,273944
986,finnigantime,5,0.00183,30903,11.28077,273944
987,fknop,5,0.00183,30908,11.28260,273944
988,foolip,5,0.00183,30913,11.28442,273944
989,froatsnook,5,0.00183,30918,11.28625,273944
990,gabeio,5,0.00183,30923,11.28807,273944
991,garthbjerk,5,0.00183,30928,11.28990,273944
992,garysye,5,0.00183,30933,11.29172,273944
993,ggam,5,0.00183,30938,11.29355,273944
994,ghoti143,5,0.00183,30943,11.29537,273944
995,gillyb,5,0.00183,30948,11.29720,273944
996,gistic-guob,5,0.00183,30953,11.29902,273944
997,gjsduarte,5,0.00183,30958,11.30085,273944
998,glitchedmob,5,0.00183,30963,11.30267,273944
999,gressus,5,0.00183,30968,11.30450,273944
1000,gscoppino,5,0.00183,30973,11.30633,273944
1001,Gupocca,5,0.00183,30978,11.30815,273944
1002,harunurhan,5,0.00183,30983,11.30998,273944
1003,hejld,5,0.00183,30988,11.31180,273944
1004,hiowenluke,5,0.00183,30993,11.31363,273944
1005,hkal,5,0.00183,30998,11.31545,273944
1006,howtonotwin,5,0.00183,31003,11.31728,273944
1007,hristo-kanchev,5,0.00183,31008,11.31910,273944
1008,iangreenleaf,5,0.00183,31013,11.32093,273944
1009,ioanacrant,5,0.00183,31018,11.32275,273944
1010,islemaster,5,0.00183,31023,11.32458,273944
1011,ivanseidel,5,0.00183,31028,11.32640,273944
1012,jahtalab,5,0.00183,31033,11.32823,273944
1013,jakubhonisek,5,0.00183,31038,11.33005,273944
1014,jdanyow,5,0.00183,31043,11.33188,273944
1015,jeffmo,5,0.00183,31048,11.33370,273944
1016,jergason,5,0.00183,31053,11.33553,273944
1017,jfmercer,5,0.00183,31058,11.33735,273944
1018,jianlin,5,0.00183,31063,11.33918,273944
1019,jimdemis,5,0.00183,31068,11.34100,273944
1020,jimgong92,5,0.00183,31073,11.34283,273944
1021,jlennox,5,0.00183,31078,11.34465,273944
1022,jmezach,5,0.00183,31083,11.34648,273944
1023,jodastephen,5,0.00183,31088,11.34830,273944
1024,JoeCortopassi,5,0.00183,31093,11.35013,273944
1025,JoyceBabu,5,0.00183,31098,11.35196,273944
1026,jp2masa,5,0.00183,31103,11.35378,273944
1027,jpekkala,5,0.00183,31108,11.35561,273944
1028,jrpool,5,0.00183,31113,11.35743,273944
1029,jswolf19,5,0.00183,31118,11.35926,273944
1030,jthoms1,5,0.00183,31123,11.36108,273944
1031,ju1ius,5,0.00183,31128,11.36291,273944
1032,kamilogorek,5,0.00183,31133,11.36473,273944
1033,Karql,5,0.00183,31138,11.36656,273944
1034,keeratsingh,5,0.00183,31143,11.36838,273944
1035,KellyMarchewa,5,0.00183,31148,11.37021,273944
1036,Kirlovon,5,0.00183,31153,11.37203,273944
1037,kpdecker,5,0.00183,31158,11.37386,273944
1038,Kramb,5,0.00183,31163,11.37568,273944
1039,krambertech,5,0.00183,31168,11.37751,273944
1040,krzysztof-grzybek,5,0.00183,31173,11.37933,273944
1041,kt3k,5,0.00183,31178,11.38116,273944
1042,KwintenP,5,0.00183,31183,11.38298,273944
1043,kylewuolle,5,0.00183,31188,11.38481,273944
1044,lazarljubenovic,5,0.00183,31193,11.38663,273944
1045,lee101,5,0.00183,31198,11.38846,273944
1046,lgdean,5,0.00183,31203,11.39028,273944
1047,lharries,5,0.00183,31208,11.39211,273944
1048,LitoMore,5,0.00183,31213,11.39393,273944
1049,Lixire,5,0.00183,31218,11.39576,273944
1050,lnfnunes,5,0.00183,31223,11.39758,273944
1051,LongTengDao,5,0.00183,31228,11.39941,273944
1052,louy,5,0.00183,31233,11.40124,273944
1053,lyubomyr-shaydariv,5,0.00183,31238,11.40306,273944
1054,mancha1,5,0.00183,31243,11.40489,273944
1055,manughub,5,0.00183,31248,11.40671,273944
1056,marcuskrahl,5,0.00183,31253,11.40854,273944
1057,markstos,5,0.00183,31258,11.41036,273944
1058,mdedetrich,5,0.00183,31263,11.41219,273944
1059,metamatt,5,0.00183,31268,11.41401,273944
1060,mfairchild365,5,0.00183,31273,11.41584,273944
1061,mhoffmeyerDC,5,0.00183,31278,11.41766,273944
1062,miccarr,5,0.00183,31283,11.41949,273944
1063,michal-franc,5,0.00183,31288,11.42131,273944
1064,middagj,5,0.00183,31293,11.42314,273944
1065,misoguy,5,0.00183,31298,11.42496,273944
1066,mmarkelov,5,0.00183,31303,11.42679,273944
1067,mohsen1,5,0.00183,31308,11.42861,273944
1068,monkeywithacupcake,5,0.00183,31313,11.43044,273944
1069,montogeek,5,0.00183,31318,11.43226,273944
1070,mouse07410,5,0.00183,31323,11.43409,273944
1071,Mutmatt,5,0.00183,31328,11.43591,273944
1072,Nazanin1369,5,0.00183,31333,11.43774,273944
1073,NextTurn,5,0.00183,31338,11.43956,273944
1074,NickManley,5,0.00183,31343,11.44139,273944
1075,nizhu,5,0.00183,31348,11.44321,273944
1076,nmathewson,5,0.00183,31353,11.44504,273944
1077,OberstK,5,0.00183,31358,11.44687,273944
1078,ODAVING,5,0.00183,31363,11.44869,273944
1079,odedniv,5,0.00183,31368,11.45052,273944
1080,omariom,5,0.00183,31373,11.45234,273944
1081,ORESoftware,5,0.00183,31378,11.45417,273944
1082,ovr,5,0.00183,31383,11.45599,273944
1083,owencraig,5,0.00183,31388,11.45782,273944
1084,pahdo,5,0.00183,31393,11.45964,273944
1085,paulceli,5,0.00183,31398,11.46147,273944
1086,planetoftheweb,5,0.00183,31403,11.46329,273944
1087,pluma,5,0.00183,31408,11.46512,273944
1088,pocketmax,5,0.00183,31413,11.46694,273944
1089,potato4d,5,0.00183,31418,11.46877,273944
1090,Pouja,5,0.00183,31423,11.47059,273944
1091,prakal,5,0.00183,31428,11.47242,273944
1092,preethamvishy,5,0.00183,31433,11.47424,273944
1093,Prelc,5,0.00183,31438,11.47607,273944
1094,Progdom,5,0.00183,31443,11.47789,273944
1095,prometheansacrifice,5,0.00183,31448,11.47972,273944
1096,prose100,5,0.00183,31453,11.48154,273944
1097,Pvanhesteren,5,0.00183,31458,11.48337,273944
1098,qsona,5,0.00183,31463,11.48519,273944
1099,rahatarmanahmed,5,0.00183,31468,11.48702,273944
1100,rainabba,5,0.00183,31473,11.48884,273944
1101,randombit,5,0.00183,31478,11.49067,273944
1102,rec,5,0.00183,31483,11.49249,273944
1103,ReneFerwerda,5,0.00183,31488,11.49432,273944
1104,repinel,5,0.00183,31493,11.49615,273944
1105,Retroity,5,0.00183,31498,11.49797,273944
1106,rfoltyns,5,0.00183,31503,11.49980,273944
1107,rilut,5,0.00183,31508,11.50162,273944
1108,rkho,5,0.00183,31513,11.50345,273944
1109,rmzelle,5,0.00183,31518,11.50527,273944
1110,robert-scheck,5,0.00183,31523,11.50710,273944
1111,RobJohnston,5,0.00183,31528,11.50892,273944
1112,roderickhsiao,5,0.00183,31533,11.51075,273944
1113,rodyhaddad,5,0.00183,31538,11.51257,273944
1114,ro-savage,5,0.00183,31543,11.51440,273944
1115,rosskevin,5,0.00183,31548,11.51622,273944
1116,rschmitt,5,0.00183,31553,11.51805,273944
1117,rthor,5,0.00183,31558,11.51987,273944
1118,Rud5G,5,0.00183,31563,11.52170,273944
1119,rwaldron,5,0.00183,31568,11.52352,273944
1120,RyanCavanaugh,5,0.00183,31573,11.52535,273944
1121,samilamti,5,0.00183,31578,11.52717,273944
1122,santialbo,5,0.00183,31583,11.52900,273944
1123,sbomer,5,0.00183,31588,11.53082,273944
1124,scatcher,5,0.00183,31593,11.53265,273944
1125,scop,5,0.00183,31598,11.53447,273944
1126,seppevs,5,0.00183,31603,11.53630,273944
1127,sergej2705,5,0.00183,31608,11.53812,273944
1128,sfuhrm,5,0.00183,31613,11.53995,273944
1129,s-gbz,5,0.00183,31618,11.54177,273944
1130,Shastel,5,0.00183,31623,11.54360,273944
1131,shigeki,5,0.00183,31628,11.54543,273944
1132,sholladay,5,0.00183,31633,11.54725,273944
1133,Sibiraj-Codes,5,0.00183,31638,11.54908,273944
1134,sigmundch,5,0.00183,31643,11.55090,273944
1135,simon-p-r,5,0.00183,31648,11.55273,273944
1136,sis0k0,5,0.00183,31653,11.55455,273944
1137,s-light,5,0.00183,31658,11.55638,273944
1138,socketpair,5,0.00183,31663,11.55820,273944
1139,solomax,5,0.00183,31668,11.56003,273944
1140,steji113,5,0.00183,31673,11.56185,273944
1141,stephenmichaelf,5,0.00183,31678,11.56368,273944
1142,stewx,5,0.00183,31683,11.56550,273944
1143,STRML,5,0.00183,31688,11.56733,273944
1144,stroncium,5,0.00183,31693,11.56915,273944
1145,suryasingh,5,0.00183,31698,11.57098,273944
1146,T1st3,5,0.00183,31703,11.57280,273944
1147,takayahilton,5,0.00183,31708,11.57463,273944
1148,taufek,5,0.00183,31713,11.57645,273944
1149,thefourtheye,5,0.00183,31718,11.57828,273944
1150,TheRealHaui,5,0.00183,31723,11.58010,273944
1151,theseyi,5,0.00183,31728,11.58193,273944
1152,tikotzky,5,0.00183,31733,11.58375,273944
1153,TimurM,5,0.00183,31738,11.58558,273944
1154,tjcelaya,5,0.00183,31743,11.58740,273944
1155,tmurakam,5,0.00183,31748,11.58923,273944
1156,tniessen,5,0.00183,31753,11.59106,273944
1157,tomByrer,5,0.00183,31758,11.59288,273944
1158,TomHoss,5,0.00183,31763,11.59471,273944
1159,trevorade,5,0.00183,31768,11.59653,273944
1160,Tydude4Christ,5,0.00183,31773,11.59836,273944
1161,underfin,5,0.00183,31778,11.60018,273944
1162,Utsav2,5,0.00183,31783,11.60201,273944
1163,venkateshwar,5,0.00183,31788,11.60383,273944
1164,Vibhuti,5,0.00183,31793,11.60566,273944
1165,vinagreti,5,0.00183,31798,11.60748,273944
1166,vjkoskela,5,0.00183,31803,11.60931,273944
1167,wangsai,5,0.00183,31808,11.61113,273944
1168,watadarkstar,5,0.00183,31813,11.61296,273944
1169,wesalvaro,5,0.00183,31818,11.61478,273944
1170,WikiDiscoverer,5,0.00183,31823,11.61661,273944
1171,wolfy1339,5,0.00183,31828,11.61843,273944
1172,wuct,5,0.00183,31833,11.62026,273944
1173,xeno-by,5,0.00183,31838,11.62208,273944
1174,yizhang82,5,0.00183,31843,11.62391,273944
1175,yjaaidi,5,0.00183,31848,11.62573,273944
1176,YonatanKra,5,0.00183,31853,11.62756,273944
1177,Youssef1313,5,0.00183,31858,11.62938,273944
1178,2m,4,0.00146,31862,11.63084,273944
1179,304NotModified,4,0.00146,31866,11.63230,273944
1180,aaron-schmidt,4,0.00146,31870,11.63376,273944
1181,accordeiro,4,0.00146,31874,11.63522,273944
1182,aciccarello,4,0.00146,31878,11.63668,273944
1183,ackratos,4,0.00146,31882,11.63815,273944
1184,adamzerner,4,0.00146,31886,11.63961,273944
1185,AdriVanHoudt,4,0.00146,31890,11.64107,273944
1186,Airblader,4,0.00146,31894,11.64253,273944
1187,ajmohan,4,0.00146,31898,11.64399,273944
1188,ajoslin,4,0.00146,31902,11.64545,273944
1189,alediaferia,4,0.00146,31906,11.64691,273944
1190,alexanderkozlenko,4,0.00146,31910,11.64837,273944
1191,alex-chuev,4,0.00146,31914,11.64983,273944
1192,alexeyr,4,0.00146,31918,11.65129,273944
1193,alexmckenley,4,0.00146,31922,11.65275,273944
1194,alfeg,4,0.00146,31926,11.65421,273944
1195,alnikola,4,0.00146,31930,11.65567,273944
1196,altescape,4,0.00146,31934,11.65713,273944
1197,amasad,4,0.00146,31938,11.65859,273944
1198,ammills01,4,0.00146,31942,11.66005,273944
1199,ampgular,4,0.00146,31946,11.66151,273944
1200,anasqadrei,4,0.00146,31950,11.66297,273944
1201,andalm,4,0.00146,31954,11.66443,273944
1202,AndrusGerman,4,0.00146,31958,11.66589,273944
1203,andykuszyk,4,0.00146,31962,11.66735,273944
1204,andyrooger,4,0.00146,31966,11.66881,273944
1205,anmonteiro,4,0.00146,31970,11.67027,273944
1206,anyong,4,0.00146,31974,11.67173,273944
1207,aortyl,4,0.00146,31978,11.67319,273944
1208,aperala,4,0.00146,31982,11.67465,273944
1209,arkist,4,0.00146,31986,11.67611,273944
1210,aroben,4,0.00146,31990,11.67757,273944
1211,arosenberg01,4,0.00146,31994,11.67903,273944
1212,artkpv,4,0.00146,31998,11.68049,273944
1213,ArtskydJ,4,0.00146,32002,11.68195,273944
1214,ascorbic,4,0.00146,32006,11.68341,273944
1215,audionerd,4,0.00146,32010,11.68487,273944
1216,austinoneil,4,0.00146,32014,11.68633,273944
1217,AustinWise,4,0.00146,32018,11.68779,273944
1218,axe312ger,4,0.00146,32022,11.68925,273944
1219,b3vegan,4,0.00146,32026,11.69071,273944
1220,balbuf,4,0.00146,32030,11.69217,273944
1221,barney2k7,4,0.00146,32034,11.69363,273944
1222,bcran,4,0.00146,32038,11.69509,273944
1223,beatgammit,4,0.00146,32042,11.69655,273944
1224,bel3atar,4,0.00146,32046,11.69801,273944
1225,bembelimen,4,0.00146,32050,11.69947,273944
1226,benmosher,4,0.00146,32054,11.70093,273944
1227,bennetthardwick,4,0.00146,32058,11.70239,273944
1228,bfred-it,4,0.00146,32062,11.70385,273944
1229,bhovhannes,4,0.00146,32066,11.70531,273944
1230,BigGillyStyle,4,0.00146,32070,11.70677,273944
1231,bmeck,4,0.00146,32074,11.70823,273944
1232,Bobeta,4,0.00146,32078,11.70969,273944
1233,boenrobot,4,0.00146,32082,11.71115,273944
1234,booleanbetrayal,4,0.00146,32086,11.71261,273944
1235,Boshen,4,0.00146,32090,11.71407,273944
1236,bradleyprice,4,0.00146,32094,11.71553,273944
1237,brandonhorst,4,0.00146,32098,11.71699,273944
1238,brunocoelho,4,0.00146,32102,11.71845,273944
1239,bsonntag,4,0.00146,32106,11.71991,273944
1240,BTMPL,4,0.00146,32110,11.72137,273944
1241,ca136,4,0.00146,32114,11.72283,273944
1242,cakofony,4,0.00146,32118,11.72429,273944
1243,calamarico,4,0.00146,32122,11.72575,273944
1244,cameronbriar,4,0.00146,32126,11.72721,273944
1245,cameronhunter,4,0.00146,32130,11.72867,273944
1246,camilogiraldo,4,0.00146,32134,11.73013,273944
1247,camsong,4,0.00146,32138,11.73159,273944
1248,cassand,4,0.00146,32142,11.73305,273944
1249,cbrwizard,4,0.00146,32146,11.73452,273944
1250,cburroughs,4,0.00146,32150,11.73598,273944
1251,CDDelta,4,0.00146,32154,11.73744,273944
1252,chainhelen,4,0.00146,32158,11.73890,273944
1253,Charlie-Hua,4,0.00146,32162,11.74036,273944
1254,cheapsteak,4,0.00146,32166,11.74182,273944
1255,chillypepper,4,0.00146,32170,11.74328,273944
1256,chirag64,4,0.00146,32174,11.74474,273944
1257,chrisrowe,4,0.00146,32178,11.74620,273944
1258,christophercurrie,4,0.00146,32182,11.74766,273944
1259,chrootsu,4,0.00146,32186,11.74912,273944
1260,clarkwinkelmann,4,0.00146,32190,11.75058,273944
1261,ClimbsRocks,4,0.00146,32194,11.75204,273944
1262,cloverharvest,4,0.00146,32198,11.75350,273944
1263,cmyers,4,0.00146,32202,11.75496,273944
1264,codeclown,4,0.00146,32206,11.75642,273944
1265,code-tree,4,0.00146,32210,11.75788,273944
1266,cooperka,4,0.00146,32214,11.75934,273944
1267,corsairmarks,4,0.00146,32218,11.76080,273944
1268,cpereida,4,0.00146,32222,11.76226,273944
1269,cRAN-cg,4,0.00146,32226,11.76372,273944
1270,ctaggart,4,0.00146,32230,11.76518,273944
1271,cyan33,4,0.00146,32234,11.76664,273944
1272,DamirAinullin,4,0.00146,32238,11.76810,273944
1273,danielmiller-nl,4,0.00146,32242,11.76956,273944
1274,daviskoh,4,0.00146,32246,11.77102,273944
1275,delgurth,4,0.00146,32250,11.77248,273944
1276,DenisIstomin,4,0.00146,32254,11.77394,273944
1277,dhyey35,4,0.00146,32258,11.77540,273944
1278,dimitrisli,4,0.00146,32262,11.77686,273944
1279,disjukr,4,0.00146,32266,11.77832,273944
1280,dittos,4,0.00146,32270,11.77978,273944
1281,dk14,4,0.00146,32274,11.78124,273944
1282,dkim-95112,4,0.00146,32278,11.78270,273944
1283,dkrugman,4,0.00146,32282,11.78416,273944
1284,dmatteo,4,0.00146,32286,11.78562,273944
1285,doggy8088,4,0.00146,32290,11.78708,273944
1286,donaldpipowitch,4,0.00146,32294,11.78854,273944
1287,don-vip,4,0.00146,32298,11.79000,273944
1288,dotku,4,0.00146,32302,11.79146,273944
1289,dotnetCarpenter,4,0.00146,32306,11.79292,273944
1290,Drake103,4,0.00146,32310,11.79438,273944
1291,drwetter,4,0.00146,32314,11.79584,273944
1292,dtritus,4,0.00146,32318,11.79730,273944
1293,dumb,4,0.00146,32322,11.79876,273944
1294,EddyP23,4,0.00146,32326,11.80022,273944
1295,edg2s,4,0.00146,32330,11.80168,273944
1296,edmundnoble,4,0.00146,32334,11.80314,273944
1297,edthedev,4,0.00146,32338,11.80460,273944
1298,e-hein,4,0.00146,32342,11.80606,273944
1299,eiriksm,4,0.00146,32346,11.80752,273944
1300,eirslett,4,0.00146,32350,11.80898,273944
1301,ejb,4,0.00146,32354,11.81044,273944
1302,ejmartin504,4,0.00146,32358,11.81190,273944
1303,ElanHasson,4,0.00146,32362,11.81336,273944
1304,ElephantRose,4,0.00146,32366,11.81482,273944
1305,ellamaolson,4,0.00146,32370,11.81628,273944
1306,elpintar,4,0.00146,32374,11.81774,273944
1307,elyoh,4,0.00146,32378,11.81920,273944
1308,emlun,4,0.00146,32382,11.82066,273944
1309,EmmanuelDemey,4,0.00146,32386,11.82212,273944
1310,Ephem,4,0.00146,32390,11.82358,273944
1311,erbridge,4,0.00146,32394,11.82504,273944
1312,ErickXavier,4,0.00146,32398,11.82650,273944
1313,ericsakmar,4,0.00146,32402,11.82796,273944
1314,EricTsangX,4,0.00146,32406,11.82942,273944
1315,erik-krogh,4,0.00146,32410,11.83089,273944
1316,erweixin,4,0.00146,32414,11.83235,273944
1317,espiler,4,0.00146,32418,11.83381,273944
1318,EsrefDurna,4,0.00146,32422,11.83527,273944
1319,EvanCarroll,4,0.00146,32426,11.83673,273944
1320,ex1st,4,0.00146,32430,11.83819,273944
1321,exiadbq,4,0.00146,32434,11.83965,273944
1322,exige81,4,0.00146,32438,11.84111,273944
1323,eXon,4,0.00146,32442,11.84257,273944
1324,ExplodingCabbage,4,0.00146,32446,11.84403,273944
1325,ezubarev,4,0.00146,32450,11.84549,273944
1326,fanatid,4,0.00146,32454,11.84695,273944
1327,fbonzon,4,0.00146,32458,11.84841,273944
1328,fealaer,4,0.00146,32462,11.84987,273944
1329,feyzo,4,0.00146,32466,11.85133,273944
1330,ffflorian,4,0.00146,32470,11.85279,273944
1331,fidian,4,0.00146,32474,11.85425,273944
1332,floatdrop,4,0.00146,32478,11.85571,273944
1333,flowersinthesand,4,0.00146,32482,11.85717,273944
1334,fscherwi,4,0.00146,32486,11.85863,273944
1335,furevor,4,0.00146,32490,11.86009,273944
1336,gabriellett,4,0.00146,32494,11.86155,273944
1337,gajus,4,0.00146,32498,11.86301,273944
1338,gberg1,4,0.00146,32502,11.86447,273944
1339,GerHobbelt,4,0.00146,32506,11.86593,273944
1340,get-trucked,4,0.00146,32510,11.86739,273944
1341,ghengeveld,4,0.00146,32514,11.86885,273944
1342,gianpaj,4,0.00146,32518,11.87031,273944
1343,gitanupam,4,0.00146,32522,11.87177,273944
1344,glenjamin,4,0.00146,32526,11.87323,273944
1345,glenr4,4,0.00146,32530,11.87469,273944
1346,gnarf,4,0.00146,32534,11.87615,273944
1347,gonengar,4,0.00146,32538,11.87761,273944
1348,gpolychronisAmadeus,4,0.00146,32542,11.87907,273944
1349,gre,4,0.00146,32546,11.88053,273944
1350,gtzinos,4,0.00146,32550,11.88199,273944
1351,guillaume-brialon,4,0.00146,32554,11.88345,273944
1352,guptasourabh04,4,0.00146,32558,11.88491,273944
1353,gustavohenke,4,0.00146,32562,11.88637,273944
1354,guybedford,4,0.00146,32566,11.88783,273944
1355,GuyMograbi,4,0.00146,32570,11.88929,273944
1356,hahla,4,0.00146,32574,11.89075,273944
1357,hamzaOp,4,0.00146,32578,11.89221,273944
1358,hartzis,4,0.00146,32582,11.89367,273944
1359,hereblur,4,0.00146,32586,11.89513,273944
1360,hildjj,4,0.00146,32590,11.89659,273944
1361,HolgerJeromin,4,0.00146,32594,11.89805,273944
1362,horprogs,4,0.00146,32598,11.89951,273944
1363,horus68,4,0.00146,32602,11.90097,273944
1364,hpawe01,4,0.00146,32606,11.90243,273944
1365,huangw5,4,0.00146,32610,11.90389,273944
1366,huang-x-h,4,0.00146,32614,11.90535,273944
1367,huphtur,4,0.00146,32618,11.90681,273944
1368,Hypnosphi,4,0.00146,32622,11.90827,273944
1369,ianwalter,4,0.00146,32626,11.90973,273944
1370,IdanCo,4,0.00146,32630,11.91119,273944
1371,idearat,4,0.00146,32634,11.91265,273944
1372,ijcheung,4,0.00146,32638,11.91411,273944
1373,iliesaithamouda,4,0.00146,32642,11.91557,273944
1374,IljaDaderko,4,0.00146,32646,11.91703,273944
1375,intellix,4,0.00146,32650,11.91849,273944
1376,istro,4,0.00146,32654,11.91995,273944
1377,itsfadnis,4,0.00146,32658,11.92141,273944
1378,jackcviers,4,0.00146,32662,11.92287,273944
1379,jacklaurencegaray,4,0.00146,32666,11.92433,273944
1380,Jakobo,4,0.00146,32670,11.92580,273944
1381,jalfonso,4,0.00146,32674,11.92726,273944
1382,jamestalmage,4,0.00146,32678,11.92872,273944
1383,janmaterne,4,0.00146,32682,11.93018,273944
1384,jaredpetersen,4,0.00146,32686,11.93164,273944
1385,jasonchoimtt,4,0.00146,32690,11.93310,273944
1386,JayKan,4,0.00146,32694,11.93456,273944
1387,jayphelps,4,0.00146,32698,11.93602,273944
1388,jccarrillo,4,0.00146,32702,11.93748,273944
1389,jeffwesson,4,0.00146,32706,11.93894,273944
1390,jesstelford,4,0.00146,32710,11.94040,273944
1391,jharrilim,4,0.00146,32714,11.94186,273944
1392,jifeon,4,0.00146,32718,11.94332,273944
1393,jkjustjoshing,4,0.00146,32722,11.94478,273944
1394,JLammeer,4,0.00146,32726,11.94624,273944
1395,jmrog,4,0.00146,32730,11.94770,273944
1396,JoanClaret,4,0.00146,32734,11.94916,273944
1397,jodersky,4,0.00146,32738,11.95062,273944
1398,joelbraun,4,0.00146,32742,11.95208,273944
1399,JohnAlbin,4,0.00146,32746,11.95354,273944
1400,JohnAnthony,4,0.00146,32750,11.95500,273944
1401,johnstonbl01,4,0.00146,32754,11.95646,273944
1402,johnz133,4,0.00146,32758,11.95792,273944
1403,JonAbrams,4,0.00146,32762,11.95938,273944
1404,jonhester,4,0.00146,32766,11.96084,273944
1405,jordonias,4,0.00146,32770,11.96230,273944
1406,joshcanhelp,4,0.00146,32774,11.96376,273944
1407,josmaissan,4,0.00146,32778,11.96522,273944
1408,JPeer264,4,0.00146,32782,11.96668,273944
1409,jshen212,4,0.00146,32786,11.96814,273944
1410,jtcrowson,4,0.00146,32790,11.96960,273944
1411,jtorbicki,4,0.00146,32794,11.97106,273944
1412,jurko-gospodnetic,4,0.00146,32798,11.97252,273944
1413,justingrant,4,0.00146,32802,11.97398,273944
1414,jvandemo,4,0.00146,32806,11.97544,273944
1415,karanveersp,4,0.00146,32810,11.97690,273944
1416,katryo,4,0.00146,32814,11.97836,273944
1417,kAworu,4,0.00146,32818,11.97982,273944
1418,kborchers,4,0.00146,32822,11.98128,273944
1419,keheliya,4,0.00146,32826,11.98274,273944
1420,KennySchank,4,0.00146,32830,11.98420,273944
1421,keropodium,4,0.00146,32834,11.98566,273944
1422,ketan-gote,4,0.00146,32838,11.98712,273944
1423,KevinBrogan,4,0.00146,32842,11.98858,273944
1424,kevingosse,4,0.00146,32846,11.99004,273944
1425,kiritsuku,4,0.00146,32850,11.99150,273944
1426,kleinmrk,4,0.00146,32854,11.99296,273944
1427,KonstantinShemyak,4,0.00146,32858,11.99442,273944
1428,Kout,4,0.00146,32862,11.99588,273944
1429,Kovah,4,0.00146,32866,11.99734,273944
1430,koyner,4,0.00146,32870,11.99880,273944
1431,kranrao,4,0.00146,32874,12.00026,273944
1432,krinoid,4,0.00146,32878,12.00172,273944
1433,ktriek,4,0.00146,32882,12.00318,273944
1434,Laisky,4,0.00146,32886,12.00464,273944
1435,lencioni,4,0.00146,32890,12.00610,273944
1436,leppie,4,0.00146,32894,12.00756,273944
1437,lesleh,4,0.00146,32898,12.00902,273944
1438,lextiz,4,0.00146,32902,12.01048,273944
1439,lincolndbryant,4,0.00146,32906,12.01194,273944
1440,lipis,4,0.00146,32910,12.01340,273944
1441,lirantal,4,0.00146,32914,12.01486,273944
1442,livvielin,4,0.00146,32918,12.01632,273944
1443,LizaLemons,4,0.00146,32922,12.01778,273944
1444,lkts,4,0.00146,32926,12.01924,273944
1445,logeshpaul,4,0.00146,32930,12.02070,273944
1446,lpage,4,0.00146,32934,12.02217,273944
1447,luckylooke,4,0.00146,32938,12.02363,273944
1448,lugovsky,4,0.00146,32942,12.02509,273944
1449,luixaviles,4,0.00146,32946,12.02655,273944
1450,LukasDrgon,4,0.00146,32950,12.02801,273944
1451,lukaselmer,4,0.00146,32954,12.02947,273944
1452,lukasoppermann,4,0.00146,32958,12.03093,273944
1453,lundmikkel,4,0.00146,32962,12.03239,273944
1454,m0mus,4,0.00146,32966,12.03385,273944
1455,maciej-ka,4,0.00146,32970,12.03531,273944
1456,maciej-kolodziejczak,4,0.00146,32974,12.03677,273944
1457,maisano,4,0.00146,32978,12.03823,273944
1458,MarceloAlves,4,0.00146,32982,12.03969,273944
1459,marciovicente,4,0.00146,32986,12.04115,273944
1460,marclr,4,0.00146,32990,12.04261,273944
1461,marianoc84,4,0.00146,32994,12.04407,273944
1462,MarkDacek,4,0.00146,32998,12.04553,273944
1463,martin-frydl,4,0.00146,33002,12.04699,273944
1464,marvinhagemeister,4,0.00146,33006,12.04845,273944
1465,Mathou54,4,0.00146,33010,12.04991,273944
1466,matiassingers,4,0.00146,33014,12.05137,273944
1467,mattbrundage,4,0.00146,33018,12.05283,273944
1468,mattcollier,4,0.00146,33022,12.05429,273944
1469,mauricew,4,0.00146,33026,12.05575,273944
1470,maurya777,4,0.00146,33030,12.05721,273944
1471,maxdeviant,4,0.00146,33034,12.05867,273944
1472,mazong1123,4,0.00146,33038,12.06013,273944
1473,mbeaudru,4,0.00146,33042,12.06159,273944
1474,mcasasola,4,0.00146,33046,12.06305,273944
1475,mcculley,4,0.00146,33050,12.06451,273944
1476,mcknell,4,0.00146,33054,12.06597,273944
1477,medinarkhov,4,0.00146,33058,12.06743,273944
1478,mfollett,4,0.00146,33062,12.06889,273944
1479,mfunkie,4,0.00146,33066,12.07035,273944
1480,mgiambalvo,4,0.00146,33070,12.07181,273944
1481,michaelchiche,4,0.00146,33074,12.07327,273944
1482,mikedn,4,0.00146,33078,12.07473,273944
1483,millermedeiros,4,0.00146,33082,12.07619,273944
1484,mingtaoy,4,0.00146,33086,12.07765,273944
1485,mirabilos,4,0.00146,33090,12.07911,273944
1486,miromannino,4,0.00146,33094,12.08057,273944
1487,mischkl,4,0.00146,33098,12.08203,273944
1488,mitenka,4,0.00146,33102,12.08349,273944
1489,mkroeders,4,0.00146,33106,12.08495,273944
1490,monkpit,4,0.00146,33110,12.08641,273944
1491,morenoh149,4,0.00146,33114,12.08787,273944
1492,morrissinger,4,0.00146,33118,12.08933,273944
1493,mortonfox,4,0.00146,33122,12.09079,273944
1494,mpeyper,4,0.00146,33126,12.09225,273944
1495,mrcoles,4,0.00146,33130,12.09371,273944
1496,m-sp,4,0.00146,33134,12.09517,273944
1497,mucer,4,0.00146,33138,12.09663,273944
1498,myarcane,4,0.00146,33142,12.09809,273944
1499,MylesBorins,4,0.00146,33146,12.09955,273944
1500,nahakiole,4,0.00146,33150,12.10101,273944
1501,Nargonath,4,0.00146,33154,12.10247,273944
1502,nathanhammond,4,0.00146,33158,12.10393,273944
1503,nazieb,4,0.00146,33162,12.10539,273944
1504,nbauernfeind,4,0.00146,33166,12.10685,273944
1505,netman92,4,0.00146,33170,12.10831,273944
1506,nhashmi,4,0.00146,33174,12.10977,273944
1507,nickmccurdy,4,0.00146,33178,12.11123,273944
1508,nicktobolski,4,0.00146,33182,12.11269,273944
1509,nickvdyck,4,0.00146,33186,12.11415,273944
1510,nicmitchell,4,0.00146,33190,12.11561,273944
1511,nicolevy,4,0.00146,33194,12.11708,273944
1512,Nikita240,4,0.00146,33198,12.11854,273944
1513,nisha-kaushik,4,0.00146,33202,12.12000,273944
1514,niteshthakur,4,0.00146,33206,12.12146,273944
1515,nooks,4,0.00146,33210,12.12292,273944
1516,nording,4,0.00146,33214,12.12438,273944
1517,norek,4,0.00146,33218,12.12584,273944
1518,nowells,4,0.00146,33222,12.12730,273944
1519,nsfmc,4,0.00146,33226,12.12876,273944
1520,ntwb,4,0.00146,33230,12.13022,273944
1521,ntzm,4,0.00146,33234,12.13168,273944
1522,nwoltman,4,0.00146,33238,12.13314,273944
1523,odahcam,4,0.00146,33242,12.13460,273944
1524,oemmes,4,0.00146,33246,12.13606,273944
1525,oGsLP,4,0.00146,33250,12.13752,273944
1526,oheger,4,0.00146,33254,12.13898,273944
1527,oti,4,0.00146,33258,12.14044,273944
1528,OwnageIsMagic,4,0.00146,33262,12.14190,273944
1529,pandualuvala,4,0.00146,33266,12.14336,273944
1530,pascalduez,4,0.00146,33270,12.14482,273944
1531,passcod,4,0.00146,33274,12.14628,273944
1532,patrixd,4,0.00146,33278,12.14774,273944
1533,paulfalgout,4,0.00146,33282,12.14920,273944
1534,pbr1111,4,0.00146,33286,12.15066,273944
1535,perrin4869,4,0.00146,33290,12.15212,273944
1536,petedmarsh,4,0.00146,33294,12.15358,273944
1537,peterneave,4,0.00146,33298,12.15504,273944
1538,petersalomonsen,4,0.00146,33302,12.15650,273944
1539,philBrown,4,0.00146,33306,12.15796,273944
1540,pholly,4,0.00146,33310,12.15942,273944
1541,pixelbandito,4,0.00146,33314,12.16088,273944
1542,poke,4,0.00146,33318,12.16234,273944
1543,pomber,4,0.00146,33322,12.16380,273944
1544,poxrud,4,0.00146,33326,12.16526,273944
1545,prog1dev,4,0.00146,33330,12.16672,273944
1546,qiuyuntao,4,0.00146,33334,12.16818,273944
1547,qiyigg,4,0.00146,33338,12.16964,273944
1548,Queeniebee,4,0.00146,33342,12.17110,273944
1549,QWp6t,4,0.00146,33346,12.17256,273944
1550,RaghavRamesh,4,0.00146,33350,12.17402,273944
1551,RaphStein,4,0.00146,33354,12.17548,273944
1552,redbmk,4,0.00146,33358,12.17694,273944
1553,remal,4,0.00146,33362,12.17840,273944
1554,rgksugan,4,0.00146,33366,12.17986,273944
1555,RhinoLu,4,0.00146,33370,12.18132,273944
1556,rictorres,4,0.00146,33374,12.18278,273944
1557,riichard,4,0.00146,33378,12.18424,273944
1558,riren,4,0.00146,33382,12.18570,273944
1559,rishabhjain,4,0.00146,33386,12.18716,273944
1560,rlindner81,4,0.00146,33390,12.18862,273944
1561,rluba,4,0.00146,33394,12.19008,273944
1562,robinj,4,0.00146,33398,12.19154,273944
1563,robtimus,4,0.00146,33402,12.19300,273944
1564,rparrapy,4,0.00146,33406,12.19446,273944
1565,rphv,4,0.00146,33410,12.19592,273944
1566,rPraml,4,0.00146,33414,12.19738,273944
1567,rrsivabalan,4,0.00146,33418,12.19884,273944
1568,rtack,4,0.00146,33422,12.20030,273944
1569,RudarDaman,4,0.00146,33426,12.20176,273944
1570,ruoho,4,0.00146,33430,12.20322,273944
1571,rwg,4,0.00146,33434,12.20468,273944
1572,ryanhart2,4,0.00146,33438,12.20614,273944
1573,sahrens,4,0.00146,33442,12.20760,273944
1574,salamanderrex,4,0.00146,33446,12.20906,273944
1575,SanderElias,4,0.00146,33450,12.21052,273944
1576,SaptakS,4,0.00146,33454,12.21198,273944
1577,sathify,4,0.00146,33458,12.21345,273944
1578,scheglov,4,0.00146,33462,12.21491,273944
1579,scloudyy,4,0.00146,33466,12.21637,273944
1580,scottaddie,4,0.00146,33470,12.21783,273944
1581,scottpetrovic,4,0.00146,33474,12.21929,273944
1582,secrettriangle,4,0.00146,33478,12.22075,273944
1583,selbekk,4,0.00146,33482,12.22221,273944
1584,semenyakNik,4,0.00146,33486,12.22367,273944
1585,serima,4,0.00146,33490,12.22513,273944
1586,sevdog,4,0.00146,33494,12.22659,273944
1587,sh0hei,4,0.00146,33498,12.22805,273944
1588,shairez,4,0.00146,33502,12.22951,273944
1589,shlomiassaf,4,0.00146,33506,12.23097,273944
1590,Shrulik,4,0.00146,33510,12.23243,273944
1591,sijanmilan,4,0.00146,33514,12.23389,273944
1592,simon04,4,0.00146,33518,12.23535,273944
1593,simoneb,4,0.00146,33522,12.23681,273944
1594,sjsyrek,4,0.00146,33526,12.23827,273944
1595,Skasi,4,0.00146,33530,12.23973,273944
1596,SlimFoster,4,0.00146,33534,12.24119,273944
1597,snehalbaghel,4,0.00146,33538,12.24265,273944
1598,souvikbasu,4,0.00146,33542,12.24411,273944
1599,sp00m,4,0.00146,33546,12.24557,273944
1600,splendido,4,0.00146,33550,12.24703,273944
1601,spoonraker,4,0.00146,33554,12.24849,273944
1602,stefanpenner,4,0.00146,33558,12.24995,273944
1603,stephaniekendall,4,0.00146,33562,12.25141,273944
1604,stoeckmann,4,0.00146,33566,12.25287,273944
1605,Strikeskids,4,0.00146,33570,12.25433,273944
1606,strogonoff,4,0.00146,33574,12.25579,273944
1607,styfle,4,0.00146,33578,12.25725,273944
1608,svershin,4,0.00146,33582,12.25871,273944
1609,SyntaxRules,4,0.00146,33586,12.26017,273944
1610,tae-jun,4,0.00146,33590,12.26163,273944
1611,tagyoureit,4,0.00146,33594,12.26309,273944
1612,taion,4,0.00146,33598,12.26455,273944
1613,tako-black,4,0.00146,33602,12.26601,273944
1614,tama3bb,4,0.00146,33606,12.26747,273944
1615,tavianator,4,0.00146,33610,12.26893,273944
1616,tekwiz,4,0.00146,33614,12.27039,273944
1617,teppeis,4,0.00146,33618,12.27185,273944
1618,thatType,4,0.00146,33622,12.27331,273944
1619,thedeco,4,0.00146,33626,12.27477,273944
1620,TheRealMaxion,4,0.00146,33630,12.27623,273944
1621,Therzok,4,0.00146,33634,12.27769,273944
1622,thinegod,4,0.00146,33638,12.27915,273944
1623,thirdcreed,4,0.00146,33642,12.28061,273944
1624,thomaslevesque,4,0.00146,33646,12.28207,273944
1625,timandy,4,0.00146,33650,12.28353,273944
1626,timvdalen,4,0.00146,33654,12.28499,273944
1627,toastynerd,4,0.00146,33658,12.28645,273944
1628,tobiasschweizer,4,0.00146,33662,12.28791,273944
1629,toebu,4,0.00146,33666,12.28937,273944
1630,tolbertam,4,0.00146,33670,12.29083,273944
1631,TomasMikula,4,0.00146,33674,12.29229,273944
1632,tomastrajan,4,0.00146,33678,12.29375,273944
1633,tom-dudley,4,0.00146,33682,12.29521,273944
1634,tomlutzenberger,4,0.00146,33686,12.29667,273944
1635,tomscholz,4,0.00146,33690,12.29813,273944
1636,tonyspb,4,0.00146,33694,12.29959,273944
1637,TornjV,4,0.00146,33698,12.30105,273944
1638,tpoulos,4,0.00146,33702,12.30251,273944
1639,trevhud,4,0.00146,33706,12.30397,273944
1640,TruePath,4,0.00146,33710,12.30543,273944
1641,tsriram,4,0.00146,33714,12.30689,273944
1642,tsuyoshizawa,4,0.00146,33718,12.30835,273944
1643,tupini07,4,0.00146,33722,12.30982,273944
1644,tvanro,4,0.00146,33726,12.31128,273944
1645,tycho01,4,0.00146,33730,12.31274,273944
1646,tyrasd,4,0.00146,33734,12.31420,273944
1647,UCIS,4,0.00146,33738,12.31566,273944
1648,ulitink,4,0.00146,33742,12.31712,273944
1649,verhas,4,0.00146,33746,12.31858,273944
1650,vincent4j,4,0.00146,33750,12.32004,273944
1651,VincentLanglet,4,0.00146,33754,12.32150,273944
1652,vincentriemer,4,0.00146,33758,12.32296,273944
1653,vincent-zurczak,4,0.00146,33762,12.32442,273944
1654,vipulnsward,4,0.00146,33766,12.32588,273944
1655,VishvajitP,4,0.00146,33770,12.32734,273944
1656,vovchik-manko,4,0.00146,33774,12.32880,273944
1657,vthinkxie,4,0.00146,33778,12.33026,273944
1658,walrusfruitcake,4,0.00146,33782,12.33172,273944
1659,web-dave,4,0.00146,33786,12.33318,273944
1660,wibisono,4,0.00146,33790,12.33464,273944
1661,Wildhoney,4,0.00146,33794,12.33610,273944
1662,wiseleo,4,0.00146,33798,12.33756,273944
1663,WORMSS,4,0.00146,33802,12.33902,273944
1664,WreckItRalph,4,0.00146,33806,12.34048,273944
1665,wtgtybhertgeghgtwtg,4,0.00146,33810,12.34194,273944
1666,xemdetia,4,0.00146,33814,12.34340,273944
1667,xieranmaya,4,0.00146,33818,12.34486,273944
1668,xjlim,4,0.00146,33822,12.34632,273944
1669,xjose97x,4,0.00146,33826,12.34778,273944
1670,xkxx,4,0.00146,33830,12.34924,273944
1671,xp44mm,4,0.00146,33834,12.35070,273944
1672,xt0rted,4,0.00146,33838,12.35216,273944
1673,yankee42,4,0.00146,33842,12.35362,273944
1674,younesfkihi,4,0.00146,33846,12.35508,273944
1675,YoupHulsebos,4,0.00146,33850,12.35654,273944
1676,zacharywelch,4,0.00146,33854,12.35800,273944
1677,zainengineer,4,0.00146,33858,12.35946,273944
1678,zawiasam,4,0.00146,33862,12.36092,273944
1679,zaytsev-victor,4,0.00146,33866,12.36238,273944
1680,Zearin,4,0.00146,33870,12.36384,273944
1681,Zenexer,4,0.00146,33874,12.36530,273944
1682,zky829,4,0.00146,33878,12.36676,273944
1683,zoechi,4,0.00146,33882,12.36822,273944
1684,zuzusik,4,0.00146,33886,12.36968,273944
1685,102,3,0.00110,33889,12.37078,273944
1686,4creators,3,0.00110,33892,12.37187,273944
1687,9thQuadrant,3,0.00110,33895,12.37297,273944
1688,aarongarciah,3,0.00110,33898,12.37406,273944
1689,aaronhoffman,3,0.00110,33901,12.37516,273944
1690,AbhiAgarwal192,3,0.00110,33904,12.37625,273944
1691,abhisheksoni27,3,0.00110,33907,12.37735,273944
1692,adampoit,3,0.00110,33910,12.37844,273944
1693,adamski52,3,0.00110,33913,12.37954,273944
1694,admosity,3,0.00110,33916,12.38063,273944
1695,Adol1111,3,0.00110,33919,12.38173,273944
1696,adriangodong,3,0.00110,33922,12.38282,273944
1697,AdrianVollmer,3,0.00110,33925,12.38392,273944
1698,adrienboulle,3,0.00110,33928,12.38501,273944
1699,adrogon,3,0.00110,33931,12.38611,273944
1700,aeons,3,0.00110,33934,12.38720,273944
1701,agussman,3,0.00110,33937,12.38830,273944
1702,ahmadawais,3,0.00110,33940,12.38939,273944
1703,ahoefling,3,0.00110,33943,12.39049,273944
1704,ajaygm,3,0.00110,33946,12.39158,273944
1705,ajcrites,3,0.00110,33949,12.39268,273944
1706,ajuliano,3,0.00110,33952,12.39377,273944
1707,AlanBreck,3,0.00110,33955,12.39487,273944
1708,alberto,3,0.00110,33958,12.39596,273944
1709,albertogarza,3,0.00110,33961,12.39706,273944
1710,albertosantini,3,0.00110,33964,12.39815,273944
1711,aldermoovel,3,0.00110,33967,12.39925,273944
1712,alesma,3,0.00110,33970,12.40034,273944
1713,alewiahmed,3,0.00110,33973,12.40144,273944
1714,alexcastillo,3,0.00110,33976,12.40253,273944
1715,AlexejLiebenthal,3,0.00110,33979,12.40363,273944
1716,Alexx999,3,0.00110,33982,12.40473,273944
1717,AlgorithmsAreCool,3,0.00110,33985,12.40582,273944
1718,Alhadis,3,0.00110,33988,12.40692,273944
1719,alimemonzx,3,0.00110,33991,12.40801,273944
1720,alobban,3,0.00110,33994,12.40911,273944
1721,alvarocjunq,3,0.00110,33997,12.41020,273944
1722,amanvir,3,0.00110,34000,12.41130,273944
1723,ameya-pandilwar,3,0.00110,34003,12.41239,273944
1724,amitport,3,0.00110,34006,12.41349,273944
1725,andresgottlieb,3,0.00110,34009,12.41458,273944
1726,AndreyAkinshin,3,0.00110,34012,12.41568,273944
1727,andreyjkee,3,0.00110,34015,12.41677,273944
1728,anhulife,3,0.00110,34018,12.41787,273944
1729,anmary,3,0.00110,34021,12.41896,273944
1730,annefernandez3,3,0.00110,34024,12.42006,273944
1731,annevk,3,0.00110,34027,12.42115,273944
1732,AnnieYousar,3,0.00110,34030,12.42225,273944
1733,antialias,3,0.00110,34033,12.42334,273944
1734,AntonLandor,3,0.00110,34036,12.42444,273944
1735,antsmartian,3,0.00110,34039,12.42553,273944
1736,anushreesubramani,3,0.00110,34042,12.42663,273944
1737,apocalyp0sys,3,0.00110,34045,12.42772,273944
1738,apushak,3,0.00110,34048,12.42882,273944
1739,aquavitae,3,0.00110,34051,12.42991,273944
1740,ara4n,3,0.00110,34054,12.43101,273944
1741,ardentia,3,0.00110,34057,12.43210,273944
1742,aretecode,3,0.00110,34060,12.43320,273944
1743,arnehoek,3,0.00110,34063,12.43429,273944
1744,artem-galas,3,0.00110,34066,12.43539,273944
1745,arthurpf,3,0.00110,34069,12.43648,273944
1746,arunkarthicksr,3,0.00110,34072,12.43758,273944
1747,asafdav2,3,0.00110,34075,12.43867,273944
1748,aschlapsi,3,0.00110,34078,12.43977,273944
1749,AScriver,3,0.00110,34081,12.44086,273944
1750,ashfahan,3,0.00110,34084,12.44196,273944
1751,AshKyd,3,0.00110,34087,12.44305,273944
1752,askpt,3,0.00110,34090,12.44415,273944
1753,atenhar,3,0.00110,34093,12.44524,273944
1754,Atuuh,3,0.00110,34096,12.44634,273944
1755,AurelioDeRosa,3,0.00110,34099,12.44743,273944
1756,azhmur,3,0.00110,34102,12.44853,273944
1757,bamblack,3,0.00110,34105,12.44962,273944
1758,barryceelen,3,0.00110,34108,12.45072,273944
1759,bartw,3,0.00110,34111,12.45181,273944
1760,basarat,3,0.00110,34114,12.45291,273944
1761,bcarson,3,0.00110,34117,12.45401,273944
1762,bcomnes,3,0.00110,34120,12.45510,273944
1763,bdhess,3,0.00110,34123,12.45620,273944
1764,bear101,3,0.00110,34126,12.45729,273944
1765,bedag-moo,3,0.00110,34129,12.45839,273944
1766,beegotsy,3,0.00110,34132,12.45948,273944
1767,ben4ever,3,0.00110,34135,12.46058,273944
1768,benbot1,3,0.00110,34138,12.46167,273944
1769,benjamn,3,0.00110,34141,12.46277,273944
1770,bergus,3,0.00110,34144,12.46386,273944
1771,bernardogfilho,3,0.00110,34147,12.46496,273944
1772,BernhardRode,3,0.00110,34150,12.46605,273944
1773,bgirard,3,0.00110,34153,12.46715,273944
1774,bhanuprasad14,3,0.00110,34156,12.46824,273944
1775,Bil0,3,0.00110,34159,12.46934,273944
1776,BioPhoton,3,0.00110,34162,12.47043,273944
1777,bisguzar,3,0.00110,34165,12.47153,273944
1778,bisubus,3,0.00110,34168,12.47262,273944
1779,bjwyse,3,0.00110,34171,12.47372,273944
1780,blackwright,3,0.00110,34174,12.47481,273944
1781,blahDL,3,0.00110,34177,12.47591,273944
1782,Blakenator,3,0.00110,34180,12.47700,273944
1783,BlockLabTV,3,0.00110,34183,12.47810,273944
1784,blowsie,3,0.00110,34186,12.47919,273944
1785,bluelovers,3,0.00110,34189,12.48029,273944
1786,bovandersteene,3,0.00110,34192,12.48138,273944
1787,bperel,3,0.00110,34195,12.48248,273944
1788,BraulioVM,3,0.00110,34198,12.48357,273944
1789,brejcham,3,0.00110,34201,12.48467,273944
1790,briancherin,3,0.00110,34204,12.48576,273944
1791,brianpchsu,3,0.00110,34207,12.48686,273944
1792,brikou,3,0.00110,34210,12.48795,273944
1793,brillout,3,0.00110,34213,12.48905,273944
1794,BrockBeaudry,3,0.00110,34216,12.49014,273944
1795,browner12,3,0.00110,34219,12.49124,273944
1796,bryanbraun,3,0.00110,34222,12.49233,273944
1797,brycehanscomb,3,0.00110,34225,12.49343,273944
1798,bsdfzzzy,3,0.00110,34228,12.49452,273944
1799,btrigueiro,3,0.00110,34231,12.49562,273944
1800,cacamille3,3,0.00110,34234,12.49671,273944
1801,calebcauthon,3,0.00110,34237,12.49781,273944
1802,calendee,3,0.00110,34240,12.49890,273944
1803,callumlocke,3,0.00110,34243,12.50000,273944
1804,camilleroux,3,0.00110,34246,12.50110,273944
1805,camjc,3,0.00110,34249,12.50219,273944
1806,camsteffen,3,0.00110,34252,12.50329,273944
1807,CarlMungazi,3,0.00110,34255,12.50438,273944
1808,carsonyl,3,0.00110,34258,12.50548,273944
1809,caseyscarborough,3,0.00110,34261,12.50657,273944
1810,catalint,3,0.00110,34264,12.50767,273944
1811,cbrandolino,3,0.00110,34267,12.50876,273944
1812,cchungmin,3,0.00110,34270,12.50986,273944
1813,cchyung,3,0.00110,34273,12.51095,273944
1814,cdschroeder,3,0.00110,34276,12.51205,273944
1815,centromere,3,0.00110,34279,12.51314,273944
1816,cgav,3,0.00110,34282,12.51424,273944
1817,chauey,3,0.00110,34285,12.51533,273944
1818,ChrisAntaki,3,0.00110,34288,12.51643,273944
1819,ChristianGrete,3,0.00110,34291,12.51752,273944
1820,cht8687,3,0.00110,34294,12.51862,273944
1821,ciderale,3,0.00110,34297,12.51971,273944
1822,cirosantilli,3,0.00110,34300,12.52081,273944
1823,clarkdo,3,0.00110,34303,12.52190,273944
1824,clarkis117,3,0.00110,34306,12.52300,273944
1825,clearyusc,3,0.00110,34309,12.52409,273944
1826,cloudy1,3,0.00110,34312,12.52519,273944
1827,Cludch,3,0.00110,34315,12.52628,273944
1828,cmckni3,3,0.00110,34318,12.52738,273944
1829,cmfcmf,3,0.00110,34321,12.52847,273944
1830,cmsdkfz,3,0.00110,34324,12.52957,273944
1831,codediodeio,3,0.00110,34327,12.53066,273944
1832,colinmorelli,3,0.00110,34330,12.53176,273944
1833,colltoaction,3,0.00110,34333,12.53285,273944
1834,comerc,3,0.00110,34336,12.53395,273944
1835,ConnorAtherton,3,0.00110,34339,12.53504,273944
1836,contextshuffling,3,0.00110,34342,12.53614,273944
1837,cooljeffro,3,0.00110,34345,12.53723,273944
1838,coryjb,3,0.00110,34348,12.53833,273944
1839,crazyatlantaguy,3,0.00110,34351,12.53942,273944
1840,CrazyPython,3,0.00110,34354,12.54052,273944
1841,ctxhou,3,0.00110,34357,12.54161,273944
1842,cvibhagool,3,0.00110,34360,12.54271,273944
1843,cyraid,3,0.00110,34363,12.54380,273944
1844,cyrilf,3,0.00110,34366,12.54490,273944
1845,D3T0N8R,3,0.00110,34369,12.54599,273944
1846,daliclass,3,0.00110,34372,12.54709,273944
1847,dalinaum,3,0.00110,34375,12.54819,273944
1848,danday74,3,0.00110,34378,12.54928,273944
1849,dandv,3,0.00110,34381,12.55038,273944
1850,danielhusar,3,0.00110,34384,12.55147,273944
1851,DanielKucal,3,0.00110,34387,12.55257,273944
1852,DanielSeehausen,3,0.00110,34390,12.55366,273944
1853,danjm,3,0.00110,34393,12.55476,273944
1854,dannyfallon,3,0.00110,34396,12.55585,273944
1855,danrot,3,0.00110,34399,12.55695,273944
1856,dargoan,3,0.00110,34402,12.55804,273944
1857,daveisfera,3,0.00110,34405,12.55914,273944
1858,dave-r12,3,0.00110,34408,12.56023,273944
1859,davidaurelio,3,0.00110,34411,12.56133,273944
1860,DavidDeSloovere,3,0.00110,34414,12.56242,273944
1861,davidfischer,3,0.00110,34417,12.56352,273944
1862,davidlsharp1,3,0.00110,34420,12.56461,273944
1863,davidsoncasey,3,0.00110,34423,12.56571,273944
1864,daydr3am,3,0.00110,34426,12.56680,273944
1865,Deadpowerful,3,0.00110,34429,12.56790,273944
1866,deanbrophy,3,0.00110,34432,12.56899,273944
1867,deeg,3,0.00110,34435,12.57009,273944
1868,deemru,3,0.00110,34438,12.57118,273944
1869,defreez,3,0.00110,34441,12.57228,273944
1870,deilv,3,0.00110,34444,12.57337,273944
1871,Deklin,3,0.00110,34447,12.57447,273944
1872,Deltatiger,3,0.00110,34450,12.57556,273944
1873,dengert,3,0.00110,34453,12.57666,273944
1874,denis-sokolov,3,0.00110,34456,12.57775,273944
1875,deniztetik,3,0.00110,34459,12.57885,273944
1876,denjamal,3,0.00110,34462,12.57994,273944
1877,dennisameling,3,0.00110,34465,12.58104,273944
1878,dennispbrown,3,0.00110,34468,12.58213,273944
1879,denyo,3,0.00110,34471,12.58323,273944
1880,deodeveloper,3,0.00110,34474,12.58432,273944
1881,deplay,3,0.00110,34477,12.58542,273944
1882,designorant,3,0.00110,34480,12.58651,273944
1883,devedse,3,0.00110,34483,12.58761,273944
1884,Devinsuit,3,0.00110,34486,12.58870,273944
1885,dianjuar,3,0.00110,34489,12.58980,273944
1886,DiegoRBaquero,3,0.00110,34492,12.59089,273944
1887,diestrin,3,0.00110,34495,12.59199,273944
1888,divercraig,3,0.00110,34498,12.59308,273944
1889,dizel3d,3,0.00110,34501,12.59418,273944
1890,djchie,3,0.00110,34504,12.59527,273944
1891,dlongley,3,0.00110,34507,12.59637,273944
1892,dloukadakis,3,0.00110,34510,12.59747,273944
1893,dmitrykos,3,0.00110,34513,12.59856,273944
1894,dnickless,3,0.00110,34516,12.59966,273944
1895,domq,3,0.00110,34519,12.60075,273944
1896,dookpham,3,0.00110,34522,12.60185,273944
1897,dornsebastian,3,0.00110,34525,12.60294,273944
1898,doughd,3,0.00110,34528,12.60404,273944
1899,dpsthree,3,0.00110,34531,12.60513,273944
1900,drademacher,3,0.00110,34534,12.60623,273944
1901,drcrallen,3,0.00110,34537,12.60732,273944
1902,dreambo8563,3,0.00110,34540,12.60842,273944
1903,Drumarcco,3,0.00110,34543,12.60951,273944
1904,drumonii,3,0.00110,34546,12.61061,273944
1905,dsychin,3,0.00110,34549,12.61170,273944
1906,dtarasiuk,3,0.00110,34552,12.61280,273944
1907,dudemelo,3,0.00110,34555,12.61389,273944
1908,DustinCampbell,3,0.00110,34558,12.61499,273944
1909,DustinMEastway,3,0.00110,34561,12.61608,273944
1910,dwaxweiler,3,0.00110,34564,12.61718,273944
1911,dwilson6,3,0.00110,34567,12.61827,273944
1912,dylanjohnson,3,0.00110,34570,12.61937,273944
1913,dzuremar,3,0.00110,34573,12.62046,273944
1914,eapnw,3,0.00110,34576,12.62156,273944
1915,edgar-pek,3,0.00110,34579,12.62265,273944
1916,Edouardbozon,3,0.00110,34582,12.62375,273944
1917,edvinerikson,3,0.00110,34585,12.62484,273944
1918,efux,3,0.00110,34588,12.62594,273944
1919,eggers,3,0.00110,34591,12.62703,273944
1920,ehellman,3,0.00110,34594,12.62813,273944
1921,ehershey,3,0.00110,34597,12.62922,273944
1922,ektrah,3,0.00110,34600,12.63032,273944
1923,EladBezalel,3,0.00110,34603,12.63141,273944
1924,elena-sam,3,0.00110,34606,12.63251,273944
1925,Elijen,3,0.00110,34609,12.63360,273944
1926,ElJerry,3,0.00110,34612,12.63470,273944
1927,emccorson,3,0.00110,34615,12.63579,273944
1928,endiliey,3,0.00110,34618,12.63689,273944
1929,enekonieto,3,0.00110,34621,12.63798,273944
1930,Enlcxx,3,0.00110,34624,12.63908,273944
1931,eoin,3,0.00110,34627,12.64017,273944
1932,eriawan,3,0.00110,34630,12.64127,273944
1933,ericksoen,3,0.00110,34633,12.64236,273944
1934,ericpitcher,3,0.00110,34636,12.64346,273944
1935,eric-s-raymond,3,0.00110,34639,12.64456,273944
1936,EricWVGG,3,0.00110,34642,12.64565,273944
1937,Erik-Codeblind,3,0.00110,34645,12.64675,273944
1938,ernest-galbrun,3,0.00110,34648,12.64784,273944
1939,ethanve,3,0.00110,34651,12.64894,273944
1940,evermax,3,0.00110,34654,12.65003,273944
1941,evolkmann,3,0.00110,34657,12.65113,273944
1942,existentialism,3,0.00110,34660,12.65222,273944
1943,ezeikel,3,0.00110,34663,12.65332,273944
1944,FabianGosebrink,3,0.00110,34666,12.65441,273944
1945,farzonl,3,0.00110,34669,12.65551,273944
1946,FaustmannChr,3,0.00110,34672,12.65660,273944
1947,fdegiuli,3,0.00110,34675,12.65770,273944
1948,fduperier,3,0.00110,34678,12.65879,273944
1949,ferhatb,3,0.00110,34681,12.65989,273944
1950,ferhate,3,0.00110,34684,12.66098,273944
1951,FGasper,3,0.00110,34687,12.66208,273944
1952,fhelwanger,3,0.00110,34690,12.66317,273944
1953,filiphosko,3,0.00110,34693,12.66427,273944
1954,FinnStutzenstein,3,0.00110,34696,12.66536,273944
1955,fisenkodv,3,0.00110,34699,12.66646,273944
1956,Florian-R,3,0.00110,34702,12.66755,273944
1957,ForJing,3,0.00110,34705,12.66865,273944
1958,forresst,3,0.00110,34708,12.66974,273944
1959,Fost,3,0.00110,34711,12.67084,273944
1960,foxx,3,0.00110,34714,12.67193,273944
1961,francoischalifour,3,0.00110,34717,12.67303,273944
1962,frankstepanski,3,0.00110,34720,12.67412,273944
1963,frank-yoon,3,0.00110,34723,12.67522,273944
1964,fraserhaer,3,0.00110,34726,12.67631,273944
1965,freezy-sk,3,0.00110,34729,12.67741,273944
1966,fthomas,3,0.00110,34732,12.67850,273944
1967,fyquah95,3,0.00110,34735,12.67960,273944
1968,gabejohnson,3,0.00110,34738,12.68069,273944
1969,gaborszekely,3,0.00110,34741,12.68179,273944
1970,Gaff,3,0.00110,34744,12.68288,273944
1971,Galad,3,0.00110,34747,12.68398,273944
1972,galtalmor,3,0.00110,34750,12.68507,273944
1973,Garbett1,3,0.00110,34753,12.68617,273944
1974,gautamkrishnar,3,0.00110,34756,12.68726,273944
1975,GavinSong123,3,0.00110,34759,12.68836,273944
1976,gavlyukovskiy,3,0.00110,34762,12.68945,273944
1977,gbamparop,3,0.00110,34765,12.69055,273944
1978,gbezyuk,3,0.00110,34768,12.69165,273944
1979,geromegrignon,3,0.00110,34771,12.69274,273944
1980,ggamel,3,0.00110,34774,12.69384,273944
1981,ggeurts,3,0.00110,34777,12.69493,273944
1982,gillchristian,3,0.00110,34780,12.69603,273944
1983,gjdev,3,0.00110,34783,12.69712,273944
1984,gkoberger,3,0.00110,34786,12.69822,273944
1985,goatslacker,3,0.00110,34789,12.69931,273944
1986,Gobie,3,0.00110,34792,12.70041,273944
1987,GordyD,3,0.00110,34795,12.70150,273944
1988,govindrai,3,0.00110,34798,12.70260,273944
1989,Gozala,3,0.00110,34801,12.70369,273944
1990,Gpx,3,0.00110,34804,12.70479,273944
1991,G-Rath,3,0.00110,34807,12.70588,273944
1992,greenify,3,0.00110,34810,12.70698,273944
1993,gregpabian,3,0.00110,34813,12.70807,273944
1994,greysteil,3,0.00110,34816,12.70917,273944
1995,grimmi,3,0.00110,34819,12.71026,273944
1996,gruberjonathan,3,0.00110,34822,12.71136,273944
1997,grumblerchester,3,0.00110,34825,12.71245,273944
1998,guillaumegarcia13,3,0.00110,34828,12.71355,273944
1999,gunn,3,0.00110,34831,12.71464,273944
2000,gzurbach,3,0.00110,34834,12.71574,273944
2001,Hacklone,3,0.00110,34837,12.71683,273944
2002,HamzaDevz,3,0.00110,34840,12.71793,273944
2003,han41858,3,0.00110,34843,12.71902,273944
2004,hankhero,3,0.00110,34846,12.72012,273944
2005,haoRchen,3,0.00110,34849,12.72121,273944
2006,happycollision,3,0.00110,34852,12.72231,273944
2007,haraldreingruber,3,0.00110,34855,12.72340,273944
2008,hariharanjv,3,0.00110,34858,12.72450,273944
2009,harriha,3,0.00110,34861,12.72559,273944
2010,harrison,3,0.00110,34864,12.72669,273944
2011,hateonion,3,0.00110,34867,12.72778,273944
2012,haydeeR,3,0.00110,34870,12.72888,273944
2013,headquarters,3,0.00110,34873,12.72997,273944
2014,Hearen,3,0.00110,34876,12.73107,273944
2015,hebbet,3,0.00110,34879,12.73216,273944
2016,HeberLZ,3,0.00110,34882,12.73326,273944
2017,hellendag,3,0.00110,34885,12.73435,273944
2018,HellooooNewman,3,0.00110,34888,12.73545,273944
2019,henderea,3,0.00110,34891,12.73654,273944
2020,henryqdineen,3,0.00110,34894,12.73764,273944
2021,HeroProtagonist,3,0.00110,34897,12.73873,273944
2022,heXelium,3,0.00110,34900,12.73983,273944
2023,him2him2,3,0.00110,34903,12.74093,273944
2024,hnordt,3,0.00110,34906,12.74202,273944
2025,hsingh23,3,0.00110,34909,12.74312,273944
2026,htulipe,3,0.00110,34912,12.74421,273944
2027,huangqinjin,3,0.00110,34915,12.74531,273944
2028,HubCodes,3,0.00110,34918,12.74640,273944
2029,Hugoer,3,0.00110,34921,12.74750,273944
2030,humphd,3,0.00110,34924,12.74859,273944
2031,hvesalai,3,0.00110,34927,12.74969,273944
2032,i3anaan,3,0.00110,34930,12.75078,273944
2033,iamdoron,3,0.00110,34933,12.75188,273944
2034,iamolivinius,3,0.00110,34936,12.75297,273944
2035,ibash,3,0.00110,34939,12.75407,273944
2036,ichensky,3,0.00110,34942,12.75516,273944
2037,idhindsight,3,0.00110,34945,12.75626,273944
2038,idzark,3,0.00110,34948,12.75735,273944
2039,imcotton,3,0.00110,34951,12.75845,273944
2040,imsky,3,0.00110,34954,12.75954,273944
2041,in-in,3,0.00110,34957,12.76064,273944
2042,inuscript,3,0.00110,34960,12.76173,273944
2043,ionspin,3,0.00110,34963,12.76283,273944
2044,istiti,3,0.00110,34966,12.76392,273944
2045,isunkes,3,0.00110,34969,12.76502,273944
2046,ite-klass,3,0.00110,34972,12.76611,273944
2047,ivosh,3,0.00110,34975,12.76721,273944
2048,iwhp,3,0.00110,34978,12.76830,273944
2049,ixkaito,3,0.00110,34981,12.76940,273944
2050,izeye,3,0.00110,34984,12.77049,273944
2051,J2TEAM,3,0.00110,34987,12.77159,273944
2052,jackfranklin,3,0.00110,34990,12.77268,273944
2053,JacoKoster,3,0.00110,34993,12.77378,273944
2054,jaideepghosh,3,0.00110,34996,12.77487,273944
2055,jakeboone02,3,0.00110,34999,12.77597,273944
2056,jakpaw,3,0.00110,35002,12.77706,273944
2057,jam40jeff,3,0.00110,35005,12.77816,273944
2058,jamercee,3,0.00110,35008,12.77925,273944
2059,jamierytlewski,3,0.00110,35011,12.78035,273944
2060,jamshedd,3,0.00110,35014,12.78144,273944
2061,JanBessai,3,0.00110,35017,12.78254,273944
2062,janclarin,3,0.00110,35020,12.78363,273944
2063,janhesters,3,0.00110,35023,12.78473,273944
2064,jankdc,3,0.00110,35026,12.78582,273944
2065,janpio,3,0.00110,35029,12.78692,273944
2066,janriemer,3,0.00110,35032,12.78802,273944
2067,JanStevens,3,0.00110,35035,12.78911,273944
2068,jaredgreen,3,0.00110,35038,12.79021,273944
2069,jaredpalmer,3,0.00110,35041,12.79130,273944
2070,jasnell,3,0.00110,35044,12.79240,273944
2071,jasonkarns,3,0.00110,35047,12.79349,273944
2072,jasonsturges,3,0.00110,35050,12.79459,273944
2073,jaspermdegroot,3,0.00110,35053,12.79568,273944
2074,jasperSpeicher,3,0.00110,35056,12.79678,273944
2075,Jasu,3,0.00110,35059,12.79787,273944
2076,javadev,3,0.00110,35062,12.79897,273944
2077,jayenashar,3,0.00110,35065,12.80006,273944
2078,JBallin,3,0.00110,35068,12.80116,273944
2079,JBtje,3,0.00110,35071,12.80225,273944
2080,jcolvin79,3,0.00110,35074,12.80335,273944
2081,jdelbello,3,0.00110,35077,12.80444,273944
2082,jDeppen,3,0.00110,35080,12.80554,273944
2083,jefersonduwe,3,0.00110,35083,12.80663,273944
2084,jeffora,3,0.00110,35086,12.80773,273944
2085,jeradrutnam,3,0.00110,35089,12.80882,273944
2086,jerryorta-dev,3,0.00110,35092,12.80992,273944
2087,jesperkc,3,0.00110,35095,12.81101,273944
2088,Jessidhia,3,0.00110,35098,12.81211,273944
2089,jetpack,3,0.00110,35101,12.81320,273944
2090,jfarid27,3,0.00110,35104,12.81430,273944
2091,jfisher446,3,0.00110,35107,12.81539,273944
2092,jfoshee,3,0.00110,35110,12.81649,273944
2093,jgrune,3,0.00110,35113,12.81758,273944
2094,jguady,3,0.00110,35116,12.81868,273944
2095,jhenderson2099,3,0.00110,35119,12.81977,273944
2096,jhermsmeier,3,0.00110,35122,12.82087,273944
2097,Jianru-Lin,3,0.00110,35125,12.82196,273944
2098,JinbeomHong,3,0.00110,35128,12.82306,273944
2099,Jin-H,3,0.00110,35131,12.82415,273944
2100,jinmmd,3,0.00110,35134,12.82525,273944
2101,jkasun,3,0.00110,35137,12.82634,273944
2102,jkuri,3,0.00110,35140,12.82744,273944
2103,Jlalond,3,0.00110,35143,12.82853,273944
2104,jlongster,3,0.00110,35146,12.82963,273944
2105,JobLeonard,3,0.00110,35149,12.83072,273944
2106,joeeames,3,0.00110,35152,12.83182,273944
2107,joeledwards,3,0.00110,35155,12.83291,273944
2108,johanchouquet,3,0.00110,35158,12.83401,273944
2109,JohanO,3,0.00110,35161,12.83510,273944
2110,JohnChen0,3,0.00110,35164,12.83620,273944
2111,johnlindquist,3,0.00110,35167,12.83730,273944
2112,johnnyreilly,3,0.00110,35170,12.83839,273944
2113,johnsenpeder,3,0.00110,35173,12.83949,273944
2114,johnsonlin,3,0.00110,35176,12.84058,273944
2115,jokeyrhyme,3,0.00110,35179,12.84168,273944
2116,jonathanGB,3,0.00110,35182,12.84277,273944
2117,jonbretman,3,0.00110,35185,12.84387,273944
2118,JoniJnm,3,0.00110,35188,12.84496,273944
2119,JonWallsten,3,0.00110,35191,12.84606,273944
2120,josenicomaia,3,0.00110,35194,12.84715,273944
2121,JosephPecoraro,3,0.00110,35197,12.84825,273944
2122,Josh68,3,0.00110,35200,12.84934,273944
2123,joshbrooks,3,0.00110,35203,12.85044,273944
2124,joshuahiggins,3,0.00110,35206,12.85153,273944
2125,jotatoledo,3,0.00110,35209,12.85263,273944
2126,jpvanhal,3,0.00110,35212,12.85372,273944
2127,jrudolph,3,0.00110,35215,12.85482,273944
2128,jschwarty,3,0.00110,35218,12.85591,273944
2129,jscissr,3,0.00110,35221,12.85701,273944
2130,jsina,3,0.00110,35224,12.85810,273944
2131,JSteunou,3,0.00110,35227,12.85920,273944
2132,jtheoof,3,0.00110,35230,12.86029,273944
2133,jub3i,3,0.00110,35233,12.86139,273944
2134,juboba,3,0.00110,35236,12.86248,273944
2135,julianocomg,3,0.00110,35239,12.86358,273944
2136,junglebarry,3,0.00110,35242,12.86467,273944
2137,jure,3,0.00110,35245,12.86577,273944
2138,jwalton,3,0.00110,35248,12.86686,273944
2139,kaicataldo,3,0.00110,35251,12.86796,273944
2140,kaito0228,3,0.00110,35254,12.86905,273944
2141,kamilmysliwiec,3,0.00110,35257,12.87015,273944
2142,karptonite,3,0.00110,35260,12.87124,273944
2143,karthikchintapalli,3,0.00110,35263,12.87234,273944
2144,kasabuta4,3,0.00110,35266,12.87343,273944
2145,kashifshamaz21,3,0.00110,35269,12.87453,273944
2146,KayLeung,3,0.00110,35272,12.87562,273944
2147,kb3eua,3,0.00110,35275,12.87672,273944
2148,kechol,3,0.00110,35278,12.87781,273944
2149,keilla,3,0.00110,35281,12.87891,273944
2150,kellyselden,3,0.00110,35284,12.88000,273944
2151,kentwalters,3,0.00110,35287,12.88110,273944
2152,kevhuang,3,0.00110,35290,12.88219,273944
2153,kevinashworth,3,0.00110,35293,12.88329,273944
2154,kevinmerckx,3,0.00110,35296,12.88439,273944
2155,kevinold,3,0.00110,35299,12.88548,273944
2156,kevinruscoe,3,0.00110,35302,12.88658,273944
2157,KevinVillela,3,0.00110,35305,12.88767,273944
2158,kevinzwhuang,3,0.00110,35308,12.88877,273944
2159,KimBurgess,3,0.00110,35311,12.88986,273944
2160,kingisaac95,3,0.00110,35314,12.89096,273944
2161,kirill-usov,3,0.00110,35317,12.89205,273944
2162,kirjai,3,0.00110,35320,12.89315,273944
2163,klieber,3,0.00110,35323,12.89424,273944
2164,klotzt-draeger,3,0.00110,35326,12.89534,273944
2165,kmarinushkin,3,0.00110,35329,12.89643,273944
2166,kmizu,3,0.00110,35332,12.89753,273944
2167,knowbody,3,0.00110,35335,12.89862,273944
2168,knpwrs,3,0.00110,35338,12.89972,273944
2169,koppor,3,0.00110,35341,12.90081,273944
2170,korthjp17,3,0.00110,35344,12.90191,273944
2171,krantzinator,3,0.00110,35347,12.90300,273944
2172,kristskrilovs,3,0.00110,35350,12.90410,273944
2173,kroeder,3,0.00110,35353,12.90519,273944
2174,krom-xr,3,0.00110,35356,12.90629,273944
2175,kulakowka,3,0.00110,35359,12.90738,273944
2176,kunagpal,3,0.00110,35362,12.90848,273944
2177,kuncevic,3,0.00110,35365,12.90957,273944
2178,kurthong,3,0.00110,35368,12.91067,273944
2179,kurtschelfthout,3,0.00110,35371,12.91176,273944
2180,kvisscher,3,0.00110,35374,12.91286,273944
2181,kweiberth,3,0.00110,35377,12.91395,273944
2182,Laoujin,3,0.00110,35380,12.91505,273944
2183,larssn,3,0.00110,35383,12.91614,273944
2184,leo6104,3,0.00110,35386,12.91724,273944
2185,levibuzolic,3,0.00110,35389,12.91833,273944
2186,lexjacobs,3,0.00110,35392,12.91943,273944
2187,linalu1,3,0.00110,35395,12.92052,273944
2188,linasm,3,0.00110,35398,12.92162,273944
2189,lindsaymacvean,3,0.00110,35401,12.92271,273944
2190,linquize,3,0.00110,35404,12.92381,273944
2191,Linskeyd,3,0.00110,35407,12.92490,273944
2192,liroyleshed,3,0.00110,35410,12.92600,273944
2193,lloydbenson,3,0.00110,35413,12.92709,273944
2194,loiane,3,0.00110,35416,12.92819,273944
2195,longhaiyan,3,0.00110,35419,12.92928,273944
2196,longlho,3,0.00110,35422,12.93038,273944
2197,lookfirst,3,0.00110,35425,12.93148,273944
2198,lordg,3,0.00110,35428,12.93257,273944
2199,lordrip,3,0.00110,35431,12.93367,273944
2200,louistio,3,0.00110,35434,12.93476,273944
2201,lovasoa,3,0.00110,35437,12.93586,273944
2202,lovelangy,3,0.00110,35440,12.93695,273944
2203,lozanol,3,0.00110,35443,12.93805,273944
2204,lslah,3,0.00110,35446,12.93914,273944
2205,luaks,3,0.00110,35449,12.94024,273944
2206,luanshixia,3,0.00110,35452,12.94133,273944
2207,lubomir,3,0.00110,35455,12.94243,273944
2208,LucianBuzzo,3,0.00110,35458,12.94352,273944
2209,lucienbertin,3,0.00110,35461,12.94462,273944
2210,LuisReinoso,3,0.00110,35464,12.94571,273944
2211,lukasgraf,3,0.00110,35467,12.94681,273944
2212,lyml,3,0.00110,35470,12.94790,273944
2213,lysannef,3,0.00110,35473,12.94900,273944
2214,lzsiga,3,0.00110,35476,12.95009,273944
2215,MaartenvE,3,0.00110,35479,12.95119,273944
2216,maasencioh,3,0.00110,35482,12.95228,273944
2217,MadaraUchiha,3,0.00110,35485,12.95338,273944
2218,madrisan,3,0.00110,35488,12.95447,273944
2219,MaksPob,3,0.00110,35491,12.95557,273944
2220,mandarini,3,0.00110,35494,12.95666,273944
2221,manofstick,3,0.00110,35497,12.95776,273944
2222,manoharreddyporeddy,3,0.00110,35500,12.95885,273944
2223,mantissa7,3,0.00110,35503,12.95995,273944
2224,maramon,3,0.00110,35506,12.96104,273944
2225,MarcinJuraszek,3,0.00110,35509,12.96214,273944
2226,marconilanna,3,0.00110,35512,12.96323,273944
2227,marcusnielsen,3,0.00110,35515,12.96433,273944
2228,markmielke,3,0.00110,35518,12.96542,273944
2229,MarkPflug,3,0.00110,35521,12.96652,273944
2230,marktopper,3,0.00110,35524,12.96761,273944
2231,markus1189,3,0.00110,35527,12.96871,273944
2232,martinbean,3,0.00110,35530,12.96980,273944
2233,martincostello,3,0.00110,35533,12.97090,273944
2234,martin-tarjanyi,3,0.00110,35536,12.97199,273944
2235,marvin-SL,3,0.00110,35539,12.97309,273944
2236,mateusrodrigues,3,0.00110,35542,12.97418,273944
2237,mathieumg,3,0.00110,35545,12.97528,273944
2238,Mathius17,3,0.00110,35548,12.97637,273944
2239,matt24ray,3,0.00110,35551,12.97747,273944
2240,matthewdeeco,3,0.00110,35554,12.97856,273944
2241,matthew-gerstman,3,0.00110,35557,12.97966,273944
2242,matthewhegarty,3,0.00110,35560,12.98076,273944
2243,MattiJarvinen-BA,3,0.00110,35563,12.98185,273944
2244,maxime-allex,3,0.00110,35566,12.98295,273944
2245,Maxim-Mazurok,3,0.00110,35569,12.98404,273944
2246,MaxPRafferty,3,0.00110,35572,12.98514,273944
2247,mbelsky,3,0.00110,35575,12.98623,273944
2248,m-burst,3,0.00110,35578,12.98733,273944
2249,MeiKatz,3,0.00110,35581,12.98842,273944
2250,Meknassih,3,0.00110,35584,12.98952,273944
2251,meldaravaniel,3,0.00110,35587,12.99061,273944
2252,mems,3,0.00110,35590,12.99171,273944
2253,merobal,3,0.00110,35593,12.99280,273944
2254,MerQGh,3,0.00110,35596,12.99390,273944
2255,MeyerNils,3,0.00110,35599,12.99499,273944
2256,mgreenland,3,0.00110,35602,12.99609,273944
2257,miginmrs,3,0.00110,35605,12.99718,273944
2258,mihaip,3,0.00110,35608,12.99828,273944
2259,Mike111177,3,0.00110,35611,12.99937,273944
2260,mikermcneil,3,0.00110,35614,13.00047,273944
2261,MikhailTatsky,3,0.00110,35617,13.00156,273944
2262,mikkomaunu,3,0.00110,35620,13.00266,273944
2263,mircowidmer,3,0.00110,35623,13.00375,273944
2264,misacorn,3,0.00110,35626,13.00485,273944
2265,miyajan,3,0.00110,35629,13.00594,273944
2266,mjhea0,3,0.00110,35632,13.00704,273944
2267,mlichtblau,3,0.00110,35635,13.00813,273944
2268,mmuppa,3,0.00110,35638,13.00923,273944
2269,Mobiletainment,3,0.00110,35641,13.01032,273944
2270,MohammadYounes,3,0.00110,35644,13.01142,273944
2271,mohd-akram,3,0.00110,35647,13.01251,273944
2272,mohdhamm,3,0.00110,35650,13.01361,273944
2273,molly,3,0.00110,35653,13.01470,273944
2274,moonformeli,3,0.00110,35656,13.01580,273944
2275,morriq,3,0.00110,35659,13.01689,273944
2276,mort3za,3,0.00110,35662,13.01799,273944
2277,mpetruska,3,0.00110,35665,13.01908,273944
2278,mrenrich84,3,0.00110,35668,13.02018,273944
2279,mridgway,3,0.00110,35671,13.02127,273944
2280,MrJithil,3,0.00110,35674,13.02237,273944
2281,mrLarbi,3,0.00110,35677,13.02346,273944
2282,msmania,3,0.00110,35680,13.02456,273944
2283,mstrutt,3,0.00110,35683,13.02565,273944
2284,muhajirdev,3,0.00110,35686,13.02675,273944
2285,multics,3,0.00110,35689,13.02785,273944
2286,MumblesNZ,3,0.00110,35692,13.02894,273944
2287,musicq,3,0.00110,35695,13.03004,273944
2288,muzige2000,3,0.00110,35698,13.03113,273944
2289,mwanago,3,0.00110,35701,13.03223,273944
2290,mychaelgo,3,0.00110,35704,13.03332,273944
2291,nacmartin,3,0.00110,35707,13.03442,273944
2292,naholyr,3,0.00110,35710,13.03551,273944
2293,nanjingboy,3,0.00110,35713,13.03661,273944
2294,NathanWalker,3,0.00110,35716,13.03770,273944
2295,naturalwarren,3,0.00110,35719,13.03880,273944
2296,nbellowe,3,0.00110,35722,13.03989,273944
2297,nchetankumar,3,0.00110,35725,13.04099,273944
2298,neojski,3,0.00110,35728,13.04208,273944
2299,NestorTejero,3,0.00110,35731,13.04318,273944
2300,nexus-uw,3,0.00110,35734,13.04427,273944
2301,ngdevelop-tech,3,0.00110,35737,13.04537,273944
2302,NicBonetto,3,0.00110,35740,13.04646,273944
2303,Nicholaiii,3,0.00110,35743,13.04756,273944
2304,Nicholi,3,0.00110,35746,13.04865,273944
2305,nickraphael,3,0.00110,35749,13.04975,273944
2306,nicodh,3,0.00110,35752,13.05084,273944
2307,nicojs,3,0.00110,35755,13.05194,273944
2308,NicolaiSoeborg,3,0.00110,35758,13.05303,273944
2309,nicolasleger,3,0.00110,35761,13.05413,273944
2310,nicolasstucki,3,0.00110,35764,13.05522,273944
2311,Nifled,3,0.00110,35767,13.05632,273944
2312,NightlyNexus,3,0.00110,35770,13.05741,273944
2313,NiklasMerz,3,0.00110,35773,13.05851,273944
2314,nikselite,3,0.00110,35776,13.05960,273944
2315,nikz99,3,0.00110,35779,13.06070,273944
2316,nirkaufman,3,0.00110,35782,13.06179,273944
2317,NMinhNguyen,3,0.00110,35785,13.06289,273944
2318,nnasirzada,3,0.00110,35788,13.06398,273944
2319,noahmedling,3,0.00110,35791,13.06508,273944
2320,nosovk,3,0.00110,35794,13.06617,273944
2321,npcode,3,0.00110,35797,13.06727,273944
2322,nsanitate,3,0.00110,35800,13.06836,273944
2323,nsteenbeek,3,0.00110,35803,13.06946,273944
2324,nthtran,3,0.00110,35806,13.07055,273944
2325,ntulsy,3,0.00110,35809,13.07165,273944
2326,nvborisenko,3,0.00110,35812,13.07274,273944
2327,ockham,3,0.00110,35815,13.07384,273944
2328,ojhaujjwal,3,0.00110,35818,13.07494,273944
2329,okapon,3,0.00110,35821,13.07603,273944
2330,oliviertassinari,3,0.00110,35824,13.07713,273944
2331,OlsonDev,3,0.00110,35827,13.07822,273944
2332,omouse,3,0.00110,35830,13.07932,273944
2333,onlyflix,3,0.00110,35833,13.08041,273944
2334,onovotny,3,0.00110,35836,13.08151,273944
2335,onumossn,3,0.00110,35839,13.08260,273944
2336,ooystein,3,0.00110,35842,13.08370,273944
2337,orischwartz,3,0.00110,35845,13.08479,273944
2338,Orodan,3,0.00110,35848,13.08589,273944
2339,oztune,3,0.00110,35851,13.08698,273944
2340,palanik,3,0.00110,35854,13.08808,273944
2341,panakour,3,0.00110,35857,13.08917,273944
2342,PandiyanCool,3,0.00110,35860,13.09027,273944
2343,partheseas,3,0.00110,35863,13.09136,273944
2344,pascalim,3,0.00110,35866,13.09246,273944
2345,paulmojicatech,3,0.00110,35869,13.09355,273944
2346,PaulTFreedman,3,0.00110,35872,13.09465,273944
2347,pdot86,3,0.00110,35875,13.09574,273944
2348,pedroclayman,3,0.00110,35878,13.09684,273944
2349,pedrottimark,3,0.00110,35881,13.09793,273944
2350,peebeebee,3,0.00110,35884,13.09903,273944
2351,penx,3,0.00110,35887,13.10012,273944
2352,peterfuwork,3,0.00110,35890,13.10122,273944
2353,ph1ll,3,0.00110,35893,13.10231,273944
2354,phapdinh,3,0.00110,35896,13.10341,273944
2355,PhiLhoSoft,3,0.00110,35899,13.10450,273944
2356,philquinn,3,0.00110,35902,13.10560,273944
2357,picheli20,3,0.00110,35905,13.10669,273944
2358,pieceofsummer,3,0.00110,35908,13.10779,273944
2359,pilwon,3,0.00110,35911,13.10888,273944
2360,pixtron,3,0.00110,35914,13.10998,273944
2361,pjeby,3,0.00110,35917,13.11107,273944
2362,pjohnmeyer,3,0.00110,35920,13.11217,273944
2363,pkerblaze,3,0.00110,35923,13.11326,273944
2364,pknouff,3,0.00110,35926,13.11436,273944
2365,pkukielka,3,0.00110,35929,13.11545,273944
2366,plabovich,3,0.00110,35932,13.11655,273944
2367,plr108,3,0.00110,35935,13.11764,273944
2368,pmccloghrylaing,3,0.00110,35938,13.11874,273944
2369,pocesar,3,0.00110,35941,13.11983,273944
2370,popey456963,3,0.00110,35944,13.12093,273944
2371,popomore,3,0.00110,35947,13.12202,273944
2372,poychang,3,0.00110,35950,13.12312,273944
2373,prashant-andani,3,0.00110,35953,13.12422,273944
2374,psilospore,3,0.00110,35956,13.12531,273944
2375,ptgamr,3,0.00110,35959,13.12641,273944
2376,ptrzyna,3,0.00110,35962,13.12750,273944
2377,pyitphyoaung,3,0.00110,35965,13.12860,273944
2378,raithit,3,0.00110,35968,13.12969,273944
2379,RaitoBezarius,3,0.00110,35971,13.13079,273944
2380,rajaramtt,3,0.00110,35974,13.13188,273944
2381,rajeshduggal,3,0.00110,35977,13.13298,273944
2382,ramiy,3,0.00110,35980,13.13407,273944
2383,raphaelkross,3,0.00110,35983,13.13517,273944
2384,rauchg,3,0.00110,35986,13.13626,273944
2385,razh,3,0.00110,35989,13.13736,273944
2386,RByers,3,0.00110,35992,13.13845,273944
2387,rcoy-v,3,0.00110,35995,13.13955,273944
2388,rdkmaster,3,0.00110,35998,13.14064,273944
2389,reduckted,3,0.00110,36001,13.14174,273944
2390,reedloden,3,0.00110,36004,13.14283,273944
2391,reiz,3,0.00110,36007,13.14393,273944
2392,remy,3,0.00110,36010,13.14502,273944
2393,resource11,3,0.00110,36013,13.14612,273944
2394,Retsam,3,0.00110,36016,13.14721,273944
2395,reubsinit,3,0.00110,36019,13.14831,273944
2396,rharter,3,0.00110,36022,13.14940,273944
2397,rhernandez35,3,0.00110,36025,13.15050,273944
2398,ricardopolo,3,0.00110,36028,13.15159,273944
2399,RicardoVaranda,3,0.00110,36031,13.15269,273944
2400,richbeales,3,0.00110,36034,13.15378,273944
2401,richiethomas,3,0.00110,36037,13.15488,273944
2402,RickyRoller,3,0.00110,36040,13.15597,273944
2403,RikkiGibson,3,0.00110,36043,13.15707,273944
2404,rileyL6122428,3,0.00110,36046,13.15816,273944
2405,rionmonster,3,0.00110,36049,13.15926,273944
2406,rixrix,3,0.00110,36052,13.16035,273944
2407,rjolly,3,0.00110,36055,13.16145,273944
2408,rmacklin,3,0.00110,36058,13.16254,273944
2409,robguima,3,0.00110,36061,13.16364,273944
2410,robinboehm,3,0.00110,36064,13.16473,273944
2411,RobinCsl,3,0.00110,36067,13.16583,273944
2412,robstoll,3,0.00110,36070,13.16692,273944
2413,rolodato,3,0.00110,36073,13.16802,273944
2414,romamatusevich,3,0.00110,36076,13.16911,273944
2415,romanowski,3,0.00110,36079,13.17021,273944
2416,rongduan-zhu,3,0.00110,36082,13.17131,273944
2417,rowanthorpe,3,0.00110,36085,13.17240,273944
2418,Rplus,3,0.00110,36088,13.17350,273944
2419,rrthomas,3,0.00110,36091,13.17459,273944
2420,rs017991,3,0.00110,36094,13.17569,273944
2421,runemoennike,3,0.00110,36097,13.17678,273944
2422,rupav,3,0.00110,36100,13.17788,273944
2423,RussKie,3,0.00110,36103,13.17897,273944
2424,ryo-utsunomiya,3,0.00110,36106,13.18007,273944
2425,rzschech,3,0.00110,36109,13.18116,273944
2426,sahan91,3,0.00110,36112,13.18226,273944
2427,sandbergja,3,0.00110,36115,13.18335,273944
2428,sanderboom,3,0.00110,36118,13.18445,273944
2429,sanex3339,3,0.00110,36121,13.18554,273944
2430,SangKa,3,0.00110,36124,13.18664,273944
2431,saravyas,3,0.00110,36127,13.18773,273944
2432,sasidhar,3,0.00110,36130,13.18883,273944
2433,sawilde,3,0.00110,36133,13.18992,273944
2434,schroederc,3,0.00110,36136,13.19102,273944
2435,scizor666,3,0.00110,36139,13.19211,273944
2436,scooper91,3,0.00110,36142,13.19321,273944
2437,screamingmunch,3,0.00110,36145,13.19430,273944
2438,sctape,3,0.00110,36148,13.19540,273944
2439,SeasonLeee,3,0.00110,36151,13.19649,273944
2440,SebastiaanNijland,3,0.00110,36154,13.19759,273944
2441,SebastienBtr,3,0.00110,36157,13.19868,273944
2442,sebdeckers,3,0.00110,36160,13.19978,273944
2443,Sebmaster,3,0.00110,36163,13.20087,273944
2444,sebnow,3,0.00110,36166,13.20197,273944
2445,segmentationfaulter,3,0.00110,36169,13.20306,273944
2446,seklyza,3,0.00110,36172,13.20416,273944
2447,sercaneraslan,3,0.00110,36175,13.20525,273944
2448,SergeyVolynkin,3,0.00110,36178,13.20635,273944
2449,Sergio-Mira,3,0.00110,36181,13.20744,273944
2450,serkanturgut,3,0.00110,36184,13.20854,273944
2451,sermojohn,3,0.00110,36187,13.20963,273944
2452,serpent5,3,0.00110,36190,13.21073,273944
2453,severen,3,0.00110,36193,13.21182,273944
2454,shahabkondri,3,0.00110,36196,13.21292,273944
2455,Sharondio,3,0.00110,36199,13.21401,273944
2456,ShashankaNataraj,3,0.00110,36202,13.21511,273944
2457,shaungrady,3,0.00110,36205,13.21620,273944
2458,sheikalthaf,3,0.00110,36208,13.21730,273944
2459,Shingyx,3,0.00110,36211,13.21840,273944
2460,shioyang,3,0.00110,36214,13.21949,273944
2461,Showtim3,3,0.00110,36217,13.22059,273944
2462,sibiraj-s,3,0.00110,36220,13.22168,273944
2463,siddhant1,3,0.00110,36223,13.22278,273944
2464,silvenon,3,0.00110,36226,13.22387,273944
2465,SirJackovich,3,0.00110,36229,13.22497,273944
2466,Smartis2812,3,0.00110,36232,13.22606,273944
2467,smartm0use,3,0.00110,36235,13.22716,273944
2468,smelnikov,3,0.00110,36238,13.22825,273944
2469,SMHFandA,3,0.00110,36241,13.22935,273944
2470,smithl,3,0.00110,36244,13.23044,273944
2471,smoke,3,0.00110,36247,13.23154,273944
2472,Smurf81,3,0.00110,36250,13.23263,273944
2473,sobolevn,3,0.00110,36253,13.23373,273944
2474,sod,3,0.00110,36256,13.23482,273944
2475,solderjs,3,0.00110,36259,13.23592,273944
2476,sompylasar,3,0.00110,36262,13.23701,273944
2477,soslan,3,0.00110,36265,13.23811,273944
2478,spaceribs,3,0.00110,36268,13.23920,273944
2479,Spikhalskiy,3,0.00110,36271,13.24030,273944
2480,ssonal,3,0.00110,36274,13.24139,273944
2481,StacyGay,3,0.00110,36277,13.24249,273944
2482,Steffen185,3,0.00110,36280,13.24358,273944
2483,Stephan202,3,0.00110,36283,13.24468,273944
2484,stephensauceda,3,0.00110,36286,13.24577,273944
2485,steveisok,3,0.00110,36289,13.24687,273944
2486,stevenanthonyrevo,3,0.00110,36292,13.24796,273944
2487,StevenLiekens,3,0.00110,36295,13.24906,273944
2488,stevenvachon,3,0.00110,36298,13.25015,273944
2489,stoneLeaf,3,0.00110,36301,13.25125,273944
2490,strawbrary,3,0.00110,36304,13.25234,273944
2491,StyXman,3,0.00110,36307,13.25344,273944
2492,stz-seongheon,3,0.00110,36310,13.25453,273944
2493,sudo-suhas,3,0.00110,36313,13.25563,273944
2494,sugoidesune,3,0.00110,36316,13.25672,273944
2495,sumitknoldus,3,0.00110,36319,13.25782,273944
2496,SunnyWar,3,0.00110,36322,13.25891,273944
2497,surajpoddar16,3,0.00110,36325,13.26001,273944
2498,swaroopsm,3,0.00110,36328,13.26110,273944
2499,Synoon,3,0.00110,36331,13.26220,273944
2500,systemallica,3,0.00110,36334,13.26329,273944
2501,syzzer,3,0.00110,36337,13.26439,273944
2502,taggon,3,0.00110,36340,13.26548,273944
2503,tatsuyafw,3,0.00110,36343,13.26658,273944
2504,taurose,3,0.00110,36346,13.26768,273944
2505,tcoz,3,0.00110,36349,13.26877,273944
2506,tdeschryver,3,0.00110,36352,13.26987,273944
2507,tefbop,3,0.00110,36355,13.27096,273944
2508,terabaud,3,0.00110,36358,13.27206,273944
2509,teyc,3,0.00110,36361,13.27315,273944
2510,tgiphil,3,0.00110,36364,13.27425,273944
2511,tgrrtt,3,0.00110,36367,13.27534,273944
2512,ThaneshR,3,0.00110,36370,13.27644,273944
2513,the-best-dev,3,0.00110,36373,13.27753,273944
2514,TheBlueSky,3,0.00110,36376,13.27863,273944
2515,thebyteman,3,0.00110,36379,13.27972,273944
2516,TheMushrr00m,3,0.00110,36382,13.28082,273944
2517,TheRoSS,3,0.00110,36385,13.28191,273944
2518,TheSporkBaron,3,0.00110,36388,13.28301,273944
2519,thg2k,3,0.00110,36391,13.28410,273944
2520,th-ko,3,0.00110,36394,13.28520,273944
2521,ThornWinters,3,0.00110,36397,13.28629,273944
2522,ti1024,3,0.00110,36400,13.28739,273944
2523,tiaguinho,3,0.00110,36403,13.28848,273944
2524,Tibing,3,0.00110,36406,13.28958,273944
2525,tienpham94,3,0.00110,36409,13.29067,273944
2526,timblack1,3,0.00110,36412,13.29177,273944
2527,tim-blair,3,0.00110,36415,13.29286,273944
2528,timjacobi,3,0.00110,36418,13.29396,273944
2529,timkendrick,3,0.00110,36421,13.29505,273944
2530,timkraut,3,0.00110,36424,13.29615,273944
2531,tkh44,3,0.00110,36427,13.29724,273944
2532,tmcw,3,0.00110,36430,13.29834,273944
2533,tnguyen14,3,0.00110,36433,13.29943,273944
2534,Tobyee,3,0.00110,36436,13.30053,273944
2535,todorpr,3,0.00110,36439,13.30162,273944
2536,tonylukasavage,3,0.00110,36442,13.30272,273944
2537,TooTallNate,3,0.00110,36445,13.30381,273944
2538,tracker1,3,0.00110,36448,13.30491,273944
2539,Tragetaschen,3,0.00110,36451,13.30600,273944
2540,treylitefm,3,0.00110,36454,13.30710,273944
2541,trezm,3,0.00110,36457,13.30819,273944
2542,trstringer,3,0.00110,36460,13.30929,273944
2543,ts2do,3,0.00110,36463,13.31038,273944
2544,TuckerWhitehouse,3,0.00110,36466,13.31148,273944
2545,TwoDCube,3,0.00110,36469,13.31257,273944
2546,tylerbuchea,3,0.00110,36472,13.31367,273944
2547,tyreer,3,0.00110,36475,13.31477,273944
2548,ukyo,3,0.00110,36478,13.31586,273944
2549,unional,3,0.00110,36481,13.31696,273944
2550,untitaker,3,0.00110,36484,13.31805,273944
2551,Vadorequest,3,0.00110,36487,13.31915,273944
2552,VanTanev,3,0.00110,36490,13.32024,273944
2553,varunnvs92,3,0.00110,36493,13.32134,273944
2554,vasileorza,3,0.00110,36496,13.32243,273944
2555,VasiliyNovikov,3,0.00110,36499,13.32353,273944
2556,vepasto,3,0.00110,36502,13.32462,273944
2557,vetom,3,0.00110,36505,13.32572,273944
2558,victornoel,3,0.00110,36508,13.32681,273944
2559,victor-o-silva,3,0.00110,36511,13.32791,273944
2560,vidavidorra,3,0.00110,36514,13.32900,273944
2561,VinitTomar,3,0.00110,36517,13.33010,273944
2562,vitomeuli,3,0.00110,36520,13.33119,273944
2563,vitvad,3,0.00110,36523,13.33229,273944
2564,vladimir-kazakov,3,0.00110,36526,13.33338,273944
2565,vlbee,3,0.00110,36529,13.33448,273944
2566,vogloblinsky,3,0.00110,36532,13.33557,273944
2567,Volga,3,0.00110,36535,13.33667,273944
2568,vucalur,3,0.00110,36538,13.33776,273944
2569,w1zeman1p,3,0.00110,36541,13.33886,273944
2570,wali-s,3,0.00110,36544,13.33995,273944
2571,Wcc723,3,0.00110,36547,13.34105,273944
2572,wcjohnson11,3,0.00110,36550,13.34214,273944
2573,weitzhandler,3,0.00110,36553,13.34324,273944
2574,wilgert,3,0.00110,36556,13.34433,273944
2575,willTG,3,0.00110,36559,13.34543,273944
2576,wkwiatek,3,0.00110,36562,13.34652,273944
2577,wmarques,3,0.00110,36565,13.34762,273944
2578,wmertens,3,0.00110,36568,13.34871,273944
2579,wnqnguo,3,0.00110,36571,13.34981,273944
2580,wyze,3,0.00110,36574,13.35090,273944
2581,Xaerxess,3,0.00110,36577,13.35200,273944
2582,XaveScor,3,0.00110,36580,13.35309,273944
2583,xcodebuild,3,0.00110,36583,13.35419,273944
2584,Xegyn,3,0.00110,36586,13.35528,273944
2585,xhoogland,3,0.00110,36589,13.35638,273944
2586,xiangzhuyuan,3,0.00110,36592,13.35747,273944
2587,xingao267,3,0.00110,36595,13.35857,273944
2588,xybu,3,0.00110,36598,13.35966,273944
2589,Yahkob,3,0.00110,36601,13.36076,273944
2590,yaman-jain,3,0.00110,36604,13.36185,273944
2591,yangmillstheory,3,0.00110,36607,13.36295,273944
2592,YannBertrand,3,0.00110,36610,13.36405,273944
2593,yasirmhd,3,0.00110,36613,13.36514,273944
2594,yasserkaddour,3,0.00110,36616,13.36624,273944
2595,YevhenLukomskyi,3,0.00110,36619,13.36733,273944
2596,yhagio,3,0.00110,36622,13.36843,273944
2597,yilinglu,3,0.00110,36625,13.36952,273944
2598,ymekuria,3,0.00110,36628,13.37062,273944
2599,yongdamsh,3,0.00110,36631,13.37171,273944
2600,yuan3y,3,0.00110,36634,13.37281,273944
2601,yuchi1989,3,0.00110,36637,13.37390,273944
2602,yvanin,3,0.00110,36640,13.37500,273944
2603,yxliang01,3,0.00110,36643,13.37609,273944
2604,ZachLamb,3,0.00110,36646,13.37719,273944
2605,zdouble,3,0.00110,36649,13.37828,273944
2606,zhengkai,3,0.00110,36652,13.37938,273944
2607,zhilich,3,0.00110,36655,13.38047,273944
2608,zhukov,3,0.00110,36658,13.38157,273944
2609,zjmiller,3,0.00110,36661,13.38266,273944
2610,ZLester,3,0.00110,36664,13.38376,273944
2611,Zovube,3,0.00110,36667,13.38485,273944
2612,zsd4yr,3,0.00110,36670,13.38595,273944
2613,zverbeta,3,0.00110,36673,13.38704,273944
2614,zwenza,3,0.00110,36676,13.38814,273944
2615,zwhitchcox,3,0.00110,36679,13.38923,273944
2616,zzz40500,3,0.00110,36682,13.39033,273944
2617,0x4139,2,0.00073,36684,13.39106,273944
2618,0xced,2,0.00073,36686,13.39179,273944
2619,0xflotus,2,0.00073,36688,13.39252,273944
2620,193s,2,0.00073,36690,13.39325,273944
2621,2E0PGS,2,0.00073,36692,13.39398,273944
2622,3dd13,2,0.00073,36694,13.39471,273944
2623,3LOK,2,0.00073,36696,13.39544,273944
2624,3noch,2,0.00073,36698,13.39617,273944
2625,403studio,2,0.00073,36700,13.39690,273944
2626,8398a7,2,0.00073,36702,13.39763,273944
2627,8to5Developer,2,0.00073,36704,13.39836,273944
2628,a510,2,0.00073,36706,13.39909,273944
2629,aackerman,2,0.00073,36708,13.39982,273944
2630,aandrewww,2,0.00073,36710,13.40055,273944
2631,aaronroberson,2,0.00073,36712,13.40128,273944
2632,aaugustin,2,0.00073,36714,13.40201,273944
2633,abalmos,2,0.00073,36716,13.40274,273944
2634,abargnesi,2,0.00073,36718,13.40347,273944
2635,abhas9,2,0.00073,36720,13.40420,273944
2636,AbhishekGarg,2,0.00073,36722,13.40493,273944
2637,abnud1,2,0.00073,36724,13.40566,273944
2638,acjbizar,2,0.00073,36726,13.40639,273944
2639,acourtiol,2,0.00073,36728,13.40712,273944
2640,adam77,2,0.00073,36730,13.40785,273944
2641,adambowles,2,0.00073,36732,13.40858,273944
2642,adamcohen,2,0.00073,36734,13.40931,273944
2643,adamjmcgrath,2,0.00073,36736,13.41004,273944
2644,adampenn,2,0.00073,36738,13.41077,273944
2645,adamretter,2,0.00073,36740,13.41150,273944
2646,adamyi,2,0.00073,36742,13.41223,273944
2647,adarrra,2,0.00073,36744,13.41296,273944
2648,addyosmani,2,0.00073,36746,13.41369,273944
2649,adekbadek,2,0.00073,36748,13.41442,273944
2650,adoyle-h,2,0.00073,36750,13.41515,273944
2651,adrianhopebailie,2,0.00073,36752,13.41588,273944
2652,adriantanasa,2,0.00073,36754,13.41661,273944
2653,adriensamson,2,0.00073,36756,13.41734,273944
2654,Adusei,2,0.00073,36758,13.41807,273944
2655,aelafifi,2,0.00073,36760,13.41880,273944
2656,aelij,2,0.00073,36762,13.41953,273944
2657,af,2,0.00073,36764,13.42026,273944
2658,afanasy,2,0.00073,36766,13.42099,273944
2659,afitiskin,2,0.00073,36768,13.42172,273944
2660,aft90,2,0.00073,36770,13.42245,273944
2661,agievich,2,0.00073,36772,13.42318,273944
2662,agray,2,0.00073,36774,13.42391,273944
2663,AgtLucas,2,0.00073,36776,13.42464,273944
2664,aguspina,2,0.00073,36778,13.42537,273944
2665,ahamid,2,0.00073,36780,13.42610,273944
2666,ahmedalejo,2,0.00073,36782,13.42683,273944
2667,AhmedMustafa,2,0.00073,36784,13.42756,273944
2668,ahsan-ayaz,2,0.00073,36786,13.42829,273944
2669,aianus,2,0.00073,36788,13.42902,273944
2670,airamrguez,2,0.00073,36790,13.42975,273944
2671,airs0urce,2,0.00073,36792,13.43048,273944
2672,aitboudad,2,0.00073,36794,13.43121,273944
2673,ajbogh,2,0.00073,36796,13.43194,273944
2674,ajcrowe,2,0.00073,36798,13.43267,273944
2675,akai,2,0.00073,36800,13.43340,273944
2676,akamch,2,0.00073,36802,13.43413,273944
2677,akatopo,2,0.00073,36804,13.43486,273944
2678,akaustav,2,0.00073,36806,13.43559,273944
2679,akshayagarwal,2,0.00073,36808,13.43632,273944
2680,Alanscut,2,0.00073,36810,13.43705,273944
2681,alanzheng88,2,0.00073,36812,13.43778,273944
2682,albertogoffi,2,0.00073,36814,13.43851,273944
2683,alburthoffman,2,0.00073,36816,13.43924,273944
2684,Alcaro,2,0.00073,36818,13.43997,273944
2685,AlejandroRivera,2,0.00073,36820,13.44070,273944
2686,Aleksandyr,2,0.00073,36822,13.44143,273944
2687,aleqi200,2,0.00073,36824,13.44216,273944
2688,AlexanderOMara,2,0.00073,36826,13.44289,273944
2689,alexandrnikitin,2,0.00073,36828,13.44362,273944
2690,alexbaumgertner,2,0.00073,36830,13.44435,273944
2691,alexbyk,2,0.00073,36832,13.44508,273944
2692,AlexG2017,2,0.00073,36834,13.44581,273944
2693,alexk000,2,0.00073,36836,13.44654,273944
2694,alexkirsz,2,0.00073,36838,13.44727,273944
2695,alexkrolick,2,0.00073,36840,13.44800,273944
2696,Alex-Sokolov,2,0.00073,36842,13.44873,273944
2697,alexsorokoletov,2,0.00073,36844,13.44946,273944
2698,AlexxNica,2,0.00073,36846,13.45019,273944
2699,alfaslash,2,0.00073,36848,13.45092,273944
2700,alFReD-NSH,2,0.00073,36850,13.45165,273944
2701,alippai,2,0.00073,36852,13.45238,273944
2702,allofthenorthwood,2,0.00073,36854,13.45311,273944
2703,AlmogShaul,2,0.00073,36856,13.45384,273944
2704,alpancs,2,0.00073,36858,13.45457,273944
2705,alumis,2,0.00073,36860,13.45530,273944
2706,alyssamichelle,2,0.00073,36862,13.45603,273944
2707,amandeepmittal,2,0.00073,36864,13.45676,273944
2708,ameyjadiye,2,0.00073,36866,13.45749,273944
2709,aminsoheyli,2,0.00073,36868,13.45823,273944
2710,amirelemam,2,0.00073,36870,13.45896,273944
2711,Anber,2,0.00073,36872,13.45969,273944
2712,AndersSahlin,2,0.00073,36874,13.46042,273944
2713,andreacc,2,0.00073,36876,13.46115,273944
2714,andresroberto,2,0.00073,36878,13.46188,273944
2715,andrewrota,2,0.00073,36880,13.46261,273944
2716,andyexeter,2,0.00073,36882,13.46334,273944
2717,andygrundman,2,0.00073,36884,13.46407,273944
2718,andymc12,2,0.00073,36886,13.46480,273944
2719,andypotts,2,0.00073,36888,13.46553,273944
2720,andyscott,2,0.00073,36890,13.46626,273944
2721,angelo-v,2,0.00073,36892,13.46699,273944
2722,angfal,2,0.00073,36894,13.46772,273944
2723,anirudhramanan,2,0.00073,36896,13.46845,273944
2724,annp89,2,0.00073,36898,13.46918,273944
2725,anotheredward,2,0.00073,36900,13.46991,273944
2726,ansvonwa,2,0.00073,36902,13.47064,273944
2727,anthonyryan1,2,0.00073,36904,13.47137,273944
2728,antoniom,2,0.00073,36906,13.47210,273944
2729,AnuragPorwal,2,0.00073,36908,13.47283,273944
2730,apirom9,2,0.00073,36910,13.47356,273944
2731,aral,2,0.00073,36912,13.47429,273944
2732,arbaaz,2,0.00073,36914,13.47502,273944
2733,arcana261,2,0.00073,36916,13.47575,273944
2734,ArchmageInc,2,0.00073,36918,13.47648,273944
2735,Ardeshir81,2,0.00073,36920,13.47721,273944
2736,argelius,2,0.00073,36922,13.47794,273944
2737,ariabuckles,2,0.00073,36924,13.47867,273944
2738,arm1n,2,0.00073,36926,13.47940,273944
2739,armaanahluwalia,2,0.00073,36928,13.48013,273944
2740,armfazh,2,0.00073,36930,13.48086,273944
2741,arminsolecki,2,0.00073,36932,13.48159,273944
2742,armostafizi,2,0.00073,36934,13.48232,273944
2743,arnif,2,0.00073,36936,13.48305,273944
2744,ArnoSaine,2,0.00073,36938,13.48378,273944
2745,arpitpandey0209,2,0.00073,36940,13.48451,273944
2746,arshabh,2,0.00073,36942,13.48524,273944
2747,ArtemLanovyy,2,0.00073,36944,13.48597,273944
2748,artnez,2,0.00073,36946,13.48670,273944
2749,ArturBaybulatov,2,0.00073,36948,13.48743,273944
2750,arty-name,2,0.00073,36950,13.48816,273944
2751,arunjvs,2,0.00073,36952,13.48889,273944
2752,arw-travela,2,0.00073,36954,13.48962,273944
2753,ashaffer,2,0.00073,36956,13.49035,273944
2754,ashinzekene,2,0.00073,36958,13.49108,273944
2755,AskYous,2,0.00073,36960,13.49181,273944
2756,aSoujyuTanaka,2,0.00073,36962,13.49254,273944
2757,asulaiman,2,0.00073,36964,13.49327,273944
2758,atd,2,0.00073,36966,13.49400,273944
2759,atul-shimpi,2,0.00073,36968,13.49473,273944
2760,AudyOdi,2,0.00073,36970,13.49546,273944
2761,aurium,2,0.00073,36972,13.49619,273944
2762,austinpray,2,0.00073,36974,13.49692,273944
2763,autopulated,2,0.00073,36976,13.49765,273944
2764,avens19,2,0.00073,36978,13.49838,273944
2765,avioli,2,0.00073,36980,13.49911,273944
2766,avivr,2,0.00073,36982,13.49984,273944
2767,awdyson,2,0.00073,36984,13.50057,273944
2768,axel22,2,0.00073,36986,13.50130,273944
2769,ayende,2,0.00073,36988,13.50203,273944
2770,azat,2,0.00073,36990,13.50276,273944
2771,b3nj4m,2,0.00073,36992,13.50349,273944
2772,B3zo0,2,0.00073,36994,13.50422,273944
2773,babhishek21,2,0.00073,36996,13.50495,273944
2774,bahamas10,2,0.00073,36998,13.50568,273944
2775,bancek,2,0.00073,37000,13.50641,273944
2776,banli17,2,0.00073,37002,13.50714,273944
2777,baopham,2,0.00073,37004,13.50787,273944
2778,baribadamshin,2,0.00073,37006,13.50860,273944
2779,Bartosz-D3V,2,0.00073,37008,13.50933,273944
2780,bary822,2,0.00073,37010,13.51006,273944
2781,bascoder,2,0.00073,37012,13.51079,273944
2782,based2,2,0.00073,37014,13.51152,273944
2783,batiste,2,0.00073,37016,13.51225,273944
2784,batusai513,2,0.00073,37018,13.51298,273944
2785,bbamsch,2,0.00073,37020,13.51371,273944
2786,bbartels,2,0.00073,37022,13.51444,273944
2787,BBB,2,0.00073,37024,13.51517,273944
2788,BBKolton,2,0.00073,37026,13.51590,273944
2789,bcherny,2,0.00073,37028,13.51663,273944
2790,beatak,2,0.00073,37030,13.51736,273944
2791,beausmith,2,0.00073,37032,13.51809,273944
2792,behrangsa,2,0.00073,37034,13.51882,273944
2793,behzad888,2,0.00073,37036,13.51955,273944
2794,belev,2,0.00073,37038,13.52028,273944
2795,believer,2,0.00073,37040,13.52101,273944
2796,benatespina,2,0.00073,37042,13.52174,273944
2797,bengadbois,2,0.00073,37044,13.52247,273944
2798,benhutchison,2,0.00073,37046,13.52320,273944
2799,benjamin-albert,2,0.00073,37048,13.52393,273944
2800,benjaminp,2,0.00073,37050,13.52466,273944
2801,benjaminpick,2,0.00073,37052,13.52539,273944
2802,BenjaminVadant,2,0.00073,37054,13.52612,273944
2803,Bennet11,2,0.00073,37056,13.52685,273944
2804,bennyn,2,0.00073,37058,13.52758,273944
2805,benpye,2,0.00073,37060,13.52831,273944
2806,benwiley4000,2,0.00073,37062,13.52904,273944
2807,beradrian,2,0.00073,37064,13.52977,273944
2808,beznosd,2,0.00073,37066,13.53050,273944
2809,bfanger,2,0.00073,37068,13.53123,273944
2810,bgever,2,0.00073,37070,13.53196,273944
2811,bgnx,2,0.00073,37072,13.53269,273944
2812,bgpat,2,0.00073,37074,13.53342,273944
2813,Bhambya,2,0.00073,37076,13.53415,273944
2814,BigBadBleuCheese,2,0.00073,37078,13.53488,273944
2815,bildja,2,0.00073,37080,13.53561,273944
2816,billymoon,2,0.00073,37082,13.53634,273944
2817,bjarneo,2,0.00073,37084,13.53707,273944
2818,bjouhier,2,0.00073,37086,13.53780,273944
2819,bkiselka,2,0.00073,37088,13.53853,273944
2820,bl00mber,2,0.00073,37090,13.53926,273944
2821,blacksun1,2,0.00073,37092,13.53999,273944
2822,BlancheP,2,0.00073,37094,13.54072,273944
2823,BlueHatbRit,2,0.00073,37096,13.54145,273944
2824,bluepnume,2,0.00073,37098,13.54218,273944
2825,bman654,2,0.00073,37100,13.54291,273944
2826,bnabholz,2,0.00073,37102,13.54364,273944
2827,bojand,2,0.00073,37104,13.54437,273944
2828,bokub,2,0.00073,37106,13.54510,273944
2829,bording,2,0.00073,37108,13.54583,273944
2830,borgboyone,2,0.00073,37110,13.54656,273944
2831,bradbrandhorst,2,0.00073,37112,13.54729,273944
2832,bradford-hamilton,2,0.00073,37114,13.54802,273944
2833,bradyisom,2,0.00073,37116,13.54875,273944
2834,brandwe,2,0.00073,37118,13.54948,273944
2835,Brantner,2,0.00073,37120,13.55021,273944
2836,Brar,2,0.00073,37122,13.55094,273944
2837,brendo,2,0.00073,37124,13.55167,273944
2838,brentsnook,2,0.00073,37126,13.55240,273944
2839,brentvatne,2,0.00073,37128,13.55313,273944
2840,brettdh,2,0.00073,37130,13.55387,273944
2841,briankung,2,0.00073,37132,13.55460,273944
2842,BrianLondon,2,0.00073,37134,13.55533,273944
2843,bripkens,2,0.00073,37136,13.55606,273944
2844,BRKalow,2,0.00073,37138,13.55679,273944
2845,bruceharris,2,0.00073,37140,13.55752,273944
2846,brunin2509,2,0.00073,37142,13.55825,273944
2847,brycebaril,2,0.00073,37144,13.55898,273944
2848,brychcy,2,0.00073,37146,13.55971,273944
2849,bsamek,2,0.00073,37148,13.56044,273944
2850,bsingr,2,0.00073,37150,13.56117,273944
2851,bspaulding,2,0.00073,37152,13.56190,273944
2852,b-spencer,2,0.00073,37154,13.56263,273944
2853,btelles,2,0.00073,37156,13.56336,273944
2854,bttmly,2,0.00073,37158,13.56409,273944
2855,bubersson,2,0.00073,37160,13.56482,273944
2856,bulgakovalexander,2,0.00073,37162,13.56555,273944
2857,byronigoe,2,0.00073,37164,13.56628,273944
2858,bzoz,2,0.00073,37166,13.56701,273944
2859,C45tr0,2,0.00073,37168,13.56774,273944
2860,cahbb,2,0.00073,37170,13.56847,273944
2861,calebboyd,2,0.00073,37172,13.56920,273944
2862,calibr,2,0.00073,37174,13.56993,273944
2863,Calidus,2,0.00073,37176,13.57066,273944
2864,carloluis,2,0.00073,37178,13.57139,273944
2865,carolinapowers,2,0.00073,37180,13.57212,273944
2866,CarstenWickner,2,0.00073,37182,13.57285,273944
2867,cassianomon,2,0.00073,37184,13.57358,273944
2868,Castaneda1914,2,0.00073,37186,13.57431,273944
2869,cb372,2,0.00073,37188,13.57504,273944
2870,cbdeveloper,2,0.00073,37190,13.57577,273944
2871,cbosco,2,0.00073,37192,13.57650,273944
2872,cedral,2,0.00073,37194,13.57723,273944
2873,cerkiner,2,0.00073,37196,13.57796,273944
2874,cfleschhut,2,0.00073,37198,13.57869,273944
2875,cg-cnu,2,0.00073,37200,13.57942,273944
2876,chadfawcett,2,0.00073,37202,13.58015,273944
2877,chalup,2,0.00073,37204,13.58088,273944
2878,chanakasan,2,0.00073,37206,13.58161,273944
2879,charliegdev,2,0.00073,37208,13.58234,273944
2880,charlierudolph,2,0.00073,37210,13.58307,273944
2881,charlie-s,2,0.00073,37212,13.58380,273944
2882,charsleysa,2,0.00073,37214,13.58453,273944
2883,cheesestringer,2,0.00073,37216,13.58526,273944
2884,chengpohi,2,0.00073,37218,13.58599,273944
2885,cherouvim,2,0.00073,37220,13.58672,273944
2886,chill117,2,0.00073,37222,13.58745,273944
2887,chjj,2,0.00073,37224,13.58818,273944
2888,Chocobo1,2,0.00073,37226,13.58891,273944
2889,choury,2,0.00073,37228,13.58964,273944
2890,ChrisAckerman,2,0.00073,37230,13.59037,273944
2891,chrisakers,2,0.00073,37232,13.59110,273944
2892,ChrisCinelli,2,0.00073,37234,13.59183,273944
2893,chrisdukakis,2,0.00073,37236,13.59256,273944
2894,chriseppstein,2,0.00073,37238,13.59329,273944
2895,chrisirhc,2,0.00073,37240,13.59402,273944
2896,chrislambe,2,0.00073,37242,13.59475,273944
2897,chrisokasaki,2,0.00073,37244,13.59548,273944
2898,chrisse27,2,0.00073,37246,13.59621,273944
2899,christianrondeau,2,0.00073,37248,13.59694,273944
2900,churchie317,2,0.00073,37250,13.59767,273944
2901,cianclarke,2,0.00073,37252,13.59840,273944
2902,cif,2,0.00073,37254,13.59913,273944
2903,ckniffen,2,0.00073,37256,13.59986,273944
2904,cky,2,0.00073,37258,13.60059,273944
2905,clabough,2,0.00073,37260,13.60132,273944
2906,clamp03,2,0.00073,37262,13.60205,273944
2907,Cleod9,2,0.00073,37264,13.60278,273944
2908,cn007b,2,0.00073,37266,13.60351,273944
2909,cnishina,2,0.00073,37268,13.60424,273944
2910,cobbweb,2,0.00073,37270,13.60497,273944
2911,CodeBlanch,2,0.00073,37272,13.60570,273944
2912,CodeMan99,2,0.00073,37274,13.60643,273944
2913,coderaiser,2,0.00073,37276,13.60716,273944
2914,coderbydesign,2,0.00073,37278,13.60789,273944
2915,CodyReichert,2,0.00073,37280,13.60862,273944
2916,Cole-Beckwith-SP,2,0.00073,37282,13.60935,273944
2917,colesimmons,2,0.00073,37284,13.61008,273944
2918,colindickson,2,0.00073,37286,13.61081,273944
2919,colunga91,2,0.00073,37288,13.61154,273944
2920,Coly010,2,0.00073,37290,13.61227,273944
2921,coreysf,2,0.00073,37292,13.61300,273944
2922,Corniel,2,0.00073,37294,13.61373,273944
2923,CorvusCorrax,2,0.00073,37296,13.61446,273944
2924,coryhouse,2,0.00073,37298,13.61519,273944
2925,coryrylan,2,0.00073,37300,13.61592,273944
2926,cos,2,0.00073,37302,13.61665,273944
2927,coultonluke,2,0.00073,37304,13.61738,273944
2928,coxlinton,2,0.00073,37306,13.61811,273944
2929,crispen-smith,2,0.00073,37308,13.61884,273944
2930,crisptrutski,2,0.00073,37310,13.61957,273944
2931,cristidrg,2,0.00073,37312,13.62030,273944
2932,cristobalito,2,0.00073,37314,13.62103,273944
2933,cristovaov,2,0.00073,37316,13.62176,273944
2934,crooksey,2,0.00073,37318,13.62249,273944
2935,crossjs,2,0.00073,37320,13.62322,273944
2936,csharp,2,0.00073,37322,13.62395,273944
2937,cspotcode,2,0.00073,37324,13.62468,273944
2938,cstefanache,2,0.00073,37326,13.62541,273944
2939,ctz,2,0.00073,37328,13.62614,273944
2940,curlydevil,2,0.00073,37330,13.62687,273944
2941,czajkowski,2,0.00073,37332,13.62760,273944
2942,d0g,2,0.00073,37334,13.62833,273944
2943,d2bit,2,0.00073,37336,13.62906,273944
2944,d4rky-pl,2,0.00073,37338,13.62979,273944
2945,dacoozheng,2,0.00073,37340,13.63052,273944
2946,dajeffri,2,0.00073,37342,13.63125,273944
2947,dalcib,2,0.00073,37344,13.63198,273944
2948,daltones,2,0.00073,37346,13.63271,273944
2949,danbucholtz,2,0.00073,37348,13.63344,273944
2950,danielcrisp,2,0.00073,37350,13.63417,273944
2951,danieletorelli,2,0.00073,37352,13.63490,273944
2952,danielknell,2,0.00073,37354,13.63563,273944
2953,DanielNill,2,0.00073,37356,13.63636,273944
2954,DanielRosenwasser,2,0.00073,37358,13.63709,273944
2955,daniel-shuy,2,0.00073,37360,13.63782,273944
2956,danielstjules,2,0.00073,37362,13.63855,273944
2957,danielwiehl,2,0.00073,37364,13.63928,273944
2958,dante2008,2,0.00073,37366,13.64001,273944
2959,danthegoodman,2,0.00073,37368,13.64074,273944
2960,danvitoriano,2,0.00073,37370,13.64147,273944
2961,dariusk,2,0.00073,37372,13.64220,273944
2962,darobin,2,0.00073,37374,13.64293,273944
2963,dashtinejad,2,0.00073,37376,13.64366,273944
2964,daveaglick,2,0.00073,37378,13.64439,273944
2965,davej,2,0.00073,37380,13.64512,273944
2966,davesidious,2,0.00073,37382,13.64585,273944
2967,DaveVoyles,2,0.00073,37384,13.64658,273944
2968,davewasmer,2,0.00073,37386,13.64731,273944
2969,david-driscoll,2,0.00073,37388,13.64804,273944
2970,DavidePastore,2,0.00073,37390,13.64877,273944
2971,davidhu2000,2,0.00073,37392,13.64951,273944
2972,DavidSouther,2,0.00073,37394,13.65024,273944
2973,david-unergie,2,0.00073,37396,13.65097,273944
2974,davidxmoody,2,0.00073,37398,13.65170,273944
2975,DavSanchez,2,0.00073,37400,13.65243,273944
2976,davyengone,2,0.00073,37402,13.65316,273944
2977,DAXaholic,2,0.00073,37404,13.65389,273944
2978,dblevins,2,0.00073,37406,13.65462,273944
2979,dcooper16,2,0.00073,37408,13.65535,273944
2980,ddunkin,2,0.00073,37410,13.65608,273944
2981,deblockt,2,0.00073,37412,13.65681,273944
2982,deb-saunders,2,0.00073,37414,13.65754,273944
2983,debugmodedotnet,2,0.00073,37416,13.65827,273944
2984,Degusto,2,0.00073,37418,13.65900,273944
2985,Delapouite,2,0.00073,37420,13.65973,273944
2986,delavara,2,0.00073,37422,13.66046,273944
2987,delirius325,2,0.00073,37424,13.66119,273944
2988,delitescere,2,0.00073,37426,13.66192,273944
2989,DenisGorbachev,2,0.00073,37428,13.66265,273944
2990,dennisgl,2,0.00073,37430,13.66338,273944
2991,densh,2,0.00073,37432,13.66411,273944
2992,denyskoch,2,0.00073,37434,13.66484,273944
2993,dericgw,2,0.00073,37436,13.66557,273944
2994,DerZyklop,2,0.00073,37438,13.66630,273944
2995,devmeyster,2,0.00073,37440,13.66703,273944
2996,devoto13,2,0.00073,37442,13.66776,273944
2997,devrchancay,2,0.00073,37444,13.66849,273944
2998,dfontenot,2,0.00073,37446,13.66922,273944
2999,dfrownfelter,2,0.00073,37448,13.66995,273944
3000,dgilbert,2,0.00073,37450,13.67068,273944
3001,dgp1130,2,0.00073,37452,13.67141,273944
3002,dharaburda,2,0.00073,37454,13.67214,273944
3003,dhiru30,2,0.00073,37456,13.67287,273944
3004,dhurlburtusa,2,0.00073,37458,13.67360,273944
3005,diegofss11,2,0.00073,37460,13.67433,273944
3006,diegomrsantos,2,0.00073,37462,13.67506,273944
3007,difelice,2,0.00073,37464,13.67579,273944
3008,digitaldrummerj,2,0.00073,37466,13.67652,273944
3009,dimapaloskin,2,0.00073,37468,13.67725,273944
3010,dirkfeytons,2,0.00073,37470,13.67798,273944
3011,diyews,2,0.00073,37472,13.67871,273944
3012,djrodgerspryor,2,0.00073,37474,13.67944,273944
3013,dlax,2,0.00073,37476,13.68017,273944
3014,dlink,2,0.00073,37478,13.68090,273944
3015,dlstucki,2,0.00073,37480,13.68163,273944
3016,dmaslov,2,0.00073,37482,13.68236,273944
3017,dmnd,2,0.00073,37484,13.68309,273944
3018,dnalborczyk,2,0.00073,37486,13.68382,273944
3019,Doehl,2,0.00073,37488,13.68455,273944
3020,domoritz,2,0.00073,37490,13.68528,273944
3021,domusofsail,2,0.00073,37492,13.68601,273944
3022,dotLou,2,0.00073,37494,13.68674,273944
3023,dotzero,2,0.00073,37496,13.68747,273944
3024,douglasgimli,2,0.00073,37498,13.68820,273944
3025,douglasnaphas,2,0.00073,37500,13.68893,273944
3026,dpercy,2,0.00073,37502,13.68966,273944
3027,dpismenny,2,0.00073,37504,13.69039,273944
3028,dpurp,2,0.00073,37506,13.69112,273944
3029,drazisil,2,0.00073,37508,13.69185,273944
3030,drewnoakes,2,0.00073,37510,13.69258,273944
3031,Dreyer,2,0.00073,37512,13.69331,273944
3032,dreyks,2,0.00073,37514,13.69404,273944
3033,DrMarcII,2,0.00073,37516,13.69477,273944
3034,drmonkeyninja,2,0.00073,37518,13.69550,273944
3035,Droogans,2,0.00073,37520,13.69623,273944
3036,DrPizza,2,0.00073,37522,13.69696,273944
3037,drpoggi,2,0.00073,37524,13.69769,273944
3038,drusin,2,0.00073,37526,13.69842,273944
3039,dskells,2,0.00073,37528,13.69915,273944
3040,dufferzafar,2,0.00073,37530,13.69988,273944
3041,dummycode,2,0.00073,37532,13.70061,273944
3042,dumpstate,2,0.00073,37534,13.70134,273944
3043,duncanleung,2,0.00073,37536,13.70207,273944
3044,dushmis,2,0.00073,37538,13.70280,273944
3045,Duske,2,0.00073,37540,13.70353,273944
3046,dwanderton,2,0.00073,37542,13.70426,273944
3047,dxuehu,2,0.00073,37544,13.70499,273944
3048,dylanseago,2,0.00073,37546,13.70572,273944
3049,dyrock,2,0.00073,37548,13.70645,273944
3050,dzonatan,2,0.00073,37550,13.70718,273944
3051,eadordzhiev,2,0.00073,37552,13.70791,273944
3052,eagleeye,2,0.00073,37554,13.70864,273944
3053,e-cloud,2,0.00073,37556,13.70937,273944
3054,ecnepsnai,2,0.00073,37558,13.71010,273944
3055,eddyerburgh,2,0.00073,37560,13.71083,273944
3056,EdricChan03,2,0.00073,37562,13.71156,273944
3057,eduard9x,2,0.00073,37564,13.71229,273944
3058,eeeqxxtg,2,0.00073,37566,13.71302,273944
3059,eemeli,2,0.00073,37568,13.71375,273944
3060,eeue56,2,0.00073,37570,13.71448,273944
3061,ehmicky,2,0.00073,37572,13.71521,273944
3062,Eisermann,2,0.00073,37574,13.71594,273944
3063,ekkis,2,0.00073,37576,13.71667,273944
3064,elbaloo,2,0.00073,37578,13.71740,273944
3065,ElForastero,2,0.00073,37580,13.71813,273944
3066,Elhebert,2,0.00073,37582,13.71886,273944
3067,elkdanger,2,0.00073,37584,13.71959,273944
3068,eloytoro,2,0.00073,37586,13.72032,273944
3069,ElRaph,2,0.00073,37588,13.72105,273944
3070,elvisbegovic,2,0.00073,37590,13.72178,273944
3071,emedws,2,0.00073,37592,13.72251,273944
3072,EmericBr,2,0.00073,37594,13.72324,273944
3073,emilio,2,0.00073,37596,13.72397,273944
3074,EmilTholin,2,0.00073,37598,13.72470,273944
3075,emmanne08,2,0.00073,37600,13.72543,273944
3076,emmanuelbernard,2,0.00073,37602,13.72616,273944
3077,enkore,2,0.00073,37604,13.72689,273944
3078,EnoahNetzach,2,0.00073,37606,13.72762,273944
3079,enqode-hub,2,0.00073,37608,13.72835,273944
3080,enriquedacostacambio,2,0.00073,37610,13.72908,273944
3081,eoneill,2,0.00073,37612,13.72981,273944
3082,epps,2,0.00073,37614,13.73054,273944
3083,epsitec,2,0.00073,37616,13.73127,273944
3084,ericdouglas,2,0.00073,37618,13.73200,273944
3085,erictsangx,2,0.00073,37620,13.73273,273944
3086,EricWhiteDev,2,0.00073,37622,13.73346,273944
3087,eriol,2,0.00073,37624,13.73419,273944
3088,Ermiar,2,0.00073,37626,13.73492,273944
3089,Errorname,2,0.00073,37628,13.73565,273944
3090,erykwalder,2,0.00073,37630,13.73638,273944
3091,esagawe,2,0.00073,37632,13.73711,273944
3092,esr360,2,0.00073,37634,13.73784,273944
3093,eternalharvest,2,0.00073,37636,13.73857,273944
3094,Ethan-Arrowood,2,0.00073,37638,13.73930,273944
3095,ethanbeyer,2,0.00073,37640,13.74003,273944
3096,ethanwood17,2,0.00073,37642,13.74076,273944
3097,etiktin,2,0.00073,37644,13.74149,273944
3098,EugeneGarbuzov,2,0.00073,37646,13.74222,273944
3099,evancarey,2,0.00073,37648,13.74295,273944
3100,evgenyt1,2,0.00073,37650,13.74368,273944
3101,exvito,2,0.00073,37652,13.74441,273944
3102,EyalRonel,2,0.00073,37654,13.74514,273944
3103,EzequielB,2,0.00073,37656,13.74588,273944
3104,fa137,2,0.00073,37658,13.74661,273944
3105,fabiomcosta,2,0.00073,37660,13.74734,273944
3106,fabriciomurta,2,0.00073,37662,13.74807,273944
3107,faheel,2,0.00073,37664,13.74880,273944
3108,falms,2,0.00073,37666,13.74953,273944
3109,fasterthanlime,2,0.00073,37668,13.75026,273944
3110,fatso83,2,0.00073,37670,13.75099,273944
3111,fbergr,2,0.00073,37672,13.75172,273944
3112,FDIM,2,0.00073,37674,13.75245,273944
3113,fedesasso,2,0.00073,37676,13.75318,273944
3114,feelepxyz,2,0.00073,37678,13.75391,273944
3115,FelAl,2,0.00073,37680,13.75464,273944
3116,felipepessoto,2,0.00073,37682,13.75537,273944
3117,felixmosh,2,0.00073,37684,13.75610,273944
3118,felvhage,2,0.00073,37686,13.75683,273944
3119,fgreinacher,2,0.00073,37688,13.75756,273944
3120,firrae,2,0.00073,37690,13.75829,273944
3121,fishbar,2,0.00073,37692,13.75902,273944
3122,fkgozali,2,0.00073,37694,13.75975,273944
3123,FlashSheridan,2,0.00073,37696,13.76048,273944
3124,flowlight0,2,0.00073,37698,13.76121,273944
3125,flxwu,2,0.00073,37700,13.76194,273944
3126,fmbandit,2,0.00073,37702,13.76267,273944
3127,fmvilas,2,0.00073,37704,13.76340,273944
3128,FokkeZB,2,0.00073,37706,13.76413,273944
3129,fommil,2,0.00073,37708,13.76486,273944
3130,fonziemedia,2,0.00073,37710,13.76559,273944
3131,foolmoron,2,0.00073,37712,13.76632,273944
3132,foomango,2,0.00073,37714,13.76705,273944
3133,forkfork,2,0.00073,37716,13.76778,273944
3134,Foxtrek64,2,0.00073,37718,13.76851,273944
3135,foyangyu,2,0.00073,37720,13.76924,273944
3136,fpoumian,2,0.00073,37722,13.76997,273944
3137,francisdb,2,0.00073,37724,13.77070,273944
3138,francois2metz,2,0.00073,37726,13.77143,273944
3139,frankmorgner,2,0.00073,37728,13.77216,273944
3140,FransBouma,2,0.00073,37730,13.77289,273944
3141,freddyboucher,2,0.00073,37732,13.77362,273944
3142,freeall,2,0.00073,37734,13.77435,273944
3143,frehner,2,0.00073,37736,13.77508,273944
3144,fridays,2,0.00073,37738,13.77581,273944
3145,frostming,2,0.00073,37740,13.77654,273944
3146,FRSgit,2,0.00073,37742,13.77727,273944
3147,galgeek,2,0.00073,37744,13.77800,273944
3148,gangsthub,2,0.00073,37746,13.77873,273944
3149,garethnic,2,0.00073,37748,13.77946,273944
3150,garrows,2,0.00073,37750,13.78019,273944
3151,garycourt,2,0.00073,37752,13.78092,273944
3152,gebilaoxiong,2,0.00073,37754,13.78165,273944
3153,geeknik,2,0.00073,37756,13.78238,273944
3154,geekrumper,2,0.00073,37758,13.78311,273944
3155,gengjiawen,2,0.00073,37760,13.78384,273944
3156,geoffthorpe,2,0.00073,37762,13.78457,273944
3157,georgekosmidis,2,0.00073,37764,13.78530,273944
3158,georgeonofrei,2,0.00073,37766,13.78603,273944
3159,GeorgiChochov,2,0.00073,37768,13.78676,273944
3160,gfoust,2,0.00073,37770,13.78749,273944
3161,ghardin137,2,0.00073,37772,13.78822,273944
3162,ghostd,2,0.00073,37774,13.78895,273944
3163,ghuntley,2,0.00073,37776,13.78968,273944
3164,gilchenzion,2,0.00073,37778,13.79041,273944
3165,g-k,2,0.00073,37780,13.79114,273944
3166,gkwang,2,0.00073,37782,13.79187,273944
3167,glassdimly,2,0.00073,37784,13.79260,273944
3168,Glazy,2,0.00073,37786,13.79333,273944
3169,glegrain,2,0.00073,37788,13.79406,273944
3170,glenstaes,2,0.00073,37790,13.79479,273944
3171,glombek,2,0.00073,37792,13.79552,273944
3172,gnovack,2,0.00073,37794,13.79625,273944
3173,goenning,2,0.00073,37796,13.79698,273944
3174,gomel4ever,2,0.00073,37798,13.79771,273944
3175,gonzalez,2,0.00073,37800,13.79844,273944
3176,gorbiz,2,0.00073,37802,13.79917,273944
3177,g-palmer,2,0.00073,37804,13.79990,273944
3178,gparlakov,2,0.00073,37806,13.80063,273944
3179,gpspake,2,0.00073,37808,13.80136,273944
3180,gr2m,2,0.00073,37810,13.80209,273944
3181,gracebenz,2,0.00073,37812,13.80282,273944
3182,Grasseh,2,0.00073,37814,13.80355,273944
3183,Green-Bug,2,0.00073,37816,13.80428,273944
3184,greggunner,2,0.00073,37818,13.80501,273944
3185,gregkalapos,2,0.00073,37820,13.80574,273944
3186,GregoryPorter,2,0.00073,37822,13.80647,273944
3187,griffinmyers,2,0.00073,37824,13.80720,273944
3188,grisha-kotler,2,0.00073,37826,13.80793,273944
3189,groninge01,2,0.00073,37828,13.80866,273944
3190,Grygir,2,0.00073,37830,13.80939,273944
3191,gsklee,2,0.00073,37832,13.81012,273944
3192,gswalden,2,0.00073,37834,13.81085,273944
3193,gucluoz,2,0.00073,37836,13.81158,273944
3194,guiguan,2,0.00073,37838,13.81231,273944
3195,guimon,2,0.00073,37840,13.81304,273944
3196,guiruiz,2,0.00073,37842,13.81377,273944
3197,guox191,2,0.00073,37844,13.81450,273944
3198,gu-xionghong,2,0.00073,37846,13.81523,273944
3199,gxvv,2,0.00073,37848,13.81596,273944
3200,gyfis,2,0.00073,37850,13.81669,273944
3201,gzm0,2,0.00073,37852,13.81742,273944
3202,hadrienk,2,0.00073,37854,13.81815,273944
3203,haishengwu-okta,2,0.00073,37856,13.81888,273944
3204,hajekj,2,0.00073,37858,13.81961,273944
3205,halitogunc,2,0.00073,37860,13.82034,273944
3206,hamish-rose,2,0.00073,37862,13.82107,273944
3207,hans-kinnek,2,0.00073,37864,13.82180,273944
3208,hariberry,2,0.00073,37866,13.82253,273944
3209,harishgadiya,2,0.00073,37868,13.82326,273944
3210,HarveyZhang,2,0.00073,37870,13.82399,273944
3211,haubi,2,0.00073,37872,13.82472,273944
3212,haveo,2,0.00073,37874,13.82545,273944
3213,haveyaseen,2,0.00073,37876,13.82618,273944
3214,hawkrives,2,0.00073,37878,13.82691,273944
3215,hbrotan,2,0.00073,37880,13.82764,273944
3216,hc-codersatlas,2,0.00073,37882,13.82837,273944
3217,heavybeard,2,0.00073,37884,13.82910,273944
3218,hehachris,2,0.00073,37886,13.82983,273944
3219,helio-frota,2,0.00073,37888,13.83056,273944
3220,hemp,2,0.00073,37890,13.83129,273944
3221,hendricius,2,0.00073,37892,13.83202,273944
3222,hgwood,2,0.00073,37894,13.83275,273944
3223,hhua1120,2,0.00073,37896,13.83348,273944
3224,hibnico,2,0.00073,37898,13.83421,273944
3225,hikaru-light,2,0.00073,37900,13.83494,273944
3226,himynameisdave,2,0.00073,37902,13.83567,273944
3227,HiveSolution,2,0.00073,37904,13.83640,273944
3228,hjmoss,2,0.00073,37906,13.83713,273944
3229,hknielsen,2,0.00073,37908,13.83786,273944
3230,hleumas,2,0.00073,37910,13.83859,273944
3231,hmethvin,2,0.00073,37912,13.83932,273944
3232,HornyakBence,2,0.00073,37914,13.84005,273944
3233,HotelDon,2,0.00073,37916,13.84078,273944
3234,hotforfeature,2,0.00073,37918,13.84152,273944
3235,hshn,2,0.00073,37920,13.84225,273944
3236,htmldoug,2,0.00073,37922,13.84298,273944
3237,huaoguo,2,0.00073,37924,13.84371,273944
3238,huerlisi,2,0.00073,37926,13.84444,273944
3239,hugomn,2,0.00073,37928,13.84517,273944
3240,hxsf,2,0.00073,37930,13.84590,273944
3241,h-yamamo,2,0.00073,37932,13.84663,273944
3242,hypersw,2,0.00073,37934,13.84736,273944
3243,iainnicol,2,0.00073,37936,13.84809,273944
3244,ianobermiller,2,0.00073,37938,13.84882,273944
3245,iarna,2,0.00073,37940,13.84955,273944
3246,iblamefish,2,0.00073,37942,13.85028,273944
3247,iconoeugen,2,0.00073,37944,13.85101,273944
3248,idg10,2,0.00073,37946,13.85174,273944
3249,idlerboris,2,0.00073,37948,13.85247,273944
3250,ieatfood,2,0.00073,37950,13.85320,273944
3251,IeuanG,2,0.00073,37952,13.85393,273944
3252,igorline,2,0.00073,37954,13.85466,273944
3253,iilei,2,0.00073,37956,13.85539,273944
3254,IlCallo,2,0.00073,37958,13.85612,273944
3255,iliasch,2,0.00073,37960,13.85685,273944
3256,ilyasidorchik,2,0.00073,37962,13.85758,273944
3257,imagentleman,2,0.00073,37964,13.85831,273944
3258,imba-tjd,2,0.00073,37966,13.85904,273944
3259,ImgBotApp,2,0.00073,37968,13.85977,273944
3260,imikay,2,0.00073,37970,13.86050,273944
3261,imjanghyuk,2,0.00073,37972,13.86123,273944
3262,IndigoVerge,2,0.00073,37974,13.86196,273944
3263,indrimuska,2,0.00073,37976,13.86269,273944
3264,indutny,2,0.00073,37978,13.86342,273944
3265,inkinworld,2,0.00073,37980,13.86415,273944
3266,insin,2,0.00073,37982,13.86488,273944
3267,int64ago,2,0.00073,37984,13.86561,273944
3268,ipeters90,2,0.00073,37986,13.86634,273944
3269,ipinak,2,0.00073,37988,13.86707,273944
3270,iRumba,2,0.00073,37990,13.86780,273944
3271,isaacplmann,2,0.00073,37992,13.86853,273944
3272,isnotnick,2,0.00073,37994,13.86926,273944
3273,istarkov,2,0.00073,37996,13.86999,273944
3274,istudens,2,0.00073,37998,13.87072,273944
3275,itamark,2,0.00073,38000,13.87145,273944
3276,itchyny,2,0.00073,38002,13.87218,273944
3277,ivandevp,2,0.00073,38004,13.87291,273944
3278,ivan-kleshnin,2,0.00073,38006,13.87364,273944
3279,ivikash,2,0.00073,38008,13.87437,273944
3280,ivoanjo,2,0.00073,38010,13.87510,273944
3281,ivomju,2,0.00073,38012,13.87583,273944
3282,J3remyD,2,0.00073,38014,13.87656,273944
3283,j4nw,2,0.00073,38016,13.87729,273944
3284,jaaberg,2,0.00073,38018,13.87802,273944
3285,jablko,2,0.00073,38020,13.87875,273944
3286,jacktan1991,2,0.00073,38022,13.87948,273944
3287,JacobJohansen,2,0.00073,38024,13.88021,273944
3288,jacobrask,2,0.00073,38026,13.88094,273944
3289,jacobscarter,2,0.00073,38028,13.88167,273944
3290,Jaco-Pretorius,2,0.00073,38030,13.88240,273944
3291,jadarnel27,2,0.00073,38032,13.88313,273944
3292,Jaehlee11,2,0.00073,38034,13.88386,273944
3293,jagomf,2,0.00073,38036,13.88459,273944
3294,jahraphael,2,0.00073,38038,13.88532,273944
3295,jahumes,2,0.00073,38040,13.88605,273944
3296,JakeChampion,2,0.00073,38042,13.88678,273944
3297,jakewins,2,0.00073,38044,13.88751,273944
3298,jalbrzym,2,0.00073,38046,13.88824,273944
3299,Jamaks,2,0.00073,38048,13.88897,273944
3300,jamedranoa,2,0.00073,38050,13.88970,273944
3301,james4388,2,0.00073,38052,13.89043,273944
3302,JamesBoon,2,0.00073,38054,13.89116,273944
3303,james-callahan,2,0.00073,38056,13.89189,273944
3304,jamesgpearce,2,0.00073,38058,13.89262,273944
3305,jamessawle,2,0.00073,38060,13.89335,273944
3306,jameswomack,2,0.00073,38062,13.89408,273944
3307,Jamim,2,0.00073,38064,13.89481,273944
3308,JanDalF,2,0.00073,38066,13.89554,273944
3309,JandersonConstantino,2,0.00073,38068,13.89627,273944
3310,jandockx,2,0.00073,38070,13.89700,273944
3311,Janfred,2,0.00073,38072,13.89773,273944
3312,JanisE,2,0.00073,38074,13.89846,273944
3313,jannic,2,0.00073,38076,13.89919,273944
3314,jasongrlicky,2,0.00073,38078,13.89992,273944
3315,jasonwilliams,2,0.00073,38080,13.90065,273944
3316,javache,2,0.00073,38082,13.90138,273944
3317,javkhaanj7,2,0.00073,38084,13.90211,273944
3318,jaykrell,2,0.00073,38086,13.90284,273944
3319,jayspringate,2,0.00073,38088,13.90357,273944
3320,jayvdb,2,0.00073,38090,13.90430,273944
3321,jbandi,2,0.00073,38092,13.90503,273944
3322,jbarnettwomply,2,0.00073,38094,13.90576,273944
3323,jbe2277,2,0.00073,38096,13.90649,273944
3324,JBeatz,2,0.00073,38098,13.90722,273944
3325,jbelien,2,0.00073,38100,13.90795,273944
3326,jbenoit2011,2,0.00073,38102,13.90868,273944
3327,jbialobr,2,0.00073,38104,13.90941,273944
3328,jboavida,2,0.00073,38106,13.91014,273944
3329,jbonta,2,0.00073,38108,13.91087,273944
3330,jborgland,2,0.00073,38110,13.91160,273944
3331,jchiatt,2,0.00073,38112,13.91233,273944
3332,jcrben,2,0.00073,38114,13.91306,273944
3333,jcready,2,0.00073,38116,13.91379,273944
3334,jcspader,2,0.00073,38118,13.91452,273944
3335,jdanil,2,0.00073,38120,13.91525,273944
3336,jd-carroll,2,0.00073,38122,13.91598,273944
3337,jdelStrother,2,0.00073,38124,13.91671,273944
3338,jdorfman,2,0.00073,38126,13.91744,273944
3339,jdufresne,2,0.00073,38128,13.91817,273944
3340,jedesah,2,0.00073,38130,13.91890,273944
3341,jedwards1211,2,0.00073,38132,13.91963,273944
3342,JeffCyr,2,0.00073,38134,13.92036,273944
3343,jeffhandley,2,0.00073,38136,13.92109,273944
3344,jeffreypriebe,2,0.00073,38138,13.92182,273944
3345,JeffreyZhao,2,0.00073,38140,13.92255,273944
3346,Jefiozie,2,0.00073,38142,13.92328,273944
3347,jenjwong,2,0.00073,38144,13.92401,273944
3348,jennifer-mann,2,0.00073,38146,13.92474,273944
3349,jennyraj,2,0.00073,38148,13.92547,273944
3350,jeremenichelli,2,0.00073,38150,13.92620,273944
3351,jeremyruppel,2,0.00073,38152,13.92693,273944
3352,jerome-nelson,2,0.00073,38154,13.92766,273944
3353,jessebeach,2,0.00073,38156,13.92839,273944
3354,jessicamvs,2,0.00073,38158,13.92912,273944
3355,jessycormier,2,0.00073,38160,13.92985,273944
3356,jgalat,2,0.00073,38162,13.93058,273944
3357,jghaines,2,0.00073,38164,13.93131,273944
3358,jhabdas,2,0.00073,38166,13.93204,273944
3359,jhamm,2,0.00073,38168,13.93277,273944
3360,jharris4,2,0.00073,38170,13.93350,273944
3361,jhnaldo,2,0.00073,38172,13.93423,273944
3362,jiabaowu,2,0.00073,38174,13.93496,273944
3363,JianMeng,2,0.00073,38176,13.93569,273944
3364,jiayihu,2,0.00073,38178,13.93642,273944
3365,jileeon,2,0.00073,38180,13.93716,273944
3366,Jimbly,2,0.00073,38182,13.93789,273944
3367,JimiHFord,2,0.00073,38184,13.93862,273944
3368,jiminikiz,2,0.00073,38186,13.93935,273944
3369,jimlloyd,2,0.00073,38188,13.94008,273944
3370,jimmywarting,2,0.00073,38190,13.94081,273944
3371,jimthedev,2,0.00073,38192,13.94154,273944
3372,jjware,2,0.00073,38194,13.94227,273944
3373,jmaebe,2,0.00073,38196,13.94300,273944
3374,jmbyerly,2,0.00073,38198,13.94373,273944
3375,jmendeth,2,0.00073,38200,13.94446,273944
3376,jnaputi253,2,0.00073,38202,13.94519,273944
3377,joakimbl,2,0.00073,38204,13.94592,273944
3378,jochenberger,2,0.00073,38206,13.94665,273944
3379,joe2018Outlookcom,2,0.00073,38208,13.94738,273944
3380,joearasin,2,0.00073,38210,13.94811,273944
3381,joefreeman,2,0.00073,38212,13.94884,273944
3382,joej164,2,0.00073,38214,13.94957,273944
3383,joejordanbrown,2,0.00073,38216,13.95030,273944
3384,joekrill,2,0.00073,38218,13.95103,273944
3385,joel-leitch,2,0.00073,38220,13.95176,273944
3386,joelongstreet,2,0.00073,38222,13.95249,273944
3387,joeratt,2,0.00073,38224,13.95322,273944
3388,JohanLarsson,2,0.00073,38226,13.95395,273944
3389,johannes-scharlach,2,0.00073,38228,13.95468,273944
3390,joh-klein,2,0.00073,38230,13.95541,273944
3391,johnhoffman,2,0.00073,38232,13.95614,273944
3392,johnjohndoe,2,0.00073,38234,13.95687,273944
3393,johnlonganecker,2,0.00073,38236,13.95760,273944
3394,johnnyRose,2,0.00073,38238,13.95833,273944
3395,johntron,2,0.00073,38240,13.95906,273944
3396,joliss,2,0.00073,38242,13.95979,273944
3397,jolly-roger,2,0.00073,38244,13.96052,273944
3398,jonahkirangi,2,0.00073,38246,13.96125,273944
3399,jonathantyates,2,0.00073,38248,13.96198,273944
3400,jongear,2,0.00073,38250,13.96271,273944
3401,jo-ninja,2,0.00073,38252,13.96344,273944
3402,jonmill,2,0.00073,38254,13.96417,273944
3403,jonotron,2,0.00073,38256,13.96490,273944
3404,joongsoo,2,0.00073,38258,13.96563,273944
3405,jordanstephens,2,0.00073,38260,13.96636,273944
3406,jorgeucano,2,0.00073,38262,13.96709,273944
3407,JosephTremoulet,2,0.00073,38264,13.96782,273944
3408,joshalling,2,0.00073,38266,13.96855,273944
3409,JoshData,2,0.00073,38268,13.96928,273944
3410,joshdrees,2,0.00073,38270,13.97001,273944
3411,josherick,2,0.00073,38272,13.97074,273944
3412,joshgerdes,2,0.00073,38274,13.97147,273944
3413,joshuacaron,2,0.00073,38276,13.97220,273944
3414,JoshuaGross,2,0.00073,38278,13.97293,273944
3415,JoshuaJWilborn,2,0.00073,38280,13.97366,273944
3416,JoshuaKGoldberg,2,0.00073,38282,13.97439,273944
3417,JosVerburg,2,0.00073,38284,13.97512,273944
3418,JoviDeCroock,2,0.00073,38286,13.97585,273944
3419,joyzheng,2,0.00073,38288,13.97658,273944
3420,jpelcis,2,0.00073,38290,13.97731,273944
3421,jpkleemans,2,0.00073,38292,13.97804,273944
3422,jplebre,2,0.00073,38294,13.97877,273944
3423,jrocha,2,0.00073,38296,13.97950,273944
3424,jsayol,2,0.00073,38298,13.98023,273944
3425,jseabold,2,0.00073,38300,13.98096,273944
3426,jsto,2,0.00073,38302,13.98169,273944
3427,JTKnox91,2,0.00073,38304,13.98242,273944
3428,juandiana,2,0.00073,38306,13.98315,273944
3429,juangabreil,2,0.00073,38308,13.98388,273944
3430,juikim,2,0.00073,38310,13.98461,273944
3431,julen,2,0.00073,38312,13.98534,273944
3432,juliushardt,2,0.00073,38314,13.98607,273944
3433,julkwel,2,0.00073,38316,13.98680,273944
3434,JustATrick,2,0.00073,38318,13.98753,273944
3435,justincron,2,0.00073,38320,13.98826,273944
3436,jwbay,2,0.00073,38322,13.98899,273944
3437,jwworth,2,0.00073,38324,13.98972,273944
3438,kacf,2,0.00073,38326,13.99045,273944
3439,kachhalimbu,2,0.00073,38328,13.99118,273944
3440,Kachulio1,2,0.00073,38330,13.99191,273944
3441,Kahbazi,2,0.00073,38332,13.99264,273944
3442,kaigouthro,2,0.00073,38334,13.99337,273944
3443,KaiserItachi,2,0.00073,38336,13.99410,273944
3444,kambleaa007,2,0.00073,38338,13.99483,273944
3445,kamilkloch,2,0.00073,38340,13.99556,273944
3446,kaminskypavel,2,0.00073,38342,13.99629,273944
3447,kamranayub,2,0.00073,38344,13.99702,273944
3448,kamronbatman,2,0.00073,38346,13.99775,273944
3449,kant2002,2,0.00073,38348,13.99848,273944
3450,kapace,2,0.00073,38350,13.99921,273944
3451,karlhorky,2,0.00073,38352,13.99994,273944
3452,karthikb351,2,0.00073,38354,14.00067,273944
3453,kasperlewau,2,0.00073,38356,14.00140,273944
3454,kastentx,2,0.00073,38358,14.00213,273944
3455,kaufholdr,2,0.00073,38360,14.00286,273944
3456,kaylee42,2,0.00073,38362,14.00359,273944
3457,kemitchell,2,0.00073,38364,14.00432,273944
3458,kendaleiv,2,0.00073,38366,14.00505,273944
3459,ken-guru,2,0.00073,38368,14.00578,273944
3460,kenotron,2,0.00073,38370,14.00651,273944
3461,kevdonk,2,0.00073,38372,14.00724,273944
3462,kevgathuku,2,0.00073,38374,14.00797,273944
3463,kevinkucharczyk,2,0.00073,38376,14.00870,273944
3464,kevinSuttle,2,0.00073,38378,14.00943,273944
3465,kgajera,2,0.00073,38380,14.01016,273944
3466,KieranDotCo,2,0.00073,38382,14.01089,273944
3467,kikoanis,2,0.00073,38384,14.01162,273944
3468,kindy,2,0.00073,38386,14.01235,273944
3469,KirankumarAmbati,2,0.00073,38388,14.01308,273944
3470,kirillkh,2,0.00073,38390,14.01381,273944
3471,kirrg001,2,0.00073,38392,14.01454,273944
3472,kiyolee,2,0.00073,38394,14.01527,273944
3473,kkocel,2,0.00073,38396,14.01600,273944
3474,kkoopa,2,0.00073,38398,14.01673,273944
3475,kkopachev,2,0.00073,38400,14.01746,273944
3476,kkopanidis,2,0.00073,38402,14.01819,273944
3477,KlemenPlazar,2,0.00073,38404,14.01892,273944
3478,klimenko,2,0.00073,38406,14.01965,273944
3479,kmaida,2,0.00073,38408,14.02038,273944
3480,kmccullough,2,0.00073,38410,14.02111,273944
3481,knekritz,2,0.00073,38412,14.02184,273944
3482,kobake,2,0.00073,38414,14.02257,273944
3483,KoleMyers,2,0.00073,38416,14.02330,273944
3484,komainu8,2,0.00073,38418,14.02403,273944
3485,kopancek,2,0.00073,38420,14.02476,273944
3486,Kopyov,2,0.00073,38422,14.02549,273944
3487,kor-k,2,0.00073,38424,14.02622,273944
3488,korli,2,0.00073,38426,14.02695,273944
3489,kpping,2,0.00073,38428,14.02768,273944
3490,kpwbo,2,0.00073,38430,14.02841,273944
3491,krk,2,0.00073,38432,14.02914,273944
3492,kroky,2,0.00073,38434,14.02987,273944
3493,kruyvanna,2,0.00073,38436,14.03060,273944
3494,ktos,2,0.00073,38438,14.03133,273944
3495,kulabun,2,0.00073,38440,14.03206,273944
3496,kumarmj,2,0.00073,38442,14.03280,273944
3497,kumpera,2,0.00073,38444,14.03353,273944
3498,kuncevich,2,0.00073,38446,14.03426,273944
3499,kunukn,2,0.00073,38448,14.03499,273944
3500,kurtfurbush,2,0.00073,38450,14.03572,273944
3501,kvetis,2,0.00073,38452,14.03645,273944
3502,kwiateusz,2,0.00073,38454,14.03718,273944
3503,kwiatkk1,2,0.00073,38456,14.03791,273944
3504,kwonoj,2,0.00073,38458,14.03864,273944
3505,kwypchlo,2,0.00073,38460,14.03937,273944
3506,kylecho,2,0.00073,38462,14.04010,273944
3507,Lacaranian,2,0.00073,38464,14.04083,273944
3508,lachlanjc,2,0.00073,38466,14.04156,273944
3509,laiso,2,0.00073,38468,14.04229,273944
3510,laispace,2,0.00073,38470,14.04302,273944
3511,lakerko,2,0.00073,38472,14.04375,273944
3512,Landmaster,2,0.00073,38474,14.04448,273944
3513,landrok,2,0.00073,38476,14.04521,273944
3514,landvibe,2,0.00073,38478,14.04594,273944
3515,larsgrefer,2,0.00073,38480,14.04667,273944
3516,larsp,2,0.00073,38482,14.04740,273944
3517,lasekio,2,0.00073,38484,14.04813,273944
3518,lasthero,2,0.00073,38486,14.04886,273944
3519,lastland,2,0.00073,38488,14.04959,273944
3520,laur89,2,0.00073,38490,14.05032,273944
3521,LaurensN,2,0.00073,38492,14.05105,273944
3522,lazywithclass,2,0.00073,38494,14.05178,273944
3523,lbalmaceda,2,0.00073,38496,14.05251,273944
3524,lborgav,2,0.00073,38498,14.05324,273944
3525,lchesson,2,0.00073,38500,14.05397,273944
3526,LeeAdcock,2,0.00073,38502,14.05470,273944
3527,leehankyeol,2,0.00073,38504,14.05543,273944
3528,LeekAnarchism,2,0.00073,38506,14.05616,273944
3529,LeffeBakedBird,2,0.00073,38508,14.05689,273944
3530,lelandrichardson,2,0.00073,38510,14.05762,273944
3531,leobalter,2,0.00073,38512,14.05835,273944
3532,LeoLogeart,2,0.00073,38514,14.05908,273944
3533,leonardosouza,2,0.00073,38516,14.05981,273944
3534,lespacedunmatin,2,0.00073,38518,14.06054,273944
3535,LeSuisse,2,0.00073,38520,14.06127,273944
3536,Lette,2,0.00073,38522,14.06200,273944
3537,leventov,2,0.00073,38524,14.06273,273944
3538,levgaas,2,0.00073,38526,14.06346,273944
3539,lewisblackwood,2,0.00073,38528,14.06419,273944
3540,lght,2,0.00073,38530,14.06492,273944
3541,Liad91,2,0.00073,38532,14.06565,273944
3542,liamkeaton,2,0.00073,38534,14.06638,273944
3543,libHive,2,0.00073,38536,14.06711,273944
3544,libreninja,2,0.00073,38538,14.06784,273944
3545,libuk,2,0.00073,38540,14.06857,273944
3546,lifeiscontent,2,0.00073,38542,14.06930,273944
3547,liff,2,0.00073,38544,14.07003,273944
3548,light24bulbs,2,0.00073,38546,14.07076,273944
3549,lihaoyi,2,0.00073,38548,14.07149,273944
3550,linshunghuang,2,0.00073,38550,14.07222,273944
3551,lionelerard,2,0.00073,38552,14.07295,273944
3552,lislon,2,0.00073,38554,14.07368,273944
3553,listton,2,0.00073,38556,14.07441,273944
3554,liushmh,2,0.00073,38558,14.07514,273944
3555,livthomas,2,0.00073,38560,14.07587,273944
3556,lizhe2004,2,0.00073,38562,14.07660,273944
3557,llambda,2,0.00073,38564,14.07733,273944
3558,lleevvyy,2,0.00073,38566,14.07806,273944
3559,llorenspujol,2,0.00073,38568,14.07879,273944
3560,localstatic,2,0.00073,38570,14.07952,273944
3561,loganripplinger,2,0.00073,38572,14.08025,273944
3562,loicgasser,2,0.00073,38574,14.08098,273944
3563,lokson,2,0.00073,38576,14.08171,273944
3564,lolyonok,2,0.00073,38578,14.08244,273944
3565,lopesc,2,0.00073,38580,14.08317,273944
3566,lostintangent,2,0.00073,38582,14.08390,273944
3567,lotyrin,2,0.00073,38584,14.08463,273944
3568,louischatriot,2,0.00073,38586,14.08536,273944
3569,lovell,2,0.00073,38588,14.08609,273944
3570,lox,2,0.00073,38590,14.08682,273944
3571,lpinca,2,0.00073,38592,14.08755,273944
3572,LPTK,2,0.00073,38594,14.08828,273944
3573,lscspirit,2,0.00073,38596,14.08901,273944
3574,lsharir,2,0.00073,38598,14.08974,273944
3575,lucastetreault,2,0.00073,38600,14.09047,273944
3576,luciomartinez,2,0.00073,38602,14.09120,273944
3577,luftywiranda13,2,0.00073,38604,14.09193,273944
3578,luigiberrettini,2,0.00073,38606,14.09266,273944
3579,luka454,2,0.00073,38608,14.09339,273944
3580,lukasmatta,2,0.00073,38610,14.09412,273944
3581,lukasolson,2,0.00073,38612,14.09485,273944
3582,lukeb,2,0.00073,38614,14.09558,273944
3583,lukebelliveau,2,0.00073,38616,14.09631,273944
3584,lukeb-uk,2,0.00073,38618,14.09704,273944
3585,lukefrake,2,0.00073,38620,14.09777,273944
3586,lukehorvat,2,0.00073,38622,14.09850,273944
3587,lukewaite,2,0.00073,38624,14.09923,273944
3588,lukewestby,2,0.00073,38626,14.09996,273944
3589,lutzhorn,2,0.00073,38628,14.10069,273944
3590,lvn,2,0.00073,38630,14.10142,273944
3591,lyngaas,2,0.00073,38632,14.10215,273944
3592,lziest,2,0.00073,38634,14.10288,273944
3593,m0uneer,2,0.00073,38636,14.10361,273944
3594,m18,2,0.00073,38638,14.10434,273944
3595,m90,2,0.00073,38640,14.10507,273944
3596,MaadMax,2,0.00073,38642,14.10580,273944
3597,MaceWindu,2,0.00073,38644,14.10653,273944
3598,MacroChip,2,0.00073,38646,14.10726,273944
3599,madcampos,2,0.00073,38648,14.10799,273944
3600,madetara,2,0.00073,38650,14.10872,273944
3601,magnificode,2,0.00073,38652,14.10945,273944
3602,mahalde,2,0.00073,38654,14.11018,273944
3603,maleetz,2,0.00073,38656,14.11091,273944
3604,malgosiastp,2,0.00073,38658,14.11164,273944
3605,Manduro,2,0.00073,38660,14.11237,273944
3606,ManickaP,2,0.00073,38662,14.11310,273944
3607,manimis902,2,0.00073,38664,14.11383,273944
3608,ManishPatidar1,2,0.00073,38666,14.11456,273944
3609,manonthemat,2,0.00073,38668,14.11529,273944
3610,MansourFall,2,0.00073,38670,14.11602,273944
3611,mantasaudickas,2,0.00073,38672,14.11675,273944
3612,manuelschneider,2,0.00073,38674,14.11748,273944
3613,marcelosdm,2,0.00073,38676,14.11821,273944
3614,marcin-mazurek,2,0.00073,38678,14.11894,273944
3615,marcolino,2,0.00073,38680,14.11967,273944
3616,marcospassos,2,0.00073,38682,14.12040,273944
3617,mareklinka,2,0.00073,38684,14.12113,273944
3618,marionebl,2,0.00073,38686,14.12186,273944
3619,mariosouto,2,0.00073,38688,14.12259,273944
3620,mariotacke,2,0.00073,38690,14.12332,273944
3621,markgardner,2,0.00073,38692,14.12405,273944
3622,MarkHerhold,2,0.00073,38694,14.12478,273944
3623,MarkMurphy,2,0.00073,38696,14.12551,273944
3624,MarkPieszak,2,0.00073,38698,14.12624,273944
3625,MarkusSintonen,2,0.00073,38700,14.12697,273944
3626,marschall,2,0.00073,38702,14.12770,273944
3627,MarshallOfSound,2,0.00073,38704,14.12844,273944
3628,marta-krzyk-dev,2,0.00073,38706,14.12917,273944
3629,martingbrown,2,0.00073,38708,14.12990,273944
3630,MartinMa,2,0.00073,38710,14.13063,273944
3631,martinmcwhorter,2,0.00073,38712,14.13136,273944
3632,martinscholz83,2,0.00073,38714,14.13209,273944
3633,mashhoodr,2,0.00073,38716,14.13282,273944
3634,MasseGuillaume,2,0.00073,38718,14.13355,273944
3635,massic80,2,0.00073,38720,14.13428,273944
3636,mastermatt,2,0.00073,38722,14.13501,273944
3637,matanlurey,2,0.00073,38724,14.13574,273944
3638,mathuin,2,0.00073,38726,14.13647,273944
3639,matiaslarsson,2,0.00073,38728,14.13720,273944
3640,matt40k,2,0.00073,38730,14.13793,273944
3641,mattbdean,2,0.00073,38732,14.13866,273944
3642,matteofigus,2,0.00073,38734,14.13939,273944
3643,matthewdordal,2,0.00073,38736,14.14012,273944
3644,MatthewRayfield,2,0.00073,38738,14.14085,273944
3645,MatthewShotton,2,0.00073,38740,14.14158,273944
3646,MatthiasKunnen,2,0.00073,38742,14.14231,273944
3647,mattjanssen,2,0.00073,38744,14.14304,273944
3648,mattpolzin,2,0.00073,38746,14.14377,273944
3649,mattwarren,2,0.00073,38748,14.14450,273944
3650,maxbarnas,2,0.00073,38750,14.14523,273944
3651,maxschmeling,2,0.00073,38752,14.14596,273944
3652,maxwt,2,0.00073,38754,14.14669,273944
3653,mbrookes,2,0.00073,38756,14.14742,273944
3654,mcculls,2,0.00073,38758,14.14815,273944
3655,mcdado,2,0.00073,38760,14.14888,273944
3656,mchapman,2,0.00073,38762,14.14961,273944
3657,mchv,2,0.00073,38764,14.15034,273944
3658,mcpDESIGNS,2,0.00073,38766,14.15107,273944
3659,mdarveau,2,0.00073,38768,14.15180,273944
3660,mdlavin,2,0.00073,38770,14.15253,273944
3661,meDavid,2,0.00073,38772,14.15326,273944
3662,medikoo,2,0.00073,38774,14.15399,273944
3663,megastef,2,0.00073,38776,14.15472,273944
3664,Meir017,2,0.00073,38778,14.15545,273944
3665,meirotstein,2,0.00073,38780,14.15618,273944
3666,melbourne2991,2,0.00073,38782,14.15691,273944
3667,meliaxford,2,0.00073,38784,14.15764,273944
3668,mercutiodesign,2,0.00073,38786,14.15837,273944
3669,meziantou,2,0.00073,38788,14.15910,273944
3670,mfijas,2,0.00073,38790,14.15983,273944
3671,mfitz3,2,0.00073,38792,14.16056,273944
3672,mgenereu,2,0.00073,38794,14.16129,273944
3673,mgenware,2,0.00073,38796,14.16202,273944
3674,mgolovatiy-atconsulting-ru,2,0.00073,38798,14.16275,273944
3675,mguidotto,2,0.00073,38800,14.16348,273944
3676,mguinness,2,0.00073,38802,14.16421,273944
3677,mhadam,2,0.00073,38804,14.16494,273944
3678,mheiber,2,0.00073,38806,14.16567,273944
3679,mhibino,2,0.00073,38808,14.16640,273944
3680,mhujer,2,0.00073,38810,14.16713,273944
3681,micellius,2,0.00073,38812,14.16786,273944
3682,michaelaird,2,0.00073,38814,14.16859,273944
3683,michaelb958,2,0.00073,38816,14.16932,273944
3684,michaelbazos,2,0.00073,38818,14.17005,273944
3685,MichaelDeBoey,2,0.00073,38820,14.17078,273944
3686,michaelgmcd,2,0.00073,38822,14.17151,273944
3687,MichaelJGW,2,0.00073,38824,14.17224,273944
3688,MicheleBertoli,2,0.00073,38826,14.17297,273944
3689,miguelc1221,2,0.00073,38828,14.17370,273944
3690,MiguelMadero,2,0.00073,38830,14.17443,273944
3691,miguelmota,2,0.00073,38832,14.17516,273944
3692,mihbor,2,0.00073,38834,14.17589,273944
3693,mikaelstaldal,2,0.00073,38836,14.17662,273944
3694,mikejacobson,2,0.00073,38838,14.17735,273944
3695,mikeldpl,2,0.00073,38840,14.17808,273944
3696,MikeRalphson,2,0.00073,38842,14.17881,273944
3697,mikernet,2,0.00073,38844,14.17954,273944
3698,MikeyBeLike,2,0.00073,38846,14.18027,273944
3699,milesj,2,0.00073,38848,14.18100,273944
3700,miloszkukla,2,0.00073,38850,14.18173,273944
3701,Minilfat,2,0.00073,38852,14.18246,273944
3702,miquelruiz,2,0.00073,38854,14.18319,273944
3703,miraage,2,0.00073,38856,14.18392,273944
3704,Mischi,2,0.00073,38858,14.18465,273944
3705,Mixpa,2,0.00073,38860,14.18538,273944
3706,mjp41,2,0.00073,38862,14.18611,273944
3707,mjschranz,2,0.00073,38864,14.18684,273944
3708,mjwwit,2,0.00073,38866,14.18757,273944
3709,mkalish,2,0.00073,38868,14.18830,273944
3710,mkasperski,2,0.00073,38870,14.18903,273944
3711,mkordas,2,0.00073,38872,14.18976,273944
3712,mk-pmb,2,0.00073,38874,14.19049,273944
3713,mlrv,2,0.00073,38876,14.19122,273944
3714,mlwilkerson,2,0.00073,38878,14.19195,273944
3715,mmiszy,2,0.00073,38880,14.19268,273944
3716,mmiyashita,2,0.00073,38882,14.19341,273944
3717,moacirosa,2,0.00073,38884,14.19414,273944
3718,MoFtZ,2,0.00073,38886,14.19487,273944
3719,mondwan,2,0.00073,38888,14.19560,273944
3720,monosoul,2,0.00073,38890,14.19633,273944
3721,Moorzee,2,0.00073,38892,14.19706,273944
3722,moretti,2,0.00073,38894,14.19779,273944
3723,morgoth,2,0.00073,38896,14.19852,273944
3724,morgsmccauley,2,0.00073,38898,14.19925,273944
3725,moshen,2,0.00073,38900,14.19998,273944
3726,Mottie,2,0.00073,38902,14.20071,273944
3727,mourahi,2,0.00073,38904,14.20144,273944
3728,mperrando,2,0.00073,38906,14.20217,273944
3729,mpiotrowicz,2,0.00073,38908,14.20290,273944
3730,mplonka,2,0.00073,38910,14.20363,273944
3731,mpollmeier,2,0.00073,38912,14.20436,273944
3732,MrJean,2,0.00073,38914,14.20509,273944
3733,MrRexZ,2,0.00073,38916,14.20582,273944
3734,mseemann,2,0.00073,38918,14.20655,273944
3735,MSK61,2,0.00073,38920,14.20728,273944
3736,msosa,2,0.00073,38922,14.20801,273944
3737,ms-tg,2,0.00073,38924,14.20874,273944
3738,mszabo-wikia,2,0.00073,38926,14.20947,273944
3739,mtharrison,2,0.00073,38928,14.21020,273944
3740,mtrdp642,2,0.00073,38930,14.21093,273944
3741,mtrojnar,2,0.00073,38932,14.21166,273944
3742,mtsmfm,2,0.00073,38934,14.21239,273944
3743,mukrop,2,0.00073,38936,14.21312,273944
3744,mukulhase,2,0.00073,38938,14.21385,273944
3745,murashki,2,0.00073,38940,14.21458,273944
3746,murbar,2,0.00073,38942,14.21531,273944
3747,murtazahaveliwala,2,0.00073,38944,14.21604,273944
3748,musclor,2,0.00073,38946,14.21677,273944
3749,musou1500,2,0.00073,38948,14.21750,273944
3750,mustela,2,0.00073,38950,14.21823,273944
3751,mweibel,2,0.00073,38952,14.21896,273944
3752,mykolaharmash,2,0.00073,38954,14.21969,273944
3753,mzabriskie,2,0.00073,38956,14.22042,273944
3754,mzdunek93,2,0.00073,38958,14.22115,273944
3755,mzdv,2,0.00073,38960,14.22188,273944
3756,mzitnik,2,0.00073,38962,14.22261,273944
3757,mzuehlke,2,0.00073,38964,14.22334,273944
3758,n3tr,2,0.00073,38966,14.22407,273944
3759,n8schloss,2,0.00073,38968,14.22481,273944
3760,naartjie,2,0.00073,38970,14.22554,273944
3761,nachtwandler,2,0.00073,38972,14.22627,273944
3762,Nadia--,2,0.00073,38974,14.22700,273944
3763,naferx,2,0.00073,38976,14.22773,273944
3764,nafg,2,0.00073,38978,14.22846,273944
3765,nahuel,2,0.00073,38980,14.22919,273944
3766,NameFILIP,2,0.00073,38982,14.22992,273944
3767,namhong2001,2,0.00073,38984,14.23065,273944
3768,nanomosfet,2,0.00073,38986,14.23138,273944
3769,Naragato,2,0.00073,38988,14.23211,273944
3770,nasitra,2,0.00073,38990,14.23284,273944
3771,nasserghiasi,2,0.00073,38992,14.23357,273944
3772,NateEag,2,0.00073,38994,14.23430,273944
3773,navaati,2,0.00073,38996,14.23503,273944
3774,NaveenShivanna86,2,0.00073,38998,14.23576,273944
3775,nazar-pc,2,0.00073,39000,14.23649,273944
3776,nbali,2,0.00073,39002,14.23722,273944
3777,nblka,2,0.00073,39004,14.23795,273944
3778,necinc,2,0.00073,39006,14.23868,273944
3779,nedbat,2,0.00073,39008,14.23941,273944
3780,NekR,2,0.00073,39010,14.24014,273944
3781,nename0,2,0.00073,39012,14.24087,273944
3782,Nepomuceno,2,0.00073,39014,14.24160,273944
3783,nerai,2,0.00073,39016,14.24233,273944
3784,nextgenthemes,2,0.00073,39018,14.24306,273944
3785,nfriend,2,0.00073,39020,14.24379,273944
3786,ngg,2,0.00073,39022,14.24452,273944
3787,ngoyal,2,0.00073,39024,14.24525,273944
3788,NGPixel,2,0.00073,39026,14.24598,273944
3789,ngrieble,2,0.00073,39028,14.24671,273944
3790,nhardy,2,0.00073,39030,14.24744,273944
3791,nhodges,2,0.00073,39032,14.24817,273944
3792,nickclaw,2,0.00073,39034,14.24890,273944
3793,NickHeiner,2,0.00073,39036,14.24963,273944
3794,nickmerwin,2,0.00073,39038,14.25036,273944
3795,Nico385412,2,0.00073,39040,14.25109,273944
3796,nicolasmccurdy,2,0.00073,39042,14.25182,273944
3797,NicoLB,2,0.00073,39044,14.25255,273944
3798,nielsbom,2,0.00073,39046,14.25328,273944
3799,niftylettuce,2,0.00073,39048,14.25401,273944
3800,nihgwu,2,0.00073,39050,14.25474,273944
3801,NikaBuligini,2,0.00073,39052,14.25547,273944
3802,nikoudel,2,0.00073,39054,14.25620,273944
3803,niksudan,2,0.00073,39056,14.25693,273944
3804,Nilegfx,2,0.00073,39058,14.25766,273944
3805,nimaa77,2,0.00073,39060,14.25839,273944
3806,nimrod-becker,2,0.00073,39062,14.25912,273944
3807,ninesalt,2,0.00073,39064,14.25985,273944
3808,niustephanie,2,0.00073,39066,14.26058,273944
3809,nju33,2,0.00073,39068,14.26131,273944
3810,nkbt,2,0.00073,39070,14.26204,273944
3811,nmalaguti,2,0.00073,39072,14.26277,273944
3812,noahadams,2,0.00073,39074,14.26350,273944
3813,nolanlawson,2,0.00073,39076,14.26423,273944
3814,Nonemoticoner,2,0.00073,39078,14.26496,273944
3815,nono,2,0.00073,39080,14.26569,273944
3816,nowke,2,0.00073,39082,14.26642,273944
3817,noynir,2,0.00073,39084,14.26715,273944
3818,nstdio,2,0.00073,39086,14.26788,273944
3819,NTag,2,0.00073,39088,14.26861,273944
3820,ntkme,2,0.00073,39090,14.26934,273944
3821,ntotten,2,0.00073,39092,14.27007,273944
3822,NubCoda,2,0.00073,39094,14.27080,273944
3823,nuc,2,0.00073,39096,14.27153,273944
3824,null511,2,0.00073,39098,14.27226,273944
3825,nutboltu,2,0.00073,39100,14.27299,273944
3826,obligaron,2,0.00073,39102,14.27372,273944
3827,ObsidianMinor,2,0.00073,39104,14.27445,273944
3828,ochameau,2,0.00073,39106,14.27518,273944
3829,ochanje210,2,0.00073,39108,14.27591,273944
3830,oculus42,2,0.00073,39110,14.27664,273944
3831,oddui,2,0.00073,39112,14.27737,273944
3832,ogom,2,0.00073,39114,14.27810,273944
3833,oiva,2,0.00073,39116,14.27883,273944
3834,ojab,2,0.00073,39118,14.27956,273944
3835,okmr-d,2,0.00073,39120,14.28029,273944
3836,olafurpg,2,0.00073,39122,14.28102,273944
3837,older,2,0.00073,39124,14.28175,273944
3838,olegdunkan,2,0.00073,39126,14.28248,273944
3839,oleggolovkovuss,2,0.00073,39128,14.28321,273944
3840,OlenDavis,2,0.00073,39130,14.28394,273944
3841,OliverJAsh,2,0.00073,39132,14.28467,273944
3842,olivierkaisin,2,0.00073,39134,14.28540,273944
3843,olof,2,0.00073,39136,14.28613,273944
3844,olsonpm,2,0.00073,39138,14.28686,273944
3845,Om4ar,2,0.00073,39140,14.28759,273944
3846,OMantere,2,0.00073,39142,14.28832,273944
3847,omidfi,2,0.00073,39144,14.28905,273944
3848,Omniroot,2,0.00073,39146,14.28978,273944
3849,oncletom,2,0.00073,39148,14.29051,273944
3850,onokumus,2,0.00073,39150,14.29124,273944
3851,ooflorent,2,0.00073,39152,14.29197,273944
3852,opencrypto,2,0.00073,39154,14.29270,273944
3853,opensslonzos-github,2,0.00073,39156,14.29343,273944
3854,optician,2,0.00073,39158,14.29416,273944
3855,orgads,2,0.00073,39160,14.29489,273944
3856,orif-jr,2,0.00073,39162,14.29562,273944
3857,OriR,2,0.00073,39164,14.29635,273944
3858,ortexx,2,0.00073,39166,14.29708,273944
3859,oscar-b,2,0.00073,39168,14.29781,273944
3860,oscar-stripe,2,0.00073,39170,14.29854,273944
3861,osher,2,0.00073,39172,14.29927,273944
3862,osiegmar,2,0.00073,39174,14.30000,273944
3863,oskardudycz,2,0.00073,39176,14.30073,273944
3864,otodockal,2,0.00073,39178,14.30146,273944
3865,ounziw,2,0.00073,39180,14.30219,273944
3866,ovangle,2,0.00073,39182,14.30292,273944
3867,OzieGamma,2,0.00073,39184,14.30365,273944
3868,OzzieOrca,2,0.00073,39186,14.30438,273944
3869,p0v1n0m,2,0.00073,39188,14.30511,273944
3870,Pablo-Ivan,2,0.00073,39190,14.30584,273944
3871,pablonete,2,0.00073,39192,14.30657,273944
3872,paladox,2,0.00073,39194,14.30730,273944
3873,pallxk,2,0.00073,39196,14.30803,273944
3874,panacekcz,2,0.00073,39198,14.30876,273944
3875,paniko0,2,0.00073,39200,14.30949,273944
3876,papandreou,2,0.00073,39202,14.31022,273944
3877,parambirs,2,0.00073,39204,14.31095,273944
3878,pards,2,0.00073,39206,14.31168,273944
3879,pas2al,2,0.00073,39208,14.31241,273944
3880,pascalzwick,2,0.00073,39210,14.31314,273944
3881,pass86,2,0.00073,39212,14.31387,273944
3882,PathogenDavid,2,0.00073,39214,14.31460,273944
3883,patocallaghan,2,0.00073,39216,14.31533,273944
3884,patyatka,2,0.00073,39218,14.31606,273944
3885,paulcpederson,2,0.00073,39220,14.31679,273944
3886,paulferaud,2,0.00073,39222,14.31752,273944
3887,paulhroth,2,0.00073,39224,14.31825,273944
3888,pbi-qfs,2,0.00073,39226,14.31898,273944
3889,pcalin,2,0.00073,39228,14.31971,273944
3890,pcameron-,2,0.00073,39230,14.32045,273944
3891,pedrotst,2,0.00073,39232,14.32118,273944
3892,pereorga,2,0.00073,39234,14.32191,273944
3893,persandstrom,2,0.00073,39236,14.32264,273944
3894,peterbudai,2,0.00073,39238,14.32337,273944
3895,petercm,2,0.00073,39240,14.32410,273944
3896,peterjurkovic,2,0.00073,39242,14.32483,273944
3897,PeterMortensen,2,0.00073,39244,14.32556,273944
3898,peter-mouland,2,0.00073,39246,14.32629,273944
3899,petermz,2,0.00073,39248,14.32702,273944
3900,peterpeterparker,2,0.00073,39250,14.32775,273944
3901,peterpoe,2,0.00073,39252,14.32848,273944
3902,peteward44,2,0.00073,39254,14.32921,273944
3903,pgarrison,2,0.00073,39256,14.32994,273944
3904,phadej,2,0.00073,39258,14.33067,273944
3905,pharkare,2,0.00073,39260,14.33140,273944
3906,pheyvaer,2,0.00073,39262,14.33213,273944
3907,phillipalexander,2,0.00073,39264,14.33286,273944
3908,piloopin,2,0.00073,39266,14.33359,273944
3909,pirelenito,2,0.00073,39268,14.33432,273944
3910,piscolomo,2,0.00073,39270,14.33505,273944
3911,pithu,2,0.00073,39272,14.33578,273944
3912,PixnBits,2,0.00073,39274,14.33651,273944
3913,Plortinus,2,0.00073,39276,14.33724,273944
3914,pmcelhaney,2,0.00073,39278,14.33797,273944
3915,pmq20,2,0.00073,39280,14.33870,273944
3916,poizan42,2,0.00073,39282,14.33943,273944
3917,polsys,2,0.00073,39284,14.34016,273944
3918,Polvista,2,0.00073,39286,14.34089,273944
3919,pon,2,0.00073,39288,14.34162,273944
3920,pontusab,2,0.00073,39290,14.34235,273944
3921,portgasd666,2,0.00073,39292,14.34308,273944
3922,PoziWorld,2,0.00073,39294,14.34381,273944
3923,prashantpawar,2,0.00073,39296,14.34454,273944
3924,prathamesh-sonpatki,2,0.00073,39298,14.34527,273944
3925,preaction,2,0.00073,39300,14.34600,273944
3926,pschlan,2,0.00073,39302,14.34673,273944
3927,pselden,2,0.00073,39304,14.34746,273944
3928,Psidium,2,0.00073,39306,14.34819,273944
3929,psysp,2,0.00073,39308,14.34892,273944
3930,ptemplier,2,0.00073,39310,14.34965,273944
3931,Ptival,2,0.00073,39312,14.35038,273944
3932,ptoonen,2,0.00073,39314,14.35111,273944
3933,ptrcarta,2,0.00073,39316,14.35184,273944
3934,puffnfresh,2,0.00073,39318,14.35257,273944
3935,punkish,2,0.00073,39320,14.35330,273944
3936,Purus,2,0.00073,39322,14.35403,273944
3937,pvorona,2,0.00073,39324,14.35476,273944
3938,qbzzt,2,0.00073,39326,14.35549,273944
3939,qm3ster,2,0.00073,39328,14.35622,273944
3940,quanah,2,0.00073,39330,14.35695,273944
3941,qub1t,2,0.00073,39332,14.35768,273944
3942,Quintinity,2,0.00073,39334,14.35841,273944
3943,qunying,2,0.00073,39336,14.35914,273944
3944,quocvu,2,0.00073,39338,14.35987,273944
3945,Radi123,2,0.00073,39340,14.36060,273944
3946,RahulNagekar,2,0.00073,39342,14.36133,273944
3947,rajendraarora16,2,0.00073,39344,14.36206,273944
3948,Rajivts,2,0.00073,39346,14.36279,273944
3949,RalfKoban,2,0.00073,39348,14.36352,273944
3950,Rastopyr,2,0.00073,39350,14.36425,273944
3951,rationull,2,0.00073,39352,14.36498,273944
3952,ravefalcon92,2,0.00073,39354,14.36571,273944
3953,raybooysen,2,0.00073,39356,14.36644,273944
3954,raydog,2,0.00073,39358,14.36717,273944
3955,raygervais,2,0.00073,39360,14.36790,273944
3956,rbdrenn,2,0.00073,39362,14.36863,273944
3957,rbrtmrtn,2,0.00073,39364,14.36936,273944
3958,rcartwright,2,0.00073,39366,14.37009,273944
3959,reaction1989,2,0.00073,39368,14.37082,273944
3960,realdubb,2,0.00073,39370,14.37155,273944
3961,RebootJeff,2,0.00073,39372,14.37228,273944
3962,redcom,2,0.00073,39374,14.37301,273944
3963,Redsandro,2,0.00073,39376,14.37374,273944
3964,rek,2,0.00073,39378,14.37447,273944
3965,reneras,2,0.00073,39380,14.37520,273944
3966,reniowood,2,0.00073,39382,14.37593,273944
3967,resalisbury,2,0.00073,39384,14.37666,273944
3968,Retropotenza,2,0.00073,39386,14.37739,273944
3969,rf,2,0.00073,39388,14.37812,273944
3970,RFenolio,2,0.00073,39390,14.37885,273944
3971,rfkm,2,0.00073,39392,14.37958,273944
3972,rgansevles,2,0.00073,39394,14.38031,273944
3973,RGelman,2,0.00073,39396,14.38104,273944
3974,rgrove,2,0.00073,39398,14.38177,273944
3975,RheaAyase,2,0.00073,39400,14.38250,273944
3976,rhys-vdw,2,0.00073,39402,14.38323,273944
3977,RichardBradley,2,0.00073,39404,14.38396,273944
3978,Rich-Harris,2,0.00073,39406,14.38469,273944
3979,richmoore,2,0.00073,39408,14.38542,273944
3980,risseraka,2,0.00073,39410,14.38615,273944
3981,riuri,2,0.00073,39412,14.38688,273944
3982,rivenhk,2,0.00073,39414,14.38761,273944
3983,rizoom,2,0.00073,39416,14.38834,273944
3984,rjatkinson2,2,0.00073,39418,14.38907,273944
3985,rjenks,2,0.00073,39420,14.38980,273944
3986,rmhartog,2,0.00073,39422,14.39053,273944
3987,rmhasan,2,0.00073,39424,14.39126,273944
3988,rmm5t,2,0.00073,39426,14.39199,273944
3989,rnglnd,2,0.00073,39428,14.39272,273944
3990,robertbrignull,2,0.00073,39430,14.39345,273944
3991,robin850,2,0.00073,39432,14.39418,273944
3992,robinwassen,2,0.00073,39434,14.39491,273944
3993,robinweser,2,0.00073,39436,14.39564,273944
3994,robisim74,2,0.00073,39438,14.39637,273944
3995,RobJacobs,2,0.00073,39440,14.39710,273944
3996,RobSiklos,2,0.00073,39442,14.39783,273944
3997,Rob--W,2,0.00073,39444,14.39856,273944
3998,robwierzbowski,2,0.00073,39446,14.39929,273944
3999,RodneyEbanks,2,0.00073,39448,14.40002,273944
4000,rodocite,2,0.00073,39450,14.40075,273944
4001,Rohitkrops,2,0.00073,39452,14.40148,273944
4002,RolandR,2,0.00073,39454,14.40221,273944
4003,Romasz,2,0.00073,39456,14.40294,273944
4004,romkor,2,0.00073,39458,14.40367,273944
4005,ronnyroeller,2,0.00073,39460,14.40440,273944
4006,ronperris,2,0.00073,39462,14.40513,273944
4007,roooodcastro,2,0.00073,39464,14.40586,273944
4008,RoopeHakulinen,2,0.00073,39466,14.40659,273944
4009,rootulp,2,0.00073,39468,14.40732,273944
4010,Rowno,2,0.00073,39470,14.40805,273944
4011,roydukkey,2,0.00073,39472,14.40878,273944
4012,royopa,2,0.00073,39474,14.40951,273944
4013,royra,2,0.00073,39476,14.41024,273944
4014,RpprRoger,2,0.00073,39478,14.41097,273944
4015,rqrqrqrq,2,0.00073,39480,14.41170,273944
4016,rrrene,2,0.00073,39482,14.41243,273944
4017,rspier,2,0.00073,39484,14.41316,273944
4018,rudolfolah,2,0.00073,39486,14.41389,273944
4019,rusmaxim,2,0.00073,39488,14.41462,273944
4020,Rvanlaak,2,0.00073,39490,14.41535,273944
4021,rwoodnz,2,0.00073,39492,14.41609,273944
4022,rwuebker,2,0.00073,39494,14.41682,273944
4023,ryan1st,2,0.00073,39496,14.41755,273944
4024,RyanDale,2,0.00073,39498,14.41828,273944
4025,ryanhendry,2,0.00073,39500,14.41901,273944
4026,ryanhughes,2,0.00073,39502,14.41974,273944
4027,ryanmeador,2,0.00073,39504,14.42047,273944
4028,S2-,2,0.00073,39506,14.42120,273944
4029,SadPandaBear,2,0.00073,39508,14.42193,273944
4030,sagirk,2,0.00073,39510,14.42266,273944
4031,sahutd,2,0.00073,39512,14.42339,273944
4032,saiichihashimoto,2,0.00073,39514,14.42412,273944
4033,sairion,2,0.00073,39516,14.42485,273944
4034,Sakarisson,2,0.00073,39518,14.42558,273944
4035,salier,2,0.00073,39520,14.42631,273944
4036,Salil999,2,0.00073,39522,14.42704,273944
4037,samal84,2,0.00073,39524,14.42777,273944
4038,samccone,2,0.00073,39526,14.42850,273944
4039,SamCortopassi,2,0.00073,39528,14.42923,273944
4040,samsch,2,0.00073,39530,14.42996,273944
4041,samuelcole,2,0.00073,39532,14.43069,273944
4042,samuelfullerthomas,2,0.00073,39534,14.43142,273944
4043,sandervn,2,0.00073,39536,14.43215,273944
4044,sankargorthi,2,0.00073,39538,14.43288,273944
4045,santigimeno,2,0.00073,39540,14.43361,273944
4046,saoirse-zee,2,0.00073,39542,14.43434,273944
4047,Sapphire64,2,0.00073,39544,14.43507,273944
4048,sarkiroka,2,0.00073,39546,14.43580,273944
4049,sarod,2,0.00073,39548,14.43653,273944
4050,sassanh,2,0.00073,39550,14.43726,273944
4051,sava-smith,2,0.00073,39552,14.43799,273944
4052,saxicek,2,0.00073,39554,14.43872,273944
4053,sboptimal,2,0.00073,39556,14.43945,273944
4054,scampi,2,0.00073,39558,14.44018,273944
4055,sceendy,2,0.00073,39560,14.44091,273944
4056,schempy,2,0.00073,39562,14.44164,273944
4057,schwabe,2,0.00073,39564,14.44237,273944
4058,schwigri,2,0.00073,39566,14.44310,273944
4059,scottarver,2,0.00073,39568,14.44383,273944
4060,Scottkao85,2,0.00073,39570,14.44456,273944
4061,sdbedi,2,0.00073,39572,14.44529,273944
4062,seanbright,2,0.00073,39574,14.44602,273944
4063,SeanHenderson,2,0.00073,39576,14.44675,273944
4064,seaster,2,0.00073,39578,14.44748,273944
4065,SebastianC,2,0.00073,39580,14.44821,273944
4066,sebmck,2,0.00073,39582,14.44894,273944
4067,Sebring,2,0.00073,39584,14.44967,273944
4068,Seddryck,2,0.00073,39586,14.45040,273944
4069,seferov,2,0.00073,39588,14.45113,273944
4070,sereysethy,2,0.00073,39590,14.45186,273944
4071,Serginho,2,0.00073,39592,14.45259,273944
4072,sericaia,2,0.00073,39594,14.45332,273944
4073,seteen,2,0.00073,39596,14.45405,273944
4074,sethbattin,2,0.00073,39598,14.45478,273944
4075,sfinktah,2,0.00073,39600,14.45551,273944
4076,sgbrown,2,0.00073,39602,14.45624,273944
4077,ShahramMebashar,2,0.00073,39604,14.45697,273944
4078,SHAHRUKH-KHAN,2,0.00073,39606,14.45770,273944
4079,ShaneDelmore,2,0.00073,39608,14.45843,273944
4080,sharathgeorgem,2,0.00073,39610,14.45916,273944
4081,ShaviPathania,2,0.00073,39612,14.45989,273944
4082,shinok01,2,0.00073,39614,14.46062,273944
4083,Shivam-Vyas,2,0.00073,39616,14.46135,273944
4084,shivijais,2,0.00073,39618,14.46208,273944
4085,shkrobova,2,0.00073,39620,14.46281,273944
4086,shubheksha,2,0.00073,39622,14.46354,273944
4087,sibartlett,2,0.00073,39624,14.46427,273944
4088,sibelius,2,0.00073,39626,14.46500,273944
4089,SidRoberts,2,0.00073,39628,14.46573,273944
4090,SiegfriedEhret,2,0.00073,39630,14.46646,273944
4091,sihaelov,2,0.00073,39632,14.46719,273944
4092,Siilwyn,2,0.00073,39634,14.46792,273944
4093,silverwind,2,0.00073,39636,14.46865,273944
4094,simlu,2,0.00073,39638,14.46938,273944
4095,simonpai,2,0.00073,39640,14.47011,273944
4096,Sirivasv,2,0.00073,39642,14.47084,273944
4097,sjy,2,0.00073,39644,14.47157,273944
4098,skratchdot,2,0.00073,39646,14.47230,273944
4099,skyupward,2,0.00073,39648,14.47303,273944
4100,slavede,2,0.00073,39650,14.47376,273944
4101,SlexAxton,2,0.00073,39652,14.47449,273944
4102,sliftist,2,0.00073,39654,14.47522,273944
4103,slobo-showbie,2,0.00073,39656,14.47595,273944
4104,Slumber86,2,0.00073,39658,14.47668,273944
4105,smaniotto,2,0.00073,39660,14.47741,273944
4106,smashercosmo,2,0.00073,39662,14.47814,273944
4107,smbape,2,0.00073,39664,14.47887,273944
4108,smwentum,2,0.00073,39666,14.47960,273944
4109,snakajima,2,0.00073,39668,14.48033,273944
4110,SneakyFish5,2,0.00073,39670,14.48106,273944
4111,snow01,2,0.00073,39672,14.48179,273944
4112,SobakaSlava,2,0.00073,39674,14.48252,273944
4113,sonewman,2,0.00073,39676,14.48325,273944
4114,sonnemaf,2,0.00073,39678,14.48398,273944
4115,sorohan,2,0.00073,39680,14.48471,273944
4116,soygul,2,0.00073,39682,14.48544,273944
4117,Sp1l,2,0.00073,39684,14.48617,273944
4118,spacanowski,2,0.00073,39686,14.48690,273944
4119,SpaceBeers,2,0.00073,39688,14.48763,273944
4120,sparraguerra,2,0.00073,39690,14.48836,273944
4121,spiroid,2,0.00073,39692,14.48909,273944
4122,spongessuck,2,0.00073,39694,14.48982,273944
4123,spudly,2,0.00073,39696,14.49055,273944
4124,sshock,2,0.00073,39698,14.49128,273944
4125,StanEgo,2,0.00073,39700,14.49201,273944
4126,starkch,2,0.00073,39702,14.49274,273944
4127,stephaniepurvis,2,0.00073,39704,14.49347,273944
4128,stephan-tolksdorf,2,0.00073,39706,14.49420,273944
4129,stepharr,2,0.00073,39708,14.49493,273944
4130,StephenCooper,2,0.00073,39710,14.49566,273944
4131,stephenmathieson,2,0.00073,39712,14.49639,273944
4132,Stephie,2,0.00073,39714,14.49712,273944
4133,sterling,2,0.00073,39716,14.49785,273944
4134,steve8708,2,0.00073,39718,14.49858,273944
4135,stianjensen,2,0.00073,39720,14.49931,273944
4136,stickfigure,2,0.00073,39722,14.50004,273944
4137,stolenkid,2,0.00073,39724,14.50077,273944
4138,stormystormy,2,0.00073,39726,14.50150,273944
4139,strarsis,2,0.00073,39728,14.50223,273944
4140,straube,2,0.00073,39730,14.50296,273944
4141,StreetStrider,2,0.00073,39732,14.50369,273944
4142,stucox,2,0.00073,39734,14.50442,273944
4143,stukselbax,2,0.00073,39736,14.50515,273944
4144,stusmall,2,0.00073,39738,14.50588,273944
4145,styopdev,2,0.00073,39740,14.50661,273944
4146,Stzx,2,0.00073,39742,14.50734,273944
4147,sujeet,2,0.00073,39744,14.50807,273944
4148,sukima,2,0.00073,39746,14.50880,273944
4149,sumt-mgardner,2,0.00073,39748,14.50953,273944
4150,sungwoncho,2,0.00073,39750,14.51026,273944
4151,SunHuawei,2,0.00073,39752,14.51099,273944
4152,sunny,2,0.00073,39754,14.51173,273944
4153,supasate,2,0.00073,39756,14.51246,273944
4154,surajwy,2,0.00073,39758,14.51319,273944
4155,susisu,2,0.00073,39760,14.51392,273944
4156,sveyret,2,0.00073,39762,14.51465,273944
4157,swaincreates,2,0.00073,39764,14.51538,273944
4158,swaldman,2,0.00073,39766,14.51611,273944
4159,swalker2,2,0.00073,39768,14.51684,273944
4160,sw-yx,2,0.00073,39770,14.51757,273944
4161,sxmichael,2,0.00073,39772,14.51830,273944
4162,syllant,2,0.00073,39774,14.51903,273944
4163,tabdulradi,2,0.00073,39776,14.51976,273944
4164,taehwanno,2,0.00073,39778,14.52049,273944
4165,tagCincy,2,0.00073,39780,14.52122,273944
4166,tameraydin,2,0.00073,39782,14.52195,273944
4167,tamlyn,2,0.00073,39784,14.52268,273944
4168,tanzislam,2,0.00073,39786,14.52341,273944
4169,tardyp,2,0.00073,39788,14.52414,273944
4170,tarebyte,2,0.00073,39790,14.52487,273944
4171,tasos-ale,2,0.00073,39792,14.52560,273944
4172,taylorc93,2,0.00073,39794,14.52633,273944
4173,tdinucci,2,0.00073,39796,14.52706,273944
4174,tdurtschi,2,0.00073,39798,14.52779,273944
4175,tedpennings,2,0.00073,39800,14.52852,273944
4176,teebot,2,0.00073,39802,14.52925,273944
4177,teemulehtinen,2,0.00073,39804,14.52998,273944
4178,telmen,2,0.00073,39806,14.53071,273944
4179,tenjaa,2,0.00073,39808,14.53144,273944
4180,tgfjt,2,0.00073,39810,14.53217,273944
4181,tgodzik,2,0.00073,39812,14.53290,273944
4182,thatmarvin,2,0.00073,39814,14.53363,273944
4183,TheAppleFreak,2,0.00073,39816,14.53436,273944
4184,theel0ja,2,0.00073,39818,14.53509,273944
4185,TheHalcyonSavant,2,0.00073,39820,14.53582,273944
4186,TheLarkInn,2,0.00073,39822,14.53655,273944
4187,theLine,2,0.00073,39824,14.53728,273944
4188,theogravity,2,0.00073,39826,14.53801,273944
4189,Thesoro,2,0.00073,39828,14.53874,273944
4190,TheTalisman,2,0.00073,39830,14.53947,273944
4191,TheToolbox,2,0.00073,39832,14.54020,273944
4192,thevoidf,2,0.00073,39834,14.54093,273944
4193,thiagoarrais,2,0.00073,39836,14.54166,273944
4194,thiagodelgado111,2,0.00073,39838,14.54239,273944
4195,thomas-j-moffett,2,0.00073,39840,14.54312,273944
4196,ThomasLandauer,2,0.00073,39842,14.54385,273944
4197,thomasphorton,2,0.00073,39844,14.54458,273944
4198,Thorium,2,0.00073,39846,14.54531,273944
4199,thp,2,0.00073,39848,14.54604,273944
4200,tiagoefmoraes,2,0.00073,39850,14.54677,273944
4201,tiagofernandez,2,0.00073,39852,14.54750,273944
4202,tibbon,2,0.00073,39854,14.54823,273944
4203,TiGR,2,0.00073,39856,14.54896,273944
4204,tijwelch,2,0.00073,39858,14.54969,273944
4205,Tillerino,2,0.00073,39860,14.55042,273944
4206,tillmon,2,0.00073,39862,14.55115,273944
4207,timcosta,2,0.00073,39864,14.55188,273944
4208,timdeschryver,2,0.00073,39866,14.55261,273944
4209,timdp,2,0.00073,39868,14.55334,273944
4210,timkordas,2,0.00073,39870,14.55407,273944
4211,timlevett,2,0.00073,39872,14.55480,273944
4212,timmoy,2,0.00073,39874,14.55553,273944
4213,timsly,2,0.00073,39876,14.55626,273944
4214,TimvdLippe,2,0.00073,39878,14.55699,273944
4215,tinchou,2,0.00073,39880,14.55772,273944
4216,tinglof,2,0.00073,39882,14.55845,273944
4217,TinyMan,2,0.00073,39884,14.55918,273944
4218,tk3369,2,0.00073,39886,14.55991,273944
4219,tkorakas,2,0.00073,39888,14.56064,273944
4220,tkrotoff,2,0.00073,39890,14.56137,273944
4221,tleruitte,2,0.00073,39892,14.56210,273944
4222,tlhunter,2,0.00073,39894,14.56283,273944
4223,tlinkowski,2,0.00073,39896,14.56356,273944
4224,toastman,2,0.00073,39898,14.56429,273944
4225,tobhult,2,0.00073,39900,14.56502,273944
4226,tobli,2,0.00073,39902,14.56575,273944
4227,To-da,2,0.00073,39904,14.56648,273944
4228,todd,2,0.00073,39906,14.56721,273944
4229,toddself,2,0.00073,39908,14.56794,273944
4230,todesking,2,0.00073,39910,14.56867,273944
4231,togakangaroo,2,0.00073,39912,14.56940,273944
4232,tolemac,2,0.00073,39914,14.57013,273944
4233,Tom910,2,0.00073,39916,14.57086,273944
4234,tomaszbakula,2,0.00073,39918,14.57159,273944
4235,tomchristie,2,0.00073,39920,14.57232,273944
4236,tomhorvat,2,0.00073,39922,14.57305,273944
4237,tomkel,2,0.00073,39924,14.57378,273944
4238,tom-schoener,2,0.00073,39926,14.57451,273944
4239,tom-sherman,2,0.00073,39928,14.57524,273944
4240,tomulin1,2,0.00073,39930,14.57597,273944
4241,topaxi,2,0.00073,39932,14.57670,273944
4242,Tornhoof,2,0.00073,39934,14.57743,273944
4243,torniker,2,0.00073,39936,14.57816,273944
4244,toshimaru,2,0.00073,39938,14.57889,273944
4245,tranhl,2,0.00073,39940,14.57962,273944
4246,travi,2,0.00073,39942,14.58035,273944
4247,trentm,2,0.00073,39944,14.58108,273944
4248,treymack,2,0.00073,39946,14.58181,273944
4249,tridium,2,0.00073,39948,14.58254,273944
4250,troutowicz,2,0.00073,39950,14.58327,273944
4251,trvra,2,0.00073,39952,14.58400,273944
4252,tschieggm,2,0.00073,39954,14.58473,273944
4253,tsclaus,2,0.00073,39956,14.58546,273944
4254,tsm91,2,0.00073,39958,14.58619,273944
4255,TSMMark,2,0.00073,39960,14.58692,273944
4256,tsubik,2,0.00073,39962,14.58765,273944
4257,tuckbick,2,0.00073,39964,14.58838,273944
4258,tuexen,2,0.00073,39966,14.58911,273944
4259,tvler,2,0.00073,39968,14.58984,273944
4260,Tvrqvoise,2,0.00073,39970,14.59057,273944
4261,twhitbeck,2,0.00073,39972,14.59130,273944
4262,TwistedHardware,2,0.00073,39974,14.59203,273944
4263,txdv,2,0.00073,39976,14.59276,273944
4264,TylerBrock,2,0.00073,39978,14.59349,273944
4265,typhoon1983,2,0.00073,39980,14.59422,273944
4266,tyscorp,2,0.00073,39982,14.59495,273944
4267,tzachshabtay,2,0.00073,39984,14.59568,273944
4268,uber5001,2,0.00073,39986,14.59641,273944
4269,uhaciogullari,2,0.00073,39988,14.59714,273944
4270,ulikoehler,2,0.00073,39990,14.59787,273944
4271,ulrichb,2,0.00073,39992,14.59860,273944
4272,uncleAndyChen,2,0.00073,39994,14.59933,273944
4273,user-none,2,0.00073,39996,14.60006,273944
4274,usmonster,2,0.00073,39998,14.60079,273944
4275,vadimdemedes,2,0.00073,40000,14.60152,273944
4276,vaicine,2,0.00073,40002,14.60225,273944
4277,valscion,2,0.00073,40004,14.60298,273944
4278,VanJanssen,2,0.00073,40006,14.60371,273944
4279,vanshady,2,0.00073,40008,14.60444,273944
4280,vaverix,2,0.00073,40010,14.60517,273944
4281,vbraun,2,0.00073,40012,14.60590,273944
4282,v-dev-1,2,0.00073,40014,14.60663,273944
4283,vdukhovni,2,0.00073,40016,14.60737,273944
4284,vedatmahir,2,0.00073,40018,14.60810,273944
4285,vedelaar,2,0.00073,40020,14.60883,273944
4286,veger,2,0.00073,40022,14.60956,273944
4287,velemas,2,0.00073,40024,14.61029,273944
4288,ventuno,2,0.00073,40026,14.61102,273944
4289,vergenzt,2,0.00073,40028,14.61175,273944
4290,vglushak,2,0.00073,40030,14.61248,273944
4291,vgoma,2,0.00073,40032,14.61321,273944
4292,vgvenkat,2,0.00073,40034,14.61394,273944
4293,VictoriaQ,2,0.00073,40036,14.61467,273944
4294,VictorNicollet,2,0.00073,40038,14.61540,273944
4295,ViIvanov,2,0.00073,40040,14.61613,273944
4296,vijithassar,2,0.00073,40042,14.61686,273944
4297,vikynandha,2,0.00073,40044,14.61759,273944
4298,vincecampanale,2,0.00073,40046,14.61832,273944
4299,vinsonchuong,2,0.00073,40048,14.61905,273944
4300,vitalets,2,0.00073,40050,14.61978,273944
4301,vitorbal,2,0.00073,40052,14.62051,273944
4302,vitorpereirafarfetchcom,2,0.00073,40054,14.62124,273944
4303,vittorius,2,0.00073,40056,14.62197,273944
4304,vivmishra,2,0.00073,40058,14.62270,273944
4305,vkarpov15,2,0.00073,40060,14.62343,273944
4306,vkrol,2,0.00073,40062,14.62416,273944
4307,vladimirkosmala,2,0.00073,40064,14.62489,273944
4308,vladshcherbin,2,0.00073,40066,14.62562,273944
4309,vmeurisse,2,0.00073,40068,14.62635,273944
4310,vmx,2,0.00073,40070,14.62708,273944
4311,Voev,2,0.00073,40072,14.62781,273944
4312,volkaino,2,0.00073,40074,14.62854,273944
4313,voxpelli,2,0.00073,40076,14.62927,273944
4314,vpfautz,2,0.00073,40078,14.63000,273944
4315,vprasanth,2,0.00073,40080,14.63073,273944
4316,vramana,2,0.00073,40082,14.63146,273944
4317,vreuter,2,0.00073,40084,14.63219,273944
4318,vteremasov,2,0.00073,40086,14.63292,273944
4319,Vusys,2,0.00073,40088,14.63365,273944
4320,vvo,2,0.00073,40090,14.63438,273944
4321,w33ble,2,0.00073,40092,14.63511,273944
4322,w3apps,2,0.00073,40094,14.63584,273944
4323,wacii,2,0.00073,40096,14.63657,273944
4324,wajda,2,0.00073,40098,14.63730,273944
4325,WatchSteveDrum,2,0.00073,40100,14.63803,273944
4326,wayou,2,0.00073,40102,14.63876,273944
4327,wbrawner,2,0.00073,40104,14.63949,273944
4328,wcontayon,2,0.00073,40106,14.64022,273944
4329,webtrix,2,0.00073,40108,14.64095,273944
4330,weinholtendian,2,0.00073,40110,14.64168,273944
4331,wesbos,2,0.00073,40112,14.64241,273944
4332,wesinator,2,0.00073,40114,14.64314,273944
4333,westonpace,2,0.00073,40116,14.64387,273944
4334,WhereIsMyBubble,2,0.00073,40118,14.64460,273944
4335,whitneyit,2,0.00073,40120,14.64533,273944
4336,whoffmann,2,0.00073,40122,14.64606,273944
4337,Widdershin,2,0.00073,40124,14.64679,273944
4338,willfong,2,0.00073,40126,14.64752,273944
4339,willnorris,2,0.00073,40128,14.64825,273944
4340,willyboy,2,0.00073,40130,14.64898,273944
4341,winhowes,2,0.00073,40132,14.64971,273944
4342,winniehell,2,0.00073,40134,14.65044,273944
4343,wi-ski,2,0.00073,40136,14.65117,273944
4344,wkaluza,2,0.00073,40138,14.65190,273944
4345,wmhilton,2,0.00073,40140,14.65263,273944
4346,wnvko,2,0.00073,40142,14.65336,273944
4347,wpopielarski,2,0.00073,40144,14.65409,273944
4348,wraithgar,2,0.00073,40146,14.65482,273944
4349,ws0w,2,0.00073,40148,14.65555,273944
4350,ww898,2,0.00073,40150,14.65628,273944
4351,x753,2,0.00073,40152,14.65701,273944
4352,Xapuu,2,0.00073,40154,14.65774,273944
4353,xavierguihot,2,0.00073,40156,14.65847,273944
4354,xenoterracide,2,0.00073,40158,14.65920,273944
4355,xfg,2,0.00073,40160,14.65993,273944
4356,XFree,2,0.00073,40162,14.66066,273944
4357,xiangyuecn,2,0.00073,40164,14.66139,273944
4358,xixilive,2,0.00073,40166,14.66212,273944
4359,yaelkeemink,2,0.00073,40168,14.66285,273944
4360,yannickglt,2,0.00073,40170,14.66358,273944
4361,yasoob,2,0.00073,40172,14.66431,273944
4362,yausername,2,0.00073,40174,14.66504,273944
4363,YawarRaza7349,2,0.00073,40176,14.66577,273944
4364,Yaxian,2,0.00073,40178,14.66650,273944
4365,ycmjason,2,0.00073,40180,14.66723,273944
4366,yenshih,2,0.00073,40182,14.66796,273944
4367,Yermo,2,0.00073,40184,14.66869,273944
4368,yesplease,2,0.00073,40186,14.66942,273944
4369,yichaowang,2,0.00073,40188,14.67015,273944
4370,yihangho,2,0.00073,40190,14.67088,273944
4371,Y-Less,2,0.00073,40192,14.67161,273944
4372,yodeyer,2,0.00073,40194,14.67234,273944
4373,yoshuki,2,0.00073,40196,14.67307,273944
4374,youdz,2,0.00073,40198,14.67380,273944
4375,Youmoo,2,0.00073,40200,14.67453,273944
4376,ysugimoto,2,0.00073,40202,14.67526,273944
4377,yufcuy,2,0.00073,40204,14.67599,273944
4378,yuler,2,0.00073,40206,14.67672,273944
4379,yuriybash,2,0.00073,40208,14.67745,273944
4380,YuriyOborozhnyi,2,0.00073,40210,14.67818,273944
4381,YusongLiu,2,0.00073,40212,14.67891,273944
4382,yu-tian113,2,0.00073,40214,14.67964,273944
4383,yuxino,2,0.00073,40216,14.68037,273944
4384,z-10,2,0.00073,40218,14.68110,273944
4385,zackseuberling,2,0.00073,40220,14.68183,273944
4386,zalenix,2,0.00073,40222,14.68256,273944
4387,zartdinov,2,0.00073,40224,14.68329,273944
4388,zaygraveyard,2,0.00073,40226,14.68402,273944
4389,zazabe,2,0.00073,40228,14.68475,273944
4390,zce,2,0.00073,40230,14.68548,273944
4391,zenazn,2,0.00073,40232,14.68621,273944
4392,zenflow,2,0.00073,40234,14.68694,273944
4393,zenglian,2,0.00073,40236,14.68767,273944
4394,zhangtreefish,2,0.00073,40238,14.68840,273944
4395,zharro,2,0.00073,40240,14.68913,273944
4396,zhaxi,2,0.00073,40242,14.68986,273944
4397,zhenlan,2,0.00073,40244,14.69059,273944
4398,zicai,2,0.00073,40246,14.69132,273944
4399,zivillian,2,0.00073,40248,14.69205,273944
4400,zlm2012,2,0.00073,40250,14.69278,273944
4401,zombieJ,2,0.00073,40252,14.69351,273944
4402,zzz6519003,2,0.00073,40254,14.69424,273944
4403,000panther,1,0.00037,40255,14.69461,273944
4404,03byron,1,0.00037,40256,14.69497,273944
4405,0x1mason,1,0.00037,40257,14.69534,273944
4406,0x2206,1,0.00037,40258,14.69570,273944
4407,0x6773,1,0.00037,40259,14.69607,273944
4408,0xmohit,1,0.00037,40260,14.69643,273944
4409,0zAND1z,1,0.00037,40261,14.69680,273944
4410,10xLaCroixDrinker,1,0.00037,40262,14.69716,273944
4411,1egoman,1,0.00037,40263,14.69753,273944
4412,231293,1,0.00037,40264,14.69789,273944
4413,243083df,1,0.00037,40265,14.69826,273944
4414,2efPer,1,0.00037,40266,14.69862,273944
4415,2is10,1,0.00037,40267,14.69899,273944
4416,38elements,1,0.00037,40268,14.69935,273944
4417,3flex,1,0.00037,40269,14.69972,273944
4418,3rf,1,0.00037,40270,14.70008,273944
4419,43081j,1,0.00037,40271,14.70045,273944
4420,4leem,1,0.00037,40272,14.70081,273944
4421,64lines,1,0.00037,40273,14.70118,273944
4422,91bananas,1,0.00037,40274,14.70154,273944
4423,A1vinSmith,1,0.00037,40275,14.70191,273944
4424,aakash2602,1,0.00037,40276,14.70227,273944
4425,aakoch,1,0.00037,40277,14.70264,273944
4426,aakti,1,0.00037,40278,14.70300,273944
4427,aaoferreira,1,0.00037,40279,14.70337,273944
4428,aarboleda1,1,0.00037,40280,14.70374,273944
4429,aaronang,1,0.00037,40281,14.70410,273944
4430,aaroncraig10e,1,0.00037,40282,14.70447,273944
4431,aaron-em,1,0.00037,40283,14.70483,273944
4432,AaronFriel,1,0.00037,40284,14.70520,273944
4433,aaronjensen,1,0.00037,40285,14.70556,273944
4434,aaronofleonard,1,0.00037,40286,14.70593,273944
4435,aartur,1,0.00037,40287,14.70629,273944
4436,aashikgowda,1,0.00037,40288,14.70666,273944
4437,aashil,1,0.00037,40289,14.70702,273944
4438,aassaad,1,0.00037,40290,14.70739,273944
4439,abatkin,1,0.00037,40291,14.70775,273944
4440,Abazhenov,1,0.00037,40292,14.70812,273944
4441,abdullahtariq1171,1,0.00037,40293,14.70848,273944
4442,abejfehr,1,0.00037,40294,14.70885,273944
4443,abettadapur,1,0.00037,40295,14.70921,273944
4444,AbhishekBiswal,1,0.00037,40296,14.70958,273944
4445,abiduzz420,1,0.00037,40297,14.70994,273944
4446,abierbaum,1,0.00037,40298,14.71031,273944
4447,abigsmall,1,0.00037,40299,14.71067,273944
4448,Aboisier,1,0.00037,40300,14.71104,273944
4449,aboveyou00,1,0.00037,40301,14.71140,273944
4450,abrad1212,1,0.00037,40302,14.71177,273944
4451,abraham,1,0.00037,40303,14.71213,273944
4452,abstein2,1,0.00037,40304,14.71250,273944
4453,abucur,1,0.00037,40305,14.71286,273944
4454,abvalentine,1,0.00037,40306,14.71323,273944
4455,abyx,1,0.00037,40307,14.71359,273944
4456,acdenhartog,1,0.00037,40308,14.71396,273944
4457,acerbusace,1,0.00037,40309,14.71432,273944
4458,aceyoung9,1,0.00037,40310,14.71469,273944
4459,achimha,1,0.00037,40311,14.71505,273944
4460,acid-chicken,1,0.00037,40312,14.71542,273944
4461,acifani,1,0.00037,40313,14.71578,273944
4462,acinader,1,0.00037,40314,14.71615,273944
4463,acjay,1,0.00037,40315,14.71651,273944
4464,ACJustPlay,1,0.00037,40316,14.71688,273944
4465,acrazing,1,0.00037,40317,14.71724,273944
4466,acroca,1,0.00037,40318,14.71761,273944
4467,actra-gschuster,1,0.00037,40319,14.71797,273944
4468,acutexyz,1,0.00037,40320,14.71834,273944
4469,adamgruber,1,0.00037,40321,14.71870,273944
4470,adammacias,1,0.00037,40322,14.71907,273944
4471,adamreeve,1,0.00037,40323,14.71943,273944
4472,adamsea,1,0.00037,40324,14.71980,273944
4473,adamvoss,1,0.00037,40325,14.72016,273944
4474,AdamWills,1,0.00037,40326,14.72053,273944
4475,adamzap,1,0.00037,40327,14.72089,273944
4476,adelevie,1,0.00037,40328,14.72126,273944
4477,adeolabadmus,1,0.00037,40329,14.72162,273944
4478,adgoncal,1,0.00037,40330,14.72199,273944
4479,aditya1906,1,0.00037,40331,14.72235,273944
4480,adjohnson916,1,0.00037,40332,14.72272,273944
4481,adraeth,1,0.00037,40333,14.72308,273944
4482,adrianolek,1,0.00037,40334,14.72345,273944
4483,AdrienHorgnies,1,0.00037,40335,14.72381,273944
4484,adros,1,0.00037,40336,14.72418,273944
4485,adutra,1,0.00037,40337,14.72454,273944
4486,adwiii,1,0.00037,40338,14.72491,273944
4487,aegoroff,1,0.00037,40339,14.72527,273944
4488,aeschright,1,0.00037,40340,14.72564,273944
4489,afeld,1,0.00037,40341,14.72600,273944
4490,afhole,1,0.00037,40342,14.72637,273944
4491,aftab10662,1,0.00037,40343,14.72673,273944
4492,AftabAnsari10662,1,0.00037,40344,14.72710,273944
4493,agale123,1,0.00037,40345,14.72746,273944
4494,AGCB,1,0.00037,40346,14.72783,273944
4495,aghour,1,0.00037,40347,14.72819,273944
4496,agiron123,1,0.00037,40348,14.72856,273944
4497,agpreynolds,1,0.00037,40349,14.72892,273944
4498,aguynamedben,1,0.00037,40350,14.72929,273944
4499,ahacking,1,0.00037,40351,14.72965,273944
4500,ahfarmer,1,0.00037,40352,14.73002,273944
4501,ahmdsolmn,1,0.00037,40353,14.73038,273944
4502,Ahmed,1,0.00037,40354,14.73075,273944
4503,ahmedsoliman92,1,0.00037,40355,14.73111,273944
4504,ahoisl,1,0.00037,40356,14.73148,273944
4505,ahonn,1,0.00037,40357,14.73184,273944
4506,AhsanAyaz,1,0.00037,40358,14.73221,273944
4507,aicest,1,0.00037,40359,14.73257,273944
4508,aidanxyz,1,0.00037,40360,14.73294,273944
4509,aifodu,1,0.00037,40361,14.73330,273944
4510,aigdonia,1,0.00037,40362,14.73367,273944
4511,aijo,1,0.00037,40363,14.73403,273944
4512,aik-jahoda,1,0.00037,40364,14.73440,273944
4513,aisipos,1,0.00037,40365,14.73476,273944
4514,ajayambre,1,0.00037,40366,14.73513,273944
4515,aj-dev,1,0.00037,40367,14.73549,273944
4516,ajhsu,1,0.00037,40368,14.73586,273944
4517,aj-r,1,0.00037,40369,14.73622,273944
4518,ak1r4,1,0.00037,40370,14.73659,273944
4519,akamike,1,0.00037,40371,14.73695,273944
4520,akd-io,1,0.00037,40372,14.73732,273944
4521,akheron,1,0.00037,40373,14.73768,273944
4522,Akim95,1,0.00037,40374,14.73805,273944
4523,akoken,1,0.00037,40375,14.73841,273944
4524,akost,1,0.00037,40376,14.73878,273944
4525,akshayp,1,0.00037,40377,14.73914,273944
4526,akulnurislam,1,0.00037,40378,14.73951,273944
4527,akvamalin,1,0.00037,40379,14.73987,273944
4528,alanmoo,1,0.00037,40380,14.74024,273944
4529,AlanParr,1,0.00037,40381,14.74060,273944
4530,alanshaw,1,0.00037,40382,14.74097,273944
4531,alansouzati,1,0.00037,40383,14.74133,273944
4532,alaouy,1,0.00037,40384,14.74170,273944
4533,albermav,1,0.00037,40385,14.74206,273944
4534,Alberto-,1,0.00037,40386,14.74243,273944
4535,albertopiras,1,0.00037,40387,14.74279,273944
4536,alcalyn,1,0.00037,40388,14.74316,273944
4537,aldenml,1,0.00037,40389,14.74352,273944
4538,aldo-roman,1,0.00037,40390,14.74389,273944
4539,aleclarson,1,0.00037,40391,14.74425,273944
4540,aleeeftw,1,0.00037,40392,14.74462,273944
4541,alekseyzadorozhniy,1,0.00037,40393,14.74498,273944
4542,alewiscondev,1,0.00037,40394,14.74535,273944
4543,alex1712,1,0.00037,40395,14.74571,273944
4544,alex321,1,0.00037,40396,14.74608,273944
4545,alex94cp,1,0.00037,40397,14.74644,273944
4546,alex94puchades,1,0.00037,40398,14.74681,273944
4547,alexanderad,1,0.00037,40399,14.74717,273944
4548,alexandercerutti,1,0.00037,40400,14.74754,273944
4549,AlexanderGranhof,1,0.00037,40401,14.74790,273944
4550,AlexanderLukin,1,0.00037,40402,14.74827,273944
4551,AlexanderTserkovniy,1,0.00037,40403,14.74863,273944
4552,alexanderweiss,1,0.00037,40404,14.74900,273944
4553,Alexandrshy,1,0.00037,40405,14.74936,273944
4554,AlexBHarley,1,0.00037,40406,14.74973,273944
4555,alexbokii,1,0.00037,40407,14.75009,273944
4556,AlexDenisov,1,0.00037,40408,14.75046,273944
4557,alexdunphy,1,0.00037,40409,14.75082,273944
4558,Alexey-NM,1,0.00037,40410,14.75119,273944
4559,alexgibson,1,0.00037,40411,14.75156,273944
4560,alexhardwicke,1,0.00037,40412,14.75192,273944
4561,alexilyaev,1,0.00037,40413,14.75229,273944
4562,alexlouden,1,0.00037,40414,14.75265,273944
4563,AlexNeises,1,0.00037,40415,14.75302,273944
4564,alex-okrushko,1,0.00037,40416,14.75338,273944
4565,alexpien,1,0.00037,40417,14.75375,273944
4566,alexpls,1,0.00037,40418,14.75411,273944
4567,alexr101,1,0.00037,40419,14.75448,273944
4568,alexreardon,1,0.00037,40420,14.75484,273944
4569,alexrohleder,1,0.00037,40421,14.75521,273944
4570,alex-teren,1,0.00037,40422,14.75557,273944
4571,alexvictoor,1,0.00037,40423,14.75594,273944
4572,AlfioEmanueleFresta,1,0.00037,40424,14.75630,273944
4573,alfonsogoberjr,1,0.00037,40425,14.75667,273944
4574,alfredh,1,0.00037,40426,14.75703,273944
4575,alfredr,1,0.00037,40427,14.75740,273944
4576,ali,1,0.00037,40428,14.75776,273944
4577,alicederyn,1,0.00037,40429,14.75813,273944
4578,aliceklipper,1,0.00037,40430,14.75849,273944
4579,ali-master,1,0.00037,40431,14.75886,273944
4580,alirezaafkar,1,0.00037,40432,14.75922,273944
4581,alirezavalizade,1,0.00037,40433,14.75959,273944
4582,alisherdavronov,1,0.00037,40434,14.75995,273944
4583,alitaheri,1,0.00037,40435,14.76032,273944
4584,almirsarajcic,1,0.00037,40436,14.76068,273944
4585,Alois-xx,1,0.00037,40437,14.76105,273944
4586,alopatin,1,0.00037,40438,14.76141,273944
4587,alopezsanchez,1,0.00037,40439,14.76178,273944
4588,alsami,1,0.00037,40440,14.76214,273944
4589,alubbe,1,0.00037,40441,14.76251,273944
4590,alundiak,1,0.00037,40442,14.76287,273944
4591,alur,1,0.00037,40443,14.76324,273944
4592,alvarotrigo,1,0.00037,40444,14.76360,273944
4593,amaranthrose,1,0.00037,40445,14.76397,273944
4594,amaravora,1,0.00037,40446,14.76433,273944
4595,amaseda,1,0.00037,40447,14.76470,273944
4596,amfern,1,0.00037,40448,14.76506,273944
4597,amiller-gh,1,0.00037,40449,14.76543,273944
4598,amit3vr,1,0.00037,40450,14.76579,273944
4599,amitdash291,1,0.00037,40451,14.76616,273944
4600,amitzur,1,0.00037,40452,14.76652,273944
4601,AmmarHasan,1,0.00037,40453,14.76689,273944
4602,AMoreaux,1,0.00037,40454,14.76725,273944
4603,amritaramnauth,1,0.00037,40455,14.76762,273944
4604,amseager,1,0.00037,40456,14.76798,273944
4605,amurdock,1,0.00037,40457,14.76835,273944
4606,amygori,1,0.00037,40458,14.76871,273944
4607,amykyta,1,0.00037,40459,14.76908,273944
4608,AnaEliza,1,0.00037,40460,14.76944,273944
4609,anaibol,1,0.00037,40461,14.76981,273944
4610,AnandChowdhary,1,0.00037,40462,14.77017,273944
4611,anantanandgupta,1,0.00037,40463,14.77054,273944
4612,anatoliy8493,1,0.00037,40464,14.77090,273944
4613,anchnk,1,0.00037,40465,14.77127,273944
4614,andela-batolagbe,1,0.00037,40466,14.77163,273944
4615,AndersDJohnson,1,0.00037,40467,14.77200,273944
4616,AndersMad,1,0.00037,40468,14.77236,273944
4617,andersonaguiar,1,0.00037,40469,14.77273,273944
4618,Andersos,1,0.00037,40470,14.77309,273944
4619,andidavies92,1,0.00037,40471,14.77346,273944
4620,andidev,1,0.00037,40472,14.77382,273944
4621,andre487,1,0.00037,40473,14.77419,273944
4622,andrebsguedes,1,0.00037,40474,14.77455,273944
4623,Andrei15193,1,0.00037,40475,14.77492,273944
4624,AndreiRailean,1,0.00037,40476,14.77528,273944
4625,andrejsinigoj,1,0.00037,40477,14.77565,273944
4626,andre-n,1,0.00037,40478,14.77601,273944
4627,andrew,1,0.00037,40479,14.77638,273944
4628,Andrew8xx8,1,0.00037,40480,14.77674,273944
4629,andrewarchi,1,0.00037,40481,14.77711,273944
4630,andrewdotn,1,0.00037,40482,14.77747,273944
4631,AndrewFinlay,1,0.00037,40483,14.77784,273944
4632,AndrewHenderson,1,0.00037,40484,14.77820,273944
4633,andrewhood125,1,0.00037,40485,14.77857,273944
4634,andrewimm,1,0.00037,40486,14.77893,273944
4635,AndrewKvalheim,1,0.00037,40487,14.77930,273944
4636,andrewlock,1,0.00037,40488,14.77966,273944
4637,andrewnester,1,0.00037,40489,14.78003,273944
4638,andrewshir,1,0.00037,40490,14.78039,273944
4639,andrewzhaosc,1,0.00037,40491,14.78076,273944
4640,andreybleme,1,0.00037,40492,14.78112,273944
4641,andreypopp,1,0.00037,40493,14.78149,273944
4642,andreyst,1,0.00037,40494,14.78185,273944
4643,andriisoldatenko,1,0.00037,40495,14.78222,273944
4644,andydavies92,1,0.00037,40496,14.78258,273944
4645,andyfeller,1,0.00037,40497,14.78295,273944
4646,andys8,1,0.00037,40498,14.78331,273944
4647,andyshora,1,0.00037,40499,14.78368,273944
4648,Anemolo,1,0.00037,40500,14.78404,273944
4649,anfedorov,1,0.00037,40501,14.78441,273944
4650,angadgill92,1,0.00037,40502,14.78477,273944
4651,AngryPidgeon,1,0.00037,40503,14.78514,273944
4652,anibalsanchez,1,0.00037,40504,14.78550,273944
4653,aniruddha-adhikary,1,0.00037,40505,14.78587,273944
4654,ankeetmaini,1,0.00037,40506,14.78623,273944
4655,ankitbko,1,0.00037,40507,14.78660,273944
4656,anniepank,1,0.00037,40508,14.78696,273944
4657,Announcement,1,0.00037,40509,14.78733,273944
4658,Anomen,1,0.00037,40510,14.78769,273944
4659,anotherpit,1,0.00037,40511,14.78806,273944
4660,anselmbradford,1,0.00037,40512,14.78842,273944
4661,anslzo,1,0.00037,40513,14.78879,273944
4662,anteriovieira,1,0.00037,40514,14.78915,273944
4663,anthonyvdotbe,1,0.00037,40515,14.78952,273944
4664,AnthumChris,1,0.00037,40516,14.78988,273944
4665,antiufo,1,0.00037,40517,14.79025,273944
4666,antleblanc,1,0.00037,40518,14.79061,273944
4667,antoniopangallo,1,0.00037,40519,14.79098,273944
4668,antons,1,0.00037,40520,14.79134,273944
4669,antonstefanov,1,0.00037,40521,14.79171,273944
4670,antplant,1,0.00037,40522,14.79207,273944
4671,anubhavgupta,1,0.00037,40523,14.79244,273944
4672,anujaware,1,0.00037,40524,14.79280,273944
4673,AoDev,1,0.00037,40525,14.79317,273944
4674,APassanisi,1,0.00037,40526,14.79353,273944
4675,apostolos,1,0.00037,40527,14.79390,273944
4676,appden,1,0.00037,40528,14.79426,273944
4677,applideveloper,1,0.00037,40529,14.79463,273944
4678,AprilArcus,1,0.00037,40530,14.79499,273944
4679,Aprillion,1,0.00037,40531,14.79536,273944
4680,apsdehal,1,0.00037,40532,14.79572,273944
4681,apsknight,1,0.00037,40533,14.79609,273944
4682,aquarion,1,0.00037,40534,14.79645,273944
4683,ar7z1,1,0.00037,40535,14.79682,273944
4684,arahansen,1,0.00037,40536,14.79718,273944
4685,araname,1,0.00037,40537,14.79755,273944
4686,araslanov,1,0.00037,40538,14.79791,273944
4687,a-r-d,1,0.00037,40539,14.79828,273944
4688,aredridel,1,0.00037,40540,14.79864,273944
4689,arendjr,1,0.00037,40541,14.79901,273944
4690,arend-von-reinersdorff,1,0.00037,40542,14.79938,273944
4691,ares128,1,0.00037,40543,14.79974,273944
4692,Arhell,1,0.00037,40544,14.80011,273944
4693,arifogel,1,0.00037,40545,14.80047,273944
4694,arkamar,1,0.00037,40546,14.80084,273944
4695,arkan,1,0.00037,40547,14.80120,273944
4696,Arkanosis,1,0.00037,40548,14.80157,273944
4697,armandino,1,0.00037,40549,14.80193,273944
4698,arminherling,1,0.00037,40550,14.80230,273944
4699,arnaudroger,1,0.00037,40551,14.80266,273944
4700,Arneball,1,0.00037,40552,14.80303,273944
4701,arodr967,1,0.00037,40553,14.80339,273944
4702,aroget,1,0.00037,40554,14.80376,273944
4703,arosh,1,0.00037,40555,14.80412,273944
4704,arouel,1,0.00037,40556,14.80449,273944
4705,arpit2438735,1,0.00037,40557,14.80485,273944
4706,ArtemKoval,1,0.00037,40558,14.80522,273944
4707,ArtsiomCh,1,0.00037,40559,14.80558,273944
4708,arturoromeroslc,1,0.00037,40560,14.80595,273944
4709,arturoromerotcs,1,0.00037,40561,14.80631,273944
4710,artyil,1,0.00037,40562,14.80668,273944
4711,artywhite,1,0.00037,40563,14.80704,273944
4712,aruberto,1,0.00037,40564,14.80741,273944
4713,arunasank,1,0.00037,40565,14.80777,273944
4714,arxene,1,0.00037,40566,14.80814,273944
4715,aryelu,1,0.00037,40567,14.80850,273944
4716,arzafran,1,0.00037,40568,14.80887,273944
4717,asaarilahti,1,0.00037,40569,14.80923,273944
4718,asa-git,1,0.00037,40570,14.80960,273944
4719,asakaev,1,0.00037,40571,14.80996,273944
4720,ASayre,1,0.00037,40572,14.81033,273944
4721,ascott18,1,0.00037,40573,14.81069,273944
4722,aseovic,1,0.00037,40574,14.81106,273944
4723,ashishdawale20,1,0.00037,40575,14.81142,273944
4724,ashishpatelcs,1,0.00037,40576,14.81179,273944
4725,ashwinbhaskar,1,0.00037,40577,14.81215,273944
4726,asieira,1,0.00037,40578,14.81252,273944
4727,asiffermann,1,0.00037,40579,14.81288,273944
4728,asika32764,1,0.00037,40580,14.81325,273944
4729,asilinwei,1,0.00037,40581,14.81361,273944
4730,asiplas,1,0.00037,40582,14.81398,273944
4731,askoning,1,0.00037,40583,14.81434,273944
4732,asleepysamurai,1,0.00037,40584,14.81471,273944
4733,aspala,1,0.00037,40585,14.81507,273944
4734,asperry152,1,0.00037,40586,14.81544,273944
4735,aspyatkin,1,0.00037,40587,14.81580,273944
4736,Asthetic,1,0.00037,40588,14.81617,273944
4737,ateoi,1,0.00037,40589,14.81653,273944
4738,atifaziz,1,0.00037,40590,14.81690,273944
4739,atogata,1,0.00037,40591,14.81726,273944
4740,A-Tokyo,1,0.00037,40592,14.81763,273944
4741,atombrella,1,0.00037,40593,14.81799,273944
4742,atom-morgan,1,0.00037,40594,14.81836,273944
4743,augbog,1,0.00037,40595,14.81872,273944
4744,august782,1,0.00037,40596,14.81909,273944
4745,augusto-cdxs,1,0.00037,40597,14.81945,273944
4746,austinrmiller,1,0.00037,40598,14.81982,273944
4747,autowp,1,0.00037,40599,14.82018,273944
4748,autra,1,0.00037,40600,14.82055,273944
4749,avanderhoorn,1,0.00037,40601,14.82091,273944
4750,avdg,1,0.00037,40602,14.82128,273944
4751,avianbc,1,0.00037,40603,14.82164,273944
4752,avielfedida,1,0.00037,40604,14.82201,273944
4753,avnash,1,0.00037,40605,14.82237,273944
4754,avnersorek,1,0.00037,40606,14.82274,273944
4755,avsorokin,1,0.00037,40607,14.82310,273944
4756,AVVS,1,0.00037,40608,14.82347,273944
4757,awiddersheim,1,0.00037,40609,14.82383,273944
4758,awlayton,1,0.00037,40610,14.82420,273944
4759,awwright,1,0.00037,40611,14.82456,273944
4760,axel-wilczek,1,0.00037,40612,14.82493,273944
4761,axu2,1,0.00037,40613,14.82529,273944
4762,Ayachii,1,0.00037,40614,14.82566,273944
4763,ayhaadam,1,0.00037,40615,14.82602,273944
4764,aymericbouzy,1,0.00037,40616,14.82639,273944
4765,AyushG3112,1,0.00037,40617,14.82675,273944
4766,AYWWWWW,1,0.00037,40618,14.82712,273944
4767,azrijamil,1,0.00037,40619,14.82748,273944
4768,azz,1,0.00037,40620,14.82785,273944
4769,B0k0,1,0.00037,40621,14.82821,273944
4770,baahmi,1,0.00037,40622,14.82858,273944
4771,babich-a,1,0.00037,40623,14.82894,273944
4772,baboquivari,1,0.00037,40624,14.82931,273944
4773,backuitist,1,0.00037,40625,14.82967,273944
4774,badrmodoukh,1,0.00037,40626,14.83004,273944
4775,bagerard,1,0.00037,40627,14.83040,273944
4776,BaileyJM02,1,0.00037,40628,14.83077,273944
4777,bakape,1,0.00037,40629,14.83113,273944
4778,bakkot,1,0.00037,40630,14.83150,273944
4779,bakorer,1,0.00037,40631,14.83186,273944
4780,balduncle,1,0.00037,40632,14.83223,273944
4781,balta3,1,0.00037,40633,14.83259,273944
4782,Bamieh,1,0.00037,40634,14.83296,273944
4783,banderson,1,0.00037,40635,14.83332,273944
4784,banterability,1,0.00037,40636,14.83369,273944
4785,bao987654321,1,0.00037,40637,14.83405,273944
4786,bargemb,1,0.00037,40638,14.83442,273944
4787,barik,1,0.00037,40639,14.83478,273944
4788,barneycarroll,1,0.00037,40640,14.83515,273944
4789,baronswindle,1,0.00037,40641,14.83551,273944
4790,barraq,1,0.00037,40642,14.83588,273944
4791,barrymichaeldoyle,1,0.00037,40643,14.83624,273944
4792,BartoszJanota,1,0.00037,40644,14.83661,273944
4793,bartriordan,1,0.00037,40645,14.83697,273944
4794,Baschdl,1,0.00037,40646,14.83734,273944
4795,basecode,1,0.00037,40647,14.83770,273944
4796,baspeeters,1,0.00037,40648,14.83807,273944
4797,bastih,1,0.00037,40649,14.83843,273944
4798,battaile,1,0.00037,40650,14.83880,273944
4799,bazuka5801,1,0.00037,40651,14.83916,273944
4800,bbalvanera,1,0.00037,40652,14.83953,273944
4801,bbeckercscc,1,0.00037,40653,14.83989,273944
4802,bbenezech,1,0.00037,40654,14.84026,273944
4803,bbodenmiller,1,0.00037,40655,14.84062,273944
4804,bbolek,1,0.00037,40656,14.84099,273944
4805,bbrooks,1,0.00037,40657,14.84135,273944
4806,bbshih,1,0.00037,40658,14.84172,273944
4807,bbyars,1,0.00037,40659,14.84208,273944
4808,bcbcb,1,0.00037,40660,14.84245,273944
4809,bdanchilla,1,0.00037,40661,14.84281,273944
4810,BDav24,1,0.00037,40662,14.84318,273944
4811,bdmason,1,0.00037,40663,14.84354,273944
4812,bdonlan,1,0.00037,40664,14.84391,273944
4813,bearmini,1,0.00037,40665,14.84427,273944
4814,beatfactor,1,0.00037,40666,14.84464,273944
4815,bedakb,1,0.00037,40667,14.84500,273944
4816,bee0060,1,0.00037,40668,14.84537,273944
4817,bekker,1,0.00037,40669,14.84573,273944
4818,bekos,1,0.00037,40670,14.84610,273944
4819,Belax8,1,0.00037,40671,14.84646,273944
4820,Belev,1,0.00037,40672,14.84683,273944
4821,ben-bradley,1,0.00037,40673,14.84720,273944
4822,benceHornyak,1,0.00037,40674,14.84756,273944
4823,beneidel,1,0.00037,40675,14.84793,273944
4824,benekastah,1,0.00037,40676,14.84829,273944
4825,benelsen,1,0.00037,40677,14.84866,273944
4826,benfleis,1,0.00037,40678,14.84902,273944
4827,bengotow,1,0.00037,40679,14.84939,273944
4828,benhalpern,1,0.00037,40680,14.84975,273944
4829,benheymink,1,0.00037,40681,14.85012,273944
4830,benhutchins,1,0.00037,40682,14.85048,273944
4831,benigeri,1,0.00037,40683,14.85085,273944
4832,benjaffe,1,0.00037,40684,14.85121,273944
4833,benjamin-bader,1,0.00037,40685,14.85158,273944
4834,benjamindean,1,0.00037,40686,14.85194,273944
4835,benjamin-hodgson,1,0.00037,40687,14.85231,273944
4836,benjaminhoffman,1,0.00037,40688,14.85267,273944
4837,benjefferies,1,0.00037,40689,14.85304,273944
4838,ben-joostens,1,0.00037,40690,14.85340,273944
4839,benjycui,1,0.00037,40691,14.85377,273944
4840,ben-manes,1,0.00037,40692,14.85413,273944
4841,bennycoomans,1,0.00037,40693,14.85450,273944
4842,ben-page,1,0.00037,40694,14.85486,273944
4843,benrei,1,0.00037,40695,14.85523,273944
4844,benstepp,1,0.00037,40696,14.85559,273944
4845,bernard-leech,1,0.00037,40697,14.85596,273944
4846,berndartmueller,1,0.00037,40698,14.85632,273944
4847,berniefitz82,1,0.00037,40699,14.85669,273944
4848,Betanu701,1,0.00037,40700,14.85705,273944
4849,betaveros,1,0.00037,40701,14.85742,273944
4850,bettiolo,1,0.00037,40702,14.85778,273944
4851,bevanhunt,1,0.00037,40703,14.85815,273944
4852,bfricka,1,0.00037,40704,14.85851,273944
4853,bglick,1,0.00037,40705,14.85888,273944
4854,bgord,1,0.00037,40706,14.85924,273944
4855,bgoscinski,1,0.00037,40707,14.85961,273944
4856,bgribaudo,1,0.00037,40708,14.85997,273944
4857,bgschiller,1,0.00037,40709,14.86034,273944
4858,bhdrkn,1,0.00037,40710,14.86070,273944
4859,bholley,1,0.00037,40711,14.86107,273944
4860,Bhudjo,1,0.00037,40712,14.86143,273944
4861,biboudis,1,0.00037,40713,14.86180,273944
4862,BigAB,1,0.00037,40714,14.86216,273944
4863,big-andy-coates,1,0.00037,40715,14.86253,273944
4864,Bigguy34,1,0.00037,40716,14.86289,273944
4865,biglovisa,1,0.00037,40717,14.86326,273944
4866,billschaller,1,0.00037,40718,14.86362,273944
4867,biokillos,1,0.00037,40719,14.86399,273944
4868,bioxcode,1,0.00037,40720,14.86435,273944
4869,birkmose,1,0.00037,40721,14.86472,273944
4870,bishabosha,1,0.00037,40722,14.86508,273944
4871,bishwei,1,0.00037,40723,14.86545,273944
4872,bitbonk,1,0.00037,40724,14.86581,273944
4873,bitsal,1,0.00037,40725,14.86618,273944
4874,bjornstar,1,0.00037,40726,14.86654,273944
4875,bjrmatos,1,0.00037,40727,14.86691,273944
4876,bkdotcom,1,0.00037,40728,14.86727,273944
4877,blackdynamo,1,0.00037,40729,14.86764,273944
4878,blainekasten,1,0.00037,40730,14.86800,273944
4879,blainesch,1,0.00037,40731,14.86837,273944
4880,blair,1,0.00037,40732,14.86873,273944
4881,Blaisorblade,1,0.00037,40733,14.86910,273944
4882,bleshik,1,0.00037,40734,14.86946,273944
4883,bloggervista,1,0.00037,40735,14.86983,273944
4884,blokfyuh,1,0.00037,40736,14.87019,273944
4885,BloodShura,1,0.00037,40737,14.87056,273944
4886,BlueAccords,1,0.00037,40738,14.87092,273944
4887,bluelineXY,1,0.00037,40739,14.87129,273944
4888,bmac,1,0.00037,40740,14.87165,273944
4889,bmeverett,1,0.00037,40741,14.87202,273944
4890,bmispelon,1,0.00037,40742,14.87238,273944
4891,bmwadforth,1,0.00037,40743,14.87275,273944
4892,bnb,1,0.00037,40744,14.87311,273944
4893,bnorm,1,0.00037,40745,14.87348,273944
4894,bnyu,1,0.00037,40746,14.87384,273944
4895,bobbyrenwick,1,0.00037,40747,14.87421,273944
4896,BobSammers,1,0.00037,40748,14.87457,273944
4897,bocus,1,0.00037,40749,14.87494,273944
4898,Bodasia,1,0.00037,40750,14.87530,273944
4899,bodazhao,1,0.00037,40751,14.87567,273944
4900,bodgit,1,0.00037,40752,14.87603,273944
4901,bogas04,1,0.00037,40753,14.87640,273944
4902,BoLaMN,1,0.00037,40754,14.87676,273944
4903,bonham000,1,0.00037,40755,14.87713,273944
4904,bontibon,1,0.00037,40756,14.87749,273944
4905,BookOfGreg,1,0.00037,40757,14.87786,273944
4906,boopeshmahendran,1,0.00037,40758,14.87822,273944
4907,borgdylan,1,0.00037,40759,14.87859,273944
4908,borisyankov,1,0.00037,40760,14.87895,273944
4909,BorntraegerMarc,1,0.00037,40761,14.87932,273944
4910,BorodinDK,1,0.00037,40762,14.87968,273944
4911,borriglione,1,0.00037,40763,14.88005,273944
4912,borsna,1,0.00037,40764,14.88041,273944
4913,botaberg,1,0.00037,40765,14.88078,273944
4914,botovq,1,0.00037,40766,14.88114,273944
4915,boutell,1,0.00037,40767,14.88151,273944
4916,bowlofeggs,1,0.00037,40768,14.88187,273944
4917,boyaq,1,0.00037,40769,14.88224,273944
4918,Bpaterak,1,0.00037,40770,14.88260,273944
4919,b-paul,1,0.00037,40771,14.88297,273944
4920,bpetex,1,0.00037,40772,14.88333,273944
4921,bploetz,1,0.00037,40773,14.88370,273944
4922,bportnoy,1,0.00037,40774,14.88406,273944
4923,braddunbar,1,0.00037,40775,14.88443,273944
4924,bradleyayers,1,0.00037,40776,14.88479,273944
4925,bradvogel,1,0.00037,40777,14.88516,273944
4926,brafdlog,1,0.00037,40778,14.88552,273944
4927,brandon93s,1,0.00037,40779,14.88589,273944
4928,brandon-d-logan,1,0.00037,40780,14.88625,273944
4929,brandon-pereira,1,0.00037,40781,14.88662,273944
4930,BrandonSmith,1,0.00037,40782,14.88698,273944
4931,BredPet,1,0.00037,40783,14.88735,273944
4932,Breemua,1,0.00037,40784,14.88771,273944
4933,brian428,1,0.00037,40785,14.88808,273944
4934,briandealwis,1,0.00037,40786,14.88844,273944
4935,BrianDGLS,1,0.00037,40787,14.88881,273944
4936,BrianDiggs,1,0.00037,40788,14.88917,273944
4937,brian-mann,1,0.00037,40789,14.88954,273944
4938,brickspert,1,0.00037,40790,14.88990,273944
4939,bricss,1,0.00037,40791,14.89027,273944
4940,BrightLight,1,0.00037,40792,14.89063,273944
4941,brismuth,1,0.00037,40793,14.89100,273944
4942,brnrdog,1,0.00037,40794,14.89136,273944
4943,broder,1,0.00037,40795,14.89173,273944
4944,brodybits,1,0.00037,40796,14.89209,273944
4945,brunokrebs,1,0.00037,40797,14.89246,273944
4946,brunolins16,1,0.00037,40798,14.89282,273944
4947,brunoscopelliti,1,0.00037,40799,14.89319,273944
4948,bryanar,1,0.00037,40800,14.89355,273944
4949,bryanjenningz,1,0.00037,40801,14.89392,273944
4950,bsdjhb,1,0.00037,40802,14.89428,273944
4951,bsergei,1,0.00037,40803,14.89465,273944
4952,bsletten,1,0.00037,40804,14.89502,273944
4953,btd,1,0.00037,40805,14.89538,273944
4954,btholt,1,0.00037,40806,14.89575,273944
4955,btmills,1,0.00037,40807,14.89611,273944
4956,buddh4,1,0.00037,40808,14.89648,273944
4957,buddyabaddon,1,0.00037,40809,14.89684,273944
4958,buerkle,1,0.00037,40810,14.89721,273944
4959,bugknightyyp,1,0.00037,40811,14.89757,273944
4960,bugsancho,1,0.00037,40812,14.89794,273944
4961,bugtype,1,0.00037,40813,14.89830,273944
4962,burnedram,1,0.00037,40814,14.89867,273944
4963,burningtree,1,0.00037,40815,14.89903,273944
4964,bushuai,1,0.00037,40816,14.89940,273944
4965,bustta,1,0.00037,40817,14.89976,273944
4966,butla,1,0.00037,40818,14.90013,273944
4967,butterprim,1,0.00037,40819,14.90049,273944
4968,bvleur,1,0.00037,40820,14.90086,273944
4969,byr-gdp,1,0.00037,40821,14.90122,273944
4970,C0rWin,1,0.00037,40822,14.90159,273944
4971,Cactucs,1,0.00037,40823,14.90195,273944
4972,caillou,1,0.00037,40824,14.90232,273944
4973,califrench,1,0.00037,40825,14.90268,273944
4974,callumcodes,1,0.00037,40826,14.90305,273944
4975,calvinf,1,0.00037,40827,14.90341,273944
4976,Calyhre,1,0.00037,40828,14.90378,273944
4977,cancerberoSgx,1,0.00037,40829,14.90414,273944
4978,cannona,1,0.00037,40830,14.90451,273944
4979,capaj,1,0.00037,40831,14.90487,273944
4980,CaptainCow95,1,0.00037,40832,14.90524,273944
4981,captain-digitalsailors,1,0.00037,40833,14.90560,273944
4982,cardamon,1,0.00037,40834,14.90597,273944
4983,caridy,1,0.00037,40835,14.90633,273944
4984,carkod,1,0.00037,40836,14.90670,273944
4985,carlansley,1,0.00037,40837,14.90706,273944
4986,carlfranz,1,0.00037,40838,14.90743,273944
4987,CarloMartini,1,0.00037,40839,14.90779,273944
4988,carlosasj,1,0.00037,40840,14.90816,273944
4989,carlosvargas,1,0.00037,40841,14.90852,273944
4990,Carlsson87,1,0.00037,40842,14.90889,273944
4991,carolinacmoravia,1,0.00037,40843,14.90925,273944
4992,carterchung,1,0.00037,40844,14.90962,273944
4993,carterkozak,1,0.00037,40845,14.90998,273944
4994,cascornelissen,1,0.00037,40846,14.91035,273944
4995,casdevs,1,0.00037,40847,14.91071,273944
4996,CaseyLeask,1,0.00037,40848,14.91108,273944
4997,castilloandres,1,0.00037,40849,14.91144,273944
4998,CasualSuperman,1,0.00037,40850,14.91181,273944
4999,catamphetamine,1,0.00037,40851,14.91217,273944
5000,catanm,1,0.00037,40852,14.91254,273944
5001,catcake,1,0.00037,40853,14.91290,273944
5002,caub,1,0.00037,40854,14.91327,273944
5003,cbejensen,1,0.00037,40855,14.91363,273944
5004,cbguder,1,0.00037,40856,14.91400,273944
5005,cbrianso,1,0.00037,40857,14.91436,273944
5006,cchanxzy,1,0.00037,40858,14.91473,273944
5007,ccjoywang,1,0.00037,40859,14.91509,273944
5008,cconroy,1,0.00037,40860,14.91546,273944
5009,cdoremus,1,0.00037,40861,14.91582,273944
5010,cemeyer,1,0.00037,40862,14.91619,273944
5011,ceph3us,1,0.00037,40863,14.91655,273944
5012,cesarblum,1,0.00037,40864,14.91692,273944
5013,cesarbs,1,0.00037,40865,14.91728,273944
5014,cesarwbr,1,0.00037,40866,14.91765,273944
5015,cgamache,1,0.00037,40867,14.91801,273944
5016,c-geek,1,0.00037,40868,14.91838,273944
5017,cgrail,1,0.00037,40869,14.91874,273944
5018,chadhietala,1,0.00037,40870,14.91911,273944
5019,chadselph,1,0.00037,40871,14.91947,273944
5020,ChaitanyaPramod,1,0.00037,40872,14.91984,273944
5021,chamila-c,1,0.00037,40873,14.92020,273944
5022,chancedickson,1,0.00037,40874,14.92057,273944
5023,changhw01,1,0.00037,40875,14.92093,273944
5024,changLiuUNSW,1,0.00037,40876,14.92130,273944
5025,channeladam,1,0.00037,40877,14.92166,273944
5026,Charca,1,0.00037,40878,14.92203,273944
5027,CharlieGarcia,1,0.00037,40879,14.92239,273944
5028,charphi,1,0.00037,40880,14.92276,273944
5029,charukiewicz,1,0.00037,40881,14.92312,273944
5030,chaseadamsio,1,0.00037,40882,14.92349,273944
5031,cheeaun,1,0.00037,40883,14.92385,273944
5032,chenesan,1,0.00037,40884,14.92422,273944
5033,chengkungui,1,0.00037,40885,14.92458,273944
5034,chengluyu,1,0.00037,40886,14.92495,273944
5035,chenzhenxi,1,0.00037,40887,14.92531,273944
5036,cherniavskii,1,0.00037,40888,14.92568,273944
5037,chernysh,1,0.00037,40889,14.92604,273944
5038,chetbox,1,0.00037,40890,14.92641,273944
5039,chgc,1,0.00037,40891,14.92677,273944
5040,Chickenzilla,1,0.00037,40892,14.92714,273944
5041,chidozieononiwu,1,0.00037,40893,14.92750,273944
5042,chienkira,1,0.00037,40894,14.92787,273944
5043,Chima1707,1,0.00037,40895,14.92823,273944
5044,chinhodado,1,0.00037,40896,14.92860,273944
5045,chipaca,1,0.00037,40897,14.92896,273944
5046,chiragatlas,1,0.00037,40898,14.92933,273944
5047,chisler,1,0.00037,40899,14.92969,273944
5048,chmelevskij,1,0.00037,40900,14.93006,273944
5049,Chobbes,1,0.00037,40901,14.93042,273944
5050,chojrak11,1,0.00037,40902,14.93079,273944
5051,chris13524,1,0.00037,40903,14.93115,273944
5052,chris-barry,1,0.00037,40904,14.93152,273944
5053,chrisbianca,1,0.00037,40905,14.93188,273944
5054,chrisbolin,1,0.00037,40906,14.93225,273944
5055,chrisbujok,1,0.00037,40907,14.93261,273944
5056,chriscalo,1,0.00037,40908,14.93298,273944
5057,chriscartlidge,1,0.00037,40909,14.93334,273944
5058,chrisgavin,1,0.00037,40910,14.93371,273944
5059,chrisgrovers,1,0.00037,40911,14.93407,273944
5060,chriskrolak,1,0.00037,40912,14.93444,273944
5061,chris-martin,1,0.00037,40913,14.93480,273944
5062,chrisprice,1,0.00037,40914,14.93517,273944
5063,chrisranderson,1,0.00037,40915,14.93553,273944
5064,chrisrpatterson,1,0.00037,40916,14.93590,273944
5065,chrisself,1,0.00037,40917,14.93626,273944
5066,christianbundy,1,0.00037,40918,14.93663,273944
5067,ChristianSchwarz,1,0.00037,40919,14.93699,273944
5068,ChristianUlbrich,1,0.00037,40920,14.93736,273944
5069,christikaes,1,0.00037,40921,14.93772,273944
5070,ChristopherDavenport,1,0.00037,40922,14.93809,273944
5071,christopherjbaker,1,0.00037,40923,14.93845,273944
5072,chrisui,1,0.00037,40924,14.93882,273944
5073,chrisvfabio,1,0.00037,40925,14.93918,273944
5074,chrisyip,1,0.00037,40926,14.93955,273944
5075,chromakey,1,0.00037,40927,14.93991,273944
5076,chrstnbrn,1,0.00037,40928,14.94028,273944
5077,chtseac,1,0.00037,40929,14.94064,273944
5078,chulkilee,1,0.00037,40930,14.94101,273944
5079,chumtoadafuq,1,0.00037,40931,14.94137,273944
5080,ChuntaoLu,1,0.00037,40932,14.94174,273944
5081,Chyngyz,1,0.00037,40933,14.94210,273944
5082,ciceropablo,1,0.00037,40934,14.94247,273944
5083,ciddan,1,0.00037,40935,14.94284,273944
5084,citium,1,0.00037,40936,14.94320,273944
5085,cjc343,1,0.00037,40937,14.94357,273944
5086,cjpillsbury,1,0.00037,40938,14.94393,273944
5087,ckuhn,1,0.00037,40939,14.94430,273944
5088,cladera,1,0.00037,40940,14.94466,273944
5089,clairecliu,1,0.00037,40941,14.94503,273944
5090,clairecoloma,1,0.00037,40942,14.94539,273944
5091,claudi,1,0.00037,40943,14.94576,273944
5092,claudiopro,1,0.00037,40944,14.94612,273944
5093,clavecoder,1,0.00037,40945,14.94649,273944
5094,claylo,1,0.00037,40946,14.94685,273944
5095,cleitonmendonca,1,0.00037,40947,14.94722,273944
5096,clhenrick,1,0.00037,40948,14.94758,273944
5097,cliener,1,0.00037,40949,14.94795,273944
5098,clockworked247,1,0.00037,40950,14.94831,273944
5099,C-Lodder,1,0.00037,40951,14.94868,273944
5100,cloojure,1,0.00037,40952,14.94904,273944
5101,cmatheson,1,0.00037,40953,14.94941,273944
5102,cmpt376edits,1,0.00037,40954,14.94977,273944
5103,cmwall,1,0.00037,40955,14.95014,273944
5104,cnblogs-dudu,1,0.00037,40956,14.95050,273944
5105,cod7alex,1,0.00037,40957,14.95087,273944
5106,codef0rmer,1,0.00037,40958,14.95123,273944
5107,CodeFoodPixels,1,0.00037,40959,14.95160,273944
5108,codeheroics,1,0.00037,40960,14.95196,273944
5109,codepodu,1,0.00037,40961,14.95233,273944
5110,coderberry,1,0.00037,40962,14.95269,273944
5111,CoderK,1,0.00037,40963,14.95306,273944
5112,CodeTherapist,1,0.00037,40964,14.95342,273944
5113,CodinCat,1,0.00037,40965,14.95379,273944
5114,codingismy11to7,1,0.00037,40966,14.95415,273944
5115,codingtwinky,1,0.00037,40967,14.95452,273944
5116,CodogoFreddie,1,0.00037,40968,14.95488,273944
5117,codyj110,1,0.00037,40969,14.95525,273944
5118,codylerum,1,0.00037,40970,14.95561,273944
5119,Cody-Nicholson,1,0.00037,40971,14.95598,273944
5120,coenm,1,0.00037,40972,14.95634,273944
5121,colelawrence,1,0.00037,40973,14.95671,273944
5122,coleturner,1,0.00037,40974,14.95707,273944
5123,collink,1,0.00037,40975,14.95744,273944
5124,compulim,1,0.00037,40976,14.95780,273944
5125,coms,1,0.00037,40977,14.95817,273944
5126,conartist6,1,0.00037,40978,14.95853,273944
5127,ConnorMcF,1,0.00037,40979,14.95890,273944
5128,ConradIrwin,1,0.00037,40980,14.95926,273944
5129,conradoplg,1,0.00037,40981,14.95963,273944
5130,CoolCoderTony,1,0.00037,40982,14.95999,273944
5131,coolgod,1,0.00037,40983,14.96036,273944
5132,CoolGoose,1,0.00037,40984,14.96072,273944
5133,coorasse,1,0.00037,40985,14.96109,273944
5134,coreh,1,0.00037,40986,14.96145,273944
5135,Corillian,1,0.00037,40987,14.96182,273944
5136,cornedor,1,0.00037,40988,14.96218,273944
5137,coryasilva,1,0.00037,40989,14.96255,273944
5138,costahome,1,0.00037,40990,14.96291,273944
5139,countless-integers,1,0.00037,40991,14.96328,273944
5140,coutin,1,0.00037,40992,14.96364,273944
5141,couven92,1,0.00037,40993,14.96401,273944
5142,covener,1,0.00037,40994,14.96437,273944
5143,cowwoc,1,0.00037,40995,14.96474,273944
5144,cpillsbury,1,0.00037,40996,14.96510,273944
5145,cpiotr,1,0.00037,40997,14.96547,273944
5146,cquanu,1,0.00037,40998,14.96583,273944
5147,craigajohnson,1,0.00037,40999,14.96620,273944
5148,craigdanj,1,0.00037,41000,14.96656,273944
5149,cravler,1,0.00037,41001,14.96693,273944
5150,CRC-Mismatch,1,0.00037,41002,14.96729,273944
5151,crhistianramirez,1,0.00037,41003,14.96766,273944
5152,crmckenzie,1,0.00037,41004,14.96802,273944
5153,Cronan,1,0.00037,41005,14.96839,273944
5154,crosscompile,1,0.00037,41006,14.96875,273944
5155,crteal,1,0.00037,41007,14.96912,273944
5156,crux153,1,0.00037,41008,14.96948,273944
5157,Crysinyan,1,0.00037,41009,14.96985,273944
5158,csbok,1,0.00037,41010,14.97021,273944
5159,CSchulz,1,0.00037,41011,14.97058,273944
5160,CSharpFan,1,0.00037,41012,14.97094,273944
5161,Cslove,1,0.00037,41013,14.97131,273944
5162,csswizardry,1,0.00037,41014,14.97167,273944
5163,cstamas,1,0.00037,41015,14.97204,273944
5164,ctide,1,0.00037,41016,14.97240,273944
5165,ctyar,1,0.00037,41017,14.97277,273944
5166,cukejianya,1,0.00037,41018,14.97313,273944
5167,curiousdannii,1,0.00037,41019,14.97350,273944
5168,curtgrimes,1,0.00037,41020,14.97386,273944
5169,cweems,1,0.00037,41021,14.97423,273944
5170,cwohlman,1,0.00037,41022,14.97459,273944
5171,CWSpear,1,0.00037,41023,14.97496,273944
5172,cyberjacob,1,0.00037,41024,14.97532,273944
5173,CyborgMaster,1,0.00037,41025,14.97569,273944
5174,cydhaselton,1,0.00037,41026,14.97605,273944
5175,cydrobolt,1,0.00037,41027,14.97642,273944
5176,cypok,1,0.00037,41028,14.97678,273944
5177,czamp,1,0.00037,41029,14.97715,273944
5178,d6u,1,0.00037,41030,14.97751,273944
5179,DaAwesomeP,1,0.00037,41031,14.97788,273944
5180,dackmin,1,0.00037,41032,14.97824,273944
5181,daedalus28,1,0.00037,41033,14.97861,273944
5182,daevidpreis,1,0.00037,41034,14.97897,273944
5183,dafo,1,0.00037,41035,14.97934,273944
5184,daggerjames,1,0.00037,41036,14.97970,273944
5185,dagstuan,1,0.00037,41037,14.98007,273944
5186,dahim2006,1,0.00037,41038,14.98043,273944
5187,dalyhabit,1,0.00037,41039,14.98080,273944
5188,damian,1,0.00037,41040,14.98116,273944
5189,damrbaby,1,0.00037,41041,14.98153,273944
5190,damusnet,1,0.00037,41042,14.98189,273944
5191,dangreen,1,0.00037,41043,14.98226,273944
5192,daniel347x,1,0.00037,41044,14.98262,273944
5193,danielb2,1,0.00037,41045,14.98299,273944
5194,DanielBaird,1,0.00037,41046,14.98335,273944
5195,danielberndt,1,0.00037,41047,14.98372,273944
5196,danielgindi,1,0.00037,41048,14.98408,273944
5197,danielmachado,1,0.00037,41049,14.98445,273944
5198,danielmendel,1,0.00037,41050,14.98481,273944
5199,DanielPintilei,1,0.00037,41051,14.98518,273944
5200,danielpowell4,1,0.00037,41052,14.98554,273944
5201,danielrob,1,0.00037,41053,14.98591,273944
5202,danielsharvey,1,0.00037,41054,14.98627,273944
5203,danieltaub96,1,0.00037,41055,14.98664,273944
5204,daniilguit,1,0.00037,41056,14.98700,273944
5205,dankelleher,1,0.00037,41057,14.98737,273944
5206,danmana,1,0.00037,41058,14.98773,273944
5207,DannyDelott,1,0.00037,41059,14.98810,273944
5208,danpatnate,1,0.00037,41060,14.98846,273944
5209,darcyparker,1,0.00037,41061,14.98883,273944
5210,dariocravero,1,0.00037,41062,14.98919,273944
5211,DarkDimius,1,0.00037,41063,14.98956,273944
5212,DarkScorpion,1,0.00037,41064,14.98992,273944
5213,Darnor,1,0.00037,41065,14.99029,273944
5214,darxis,1,0.00037,41066,14.99066,273944
5215,dasa,1,0.00037,41067,14.99102,273944
5216,DaSchTour,1,0.00037,41068,14.99139,273944
5217,das-peter,1,0.00037,41069,14.99175,273944
5218,dasraf9,1,0.00037,41070,14.99212,273944
5219,datyayu,1,0.00037,41071,14.99248,273944
5220,daurnimator,1,0.00037,41072,14.99285,273944
5221,DaveJarvis,1,0.00037,41073,14.99321,273944
5222,davemeetsworld,1,0.00037,41074,14.99358,273944
5223,davestewart,1,0.00037,41075,14.99394,273944
5224,davethegr8,1,0.00037,41076,14.99431,273944
5225,david0178418,1,0.00037,41077,14.99467,273944
5226,davidadas,1,0.00037,41078,14.99504,273944
5227,DavidARussell,1,0.00037,41079,14.99540,273944
5228,davidblnc,1,0.00037,41080,14.99577,273944
5229,davidcigital,1,0.00037,41081,14.99613,273944
5230,DavidDTA,1,0.00037,41082,14.99650,273944
5231,davideast,1,0.00037,41083,14.99686,273944
5232,DavideD,1,0.00037,41084,14.99723,273944
5233,DavideViolante,1,0.00037,41085,14.99759,273944
5234,davidfurlong,1,0.00037,41086,14.99796,273944
5235,davidgilbertson,1,0.00037,41087,14.99832,273944
5236,DavidGregory084,1,0.00037,41088,14.99869,273944
5237,davidjrichardson,1,0.00037,41089,14.99905,273944
5238,davidkpiano,1,0.00037,41090,14.99942,273944
5239,davidlehn,1,0.00037,41091,14.99978,273944
5240,davidmoten,1,0.00037,41092,15.00015,273944
5241,davidpatrick,1,0.00037,41093,15.00051,273944
5242,davidrbright,1,0.00037,41094,15.00088,273944
5243,david-reiman-ck,1,0.00037,41095,15.00124,273944
5244,davidsheldon,1,0.00037,41096,15.00161,273944
5245,DavidTPate,1,0.00037,41097,15.00197,273944
5246,davidwood,1,0.00037,41098,15.00234,273944
5247,daviferreira,1,0.00037,41099,15.00270,273944
5248,davilimap,1,0.00037,41100,15.00307,273944
5249,davxy,1,0.00037,41101,15.00343,273944
5250,davzucky,1,0.00037,41102,15.00380,273944
5251,DawidTabak,1,0.00037,41103,15.00416,273944
5252,dbardbar,1,0.00037,41104,15.00453,273944
5253,dbkaplun,1,0.00037,41105,15.00489,273944
5254,dbkirk4211,1,0.00037,41106,15.00526,273944
5255,dbmikus,1,0.00037,41107,15.00562,273944
5256,dboshardy,1,0.00037,41108,15.00599,273944
5257,dbrugne,1,0.00037,41109,15.00635,273944
5258,dcsp,1,0.00037,41110,15.00672,273944
5259,DCtheTall,1,0.00037,41111,15.00708,273944
5260,dcworldwide,1,0.00037,41112,15.00745,273944
5261,ddebree,1,0.00037,41113,15.00781,273944
5262,ddneat,1,0.00037,41114,15.00818,273944
5263,DDRBoxman,1,0.00037,41115,15.00854,273944
5264,ddrjm,1,0.00037,41116,15.00891,273944
5265,deadbeef404,1,0.00037,41117,15.00927,273944
5266,deamme,1,0.00037,41118,15.00964,273944
5267,Dean177,1,0.00037,41119,15.01000,273944
5268,deanban,1,0.00037,41120,15.01037,273944
5269,debajitr,1,0.00037,41121,15.01073,273944
5270,debudda,1,0.00037,41122,15.01110,273944
5271,decentralion,1,0.00037,41123,15.01146,273944
5272,deebloo,1,0.00037,41124,15.01183,273944
5273,deecewan,1,0.00037,41125,15.01219,273944
5274,deed02392,1,0.00037,41126,15.01256,273944
5275,deepakpathania,1,0.00037,41127,15.01292,273944
5276,deepcoldy,1,0.00037,41128,15.01329,273944
5277,deformhead,1,0.00037,41129,15.01365,273944
5278,DemianD,1,0.00037,41130,15.01402,273944
5279,demmz,1,0.00037,41131,15.01438,273944
5280,demoneaux,1,0.00037,41132,15.01475,273944
5281,Demurgos,1,0.00037,41133,15.01511,273944
5282,den314,1,0.00037,41134,15.01548,273944
5283,deniss-muhla,1,0.00037,41135,15.01584,273944
5284,depr,1,0.00037,41136,15.01621,273944
5285,dereckson,1,0.00037,41137,15.01657,273944
5286,Derek-Ashmore,1,0.00037,41138,15.01694,273944
5287,dereksantos,1,0.00037,41139,15.01730,273944
5288,derekstavis,1,0.00037,41140,15.01767,273944
5289,DerFlatulator,1,0.00037,41141,15.01803,273944
5290,derLukers,1,0.00037,41142,15.01840,273944
5291,desheikh,1,0.00037,41143,15.01876,273944
5292,designeng,1,0.00037,41144,15.01913,273944
5293,designfrontier,1,0.00037,41145,15.01949,273944
5294,DesWurstes,1,0.00037,41146,15.01986,273944
5295,devdot,1,0.00037,41147,15.02022,273944
5296,developit,1,0.00037,41148,15.02059,273944
5297,DevInstinct,1,0.00037,41149,15.02095,273944
5298,devonharvey,1,0.00037,41150,15.02132,273944
5299,devtanc,1,0.00037,41151,15.02168,273944
5300,dewaffled,1,0.00037,41152,15.02205,273944
5301,deyboy90,1,0.00037,41153,15.02241,273944
5302,deyhle,1,0.00037,41154,15.02278,273944
5303,df3n5,1,0.00037,41155,15.02314,273944
5304,dferber90,1,0.00037,41156,15.02351,273944
5305,d-fischer,1,0.00037,41157,15.02387,273944
5306,dgofman,1,0.00037,41158,15.02424,273944
5307,dgrcode,1,0.00037,41159,15.02460,273944
5308,dgrove,1,0.00037,41160,15.02497,273944
5309,dguyonvarch,1,0.00037,41161,15.02533,273944
5310,dgwynne,1,0.00037,41162,15.02570,273944
5311,dhcmrlchtdj,1,0.00037,41163,15.02606,273944
5312,DheerajVislavath,1,0.00037,41164,15.02643,273944
5313,dhoepelman,1,0.00037,41165,15.02679,273944
5314,dhritzkiv,1,0.00037,41166,15.02716,273944
5315,dhrubesh,1,0.00037,41167,15.02752,273944
5316,dhruvdutt,1,0.00037,41168,15.02789,273944
5317,diamondo25,1,0.00037,41169,15.02825,273944
5318,dieb,1,0.00037,41170,15.02862,273944
5319,DieBauer,1,0.00037,41171,15.02898,273944
5320,diegolacarta,1,0.00037,41172,15.02935,273944
5321,digitaldavenyc,1,0.00037,41173,15.02971,273944
5322,Dignifiedquire,1,0.00037,41174,15.03008,273944
5323,dilidili,1,0.00037,41175,15.03044,273944
5324,dillonchanis,1,0.00037,41176,15.03081,273944
5325,dinomite,1,0.00037,41177,15.03117,273944
5326,disc99,1,0.00037,41178,15.03154,273944
5327,discosultan,1,0.00037,41179,15.03190,273944
5328,DJCordhose,1,0.00037,41180,15.03227,273944
5329,djds23,1,0.00037,41181,15.03263,273944
5330,djindjic,1,0.00037,41182,15.03300,273944
5331,djkirby,1,0.00037,41183,15.03336,273944
5332,djulien,1,0.00037,41184,15.03373,273944
5333,djy0,1,0.00037,41185,15.03409,273944
5334,dkebler,1,0.00037,41186,15.03446,273944
5335,dlazerka,1,0.00037,41187,15.03482,273944
5336,dlecocq,1,0.00037,41188,15.03519,273944
5337,dlwalsh,1,0.00037,41189,15.03555,273944
5338,dmap,1,0.00037,41190,15.03592,273944
5339,dmarkow,1,0.00037,41191,15.03628,273944
5340,dmin,1,0.00037,41192,15.03665,273944
5341,DmitryGaravsky,1,0.00037,41193,15.03701,273944
5342,DmitryGonchar,1,0.00037,41194,15.03738,273944
5343,dmitrysteblyuk,1,0.00037,41195,15.03774,273944
5344,dmitryvk,1,0.00037,41196,15.03811,273944
5345,dmjones500,1,0.00037,41197,15.03848,273944
5346,dmlukichev,1,0.00037,41198,15.03884,273944
5347,dmurat,1,0.00037,41199,15.03921,273944
5348,dnperfors,1,0.00037,41200,15.03957,273944
5349,dnshi,1,0.00037,41201,15.03994,273944
5350,doctyper,1,0.00037,41202,15.04030,273944
5351,doersino,1,0.00037,41203,15.04067,273944
5352,dogancelik,1,0.00037,41204,15.04103,273944
5353,dogboydog,1,0.00037,41205,15.04140,273944
5354,Dok11,1,0.00037,41206,15.04176,273944
5355,domcc,1,0.00037,41207,15.04213,273944
5356,domenic,1,0.00037,41208,15.04249,273944
5357,dominicbarnes,1,0.00037,41209,15.04286,273944
5358,dominictarr,1,0.00037,41210,15.04322,273944
5359,DominikPieper,1,0.00037,41211,15.04359,273944
5360,donabrams,1,0.00037,41212,15.04395,273944
5361,DonaldHarris,1,0.00037,41213,15.04432,273944
5362,dongyuwei,1,0.00037,41214,15.04468,273944
5363,DonnieWest,1,0.00037,41215,15.04505,273944
5364,dorktobes,1,0.00037,41216,15.04541,273944
5365,dortonway,1,0.00037,41217,15.04578,273944
5366,Dorvaryn,1,0.00037,41218,15.04614,273944
5367,dosentmatter,1,0.00037,41219,15.04651,273944
5368,dotchev,1,0.00037,41220,15.04687,273944
5369,dotproto,1,0.00037,41221,15.04724,273944
5370,doug2k1,1,0.00037,41222,15.04760,273944
5371,doug-a-brunner,1,0.00037,41223,15.04797,273944
5372,Douglas-Cleghorn,1,0.00037,41224,15.04833,273944
5373,dpaoliello,1,0.00037,41225,15.04870,273944
5374,dpellier,1,0.00037,41226,15.04906,273944
5375,dperezde,1,0.00037,41227,15.04943,273944
5376,dprotaso,1,0.00037,41228,15.04979,273944
5377,dracos,1,0.00037,41229,15.05016,273944
5378,dragmove,1,0.00037,41230,15.05052,273944
5379,dragn,1,0.00037,41231,15.05089,273944
5380,drajakumar,1,0.00037,41232,15.05125,273944
5381,drawski,1,0.00037,41233,15.05162,273944
5382,drcapulet,1,0.00037,41234,15.05198,273944
5383,DrDanRyan,1,0.00037,41235,15.05235,273944
5384,drdelambre,1,0.00037,41236,15.05271,273944
5385,dreadwail,1,0.00037,41237,15.05308,273944
5386,drewburlingame,1,0.00037,41238,15.05344,273944
5387,drew-moore,1,0.00037,41239,15.05381,273944
5388,dreyacosta,1,0.00037,41240,15.05417,273944
5389,drichard,1,0.00037,41241,15.05454,273944
5390,drieseng,1,0.00037,41242,15.05490,273944
5391,driverpt,1,0.00037,41243,15.05527,273944
5392,drothmaler,1,0.00037,41244,15.05563,273944
5393,ds300,1,0.00037,41245,15.05600,273944
5394,dschinde,1,0.00037,41246,15.05636,273944
5395,dsherret,1,0.00037,41247,15.05673,273944
5396,dstrohl,1,0.00037,41248,15.05709,273944
5397,dsuket,1,0.00037,41249,15.05746,273944
5398,dsw2127,1,0.00037,41250,15.05782,273944
5399,dtabuenc,1,0.00037,41251,15.05819,273944
5400,dtgoitia,1,0.00037,41252,15.05855,273944
5401,dtothefp,1,0.00037,41253,15.05892,273944
5402,dtslvr,1,0.00037,41254,15.05928,273944
5403,Ducki,1,0.00037,41255,15.05965,273944
5404,DudaKamil,1,0.00037,41256,15.06001,273944
5405,duereg,1,0.00037,41257,15.06038,273944
5406,Duhemm,1,0.00037,41258,15.06074,273944
5407,dukeyin,1,0.00037,41259,15.06111,273944
5408,dungsaga,1,0.00037,41260,15.06147,273944
5409,dunnock,1,0.00037,41261,15.06184,273944
5410,dvandyke,1,0.00037,41262,15.06220,273944
5411,dvishniakov,1,0.00037,41263,15.06257,273944
5412,dwelle,1,0.00037,41264,15.06293,273944
5413,dwhieb,1,0.00037,41265,15.06330,273944
5414,DXFiles,1,0.00037,41266,15.06366,273944
5415,dylang,1,0.00037,41267,15.06403,273944
5416,dzcpy,1,0.00037,41268,15.06439,273944
5417,DzonnyDZ,1,0.00037,41269,15.06476,273944
5418,eabalea,1,0.00037,41270,15.06512,273944
5419,EamonHetherton,1,0.00037,41271,15.06549,273944
5420,ebradyjobory,1,0.00037,41272,15.06585,273944
5421,ecbrodie,1,0.00037,41273,15.06622,273944
5422,eclipsewebmaster,1,0.00037,41274,15.06658,273944
5423,ecmadao,1,0.00037,41275,15.06695,273944
5424,edalquist,1,0.00037,41276,15.06731,273944
5425,eddiejaoude,1,0.00037,41277,15.06768,273944
5426,EddyVerbruggen,1,0.00037,41278,15.06804,273944
5427,edelangh,1,0.00037,41279,15.06841,273944
5428,edeustace,1,0.00037,41280,15.06877,273944
5429,edi9999,1,0.00037,41281,15.06914,273944
5430,edmBernard,1,0.00037,41282,15.06950,273944
5431,edmellum,1,0.00037,41283,15.06987,273944
5432,edofic,1,0.00037,41284,15.07023,273944
5433,edolic,1,0.00037,41285,15.07060,273944
5434,edorivai,1,0.00037,41286,15.07096,273944
5435,eduardbadillo,1,0.00037,41287,15.07133,273944
5436,eduardische,1,0.00037,41288,15.07169,273944
5437,edudojevic,1,0.00037,41289,15.07206,273944
5438,edusperoni,1,0.00037,41290,15.07242,273944
5439,edwinychu,1,0.00037,41291,15.07279,273944
5440,edysegura,1,0.00037,41292,15.07315,273944
5441,ee92,1,0.00037,41293,15.07352,273944
5442,EECOLOR,1,0.00037,41294,15.07388,273944
5443,eek,1,0.00037,41295,15.07425,273944
5444,eelkeblok,1,0.00037,41296,15.07461,273944
5445,eemmosi,1,0.00037,41297,15.07498,273944
5446,eeroan,1,0.00037,41298,15.07534,273944
5447,eforsberg,1,0.00037,41299,15.07571,273944
5448,egflores,1,0.00037,41300,15.07607,273944
5449,EgidioCaprino,1,0.00037,41301,15.07644,273944
5450,ehtb,1,0.00037,41302,15.07680,273944
5451,eigan,1,0.00037,41303,15.07717,273944
5452,einarq,1,0.00037,41304,15.07753,273944
5453,eisber,1,0.00037,41305,15.07790,273944
5454,ekevoo,1,0.00037,41306,15.07826,273944
5455,ekmartin,1,0.00037,41307,15.07863,273944
5456,elAndyG,1,0.00037,41308,15.07899,273944
5457,elboman,1,0.00037,41309,15.07936,273944
5458,elderbas,1,0.00037,41310,15.07972,273944
5459,elemount,1,0.00037,41311,15.08009,273944
5460,eleumik,1,0.00037,41312,15.08045,273944
5461,elimach,1,0.00037,41313,15.08082,273944
5462,elinor-fung,1,0.00037,41314,15.08118,273944
5463,eljobe,1,0.00037,41315,15.08155,273944
5464,elliottsj,1,0.00037,41316,15.08191,273944
5465,elongl,1,0.00037,41317,15.08228,273944
5466,elquatro,1,0.00037,41318,15.08264,273944
5467,elsbree,1,0.00037,41319,15.08301,273944
5468,eltonmesquita,1,0.00037,41320,15.08337,273944
5469,elv1s42,1,0.00037,41321,15.08374,273944
5470,elyobo,1,0.00037,41322,15.08410,273944
5471,elzapp,1,0.00037,41323,15.08447,273944
5472,emibloque,1,0.00037,41324,15.08483,273944
5473,emmanuelgautier,1,0.00037,41325,15.08520,273944
5474,emopers,1,0.00037,41326,15.08556,273944
5475,EmpeRoar,1,0.00037,41327,15.08593,273944
5476,enapupe,1,0.00037,41328,15.08630,273944
5477,enbo,1,0.00037,41329,15.08666,273944
5478,EndangeredMassa,1,0.00037,41330,15.08703,273944
5479,Ende93,1,0.00037,41331,15.08739,273944
5480,Enet4,1,0.00037,41332,15.08776,273944
5481,Enigo,1,0.00037,41333,15.08812,273944
5482,entozoon,1,0.00037,41334,15.08849,273944
5483,entronad,1,0.00037,41335,15.08885,273944
5484,Enuvid,1,0.00037,41336,15.08922,273944
5485,envolute,1,0.00037,41337,15.08958,273944
5486,enzanki-ars,1,0.00037,41338,15.08995,273944
5487,eoL95,1,0.00037,41339,15.09031,273944
5488,Eomm,1,0.00037,41340,15.09068,273944
5489,eosimosu,1,0.00037,41341,15.09104,273944
5490,epelc,1,0.00037,41342,15.09141,273944
5491,epicfaace,1,0.00037,41343,15.09177,273944
5492,EQuimper,1,0.00037,41344,15.09214,273944
5493,er1c,1,0.00037,41345,15.09250,273944
5494,eran-nussbaum,1,0.00037,41346,15.09287,273944
5495,eranshmil,1,0.00037,41347,15.09323,273944
5496,erf,1,0.00037,41348,15.09360,273944
5497,erhangundogan,1,0.00037,41349,15.09396,273944
5498,erhise,1,0.00037,41350,15.09433,273944
5499,ericanderson,1,0.00037,41351,15.09469,273944
5500,EricByers,1,0.00037,41352,15.09506,273944
5501,ericchernuka,1,0.00037,41353,15.09542,273944
5502,ericdahl,1,0.00037,41354,15.09579,273944
5503,ericjim,1,0.00037,41355,15.09615,273944
5504,ErickSanVal,1,0.00037,41356,15.09652,273944
5505,ericmartel,1,0.00037,41357,15.09688,273944
5506,ericmatthys,1,0.00037,41358,15.09725,273944
5507,ericprud,1,0.00037,41359,15.09761,273944
5508,ericyang89,1,0.00037,41360,15.09798,273944
5509,ericz,1,0.00037,41361,15.09834,273944
5510,erikbern,1,0.00037,41362,15.09871,273944
5511,erikdonohoo,1,0.00037,41363,15.09907,273944
5512,eriklax,1,0.00037,41364,15.09944,273944
5513,erinspice,1,0.00037,41365,15.09980,273944
5514,ErisDS,1,0.00037,41366,15.10017,273944
5515,ernbrn,1,0.00037,41367,15.10053,273944
5516,ErwinJanssen,1,0.00037,41368,15.10090,273944
5517,esarbe,1,0.00037,41369,15.10126,273944
5518,esbena,1,0.00037,41370,15.10163,273944
5519,esfand-r,1,0.00037,41371,15.10199,273944
5520,esiegel,1,0.00037,41372,15.10236,273944
5521,EspadaV8,1,0.00037,41373,15.10272,273944
5522,estaub,1,0.00037,41374,15.10309,273944
5523,estellecomment,1,0.00037,41375,15.10345,273944
5524,estrada9166,1,0.00037,41376,15.10382,273944
5525,etaty,1,0.00037,41377,15.10418,273944
5526,eteeselink,1,0.00037,41378,15.10455,273944
5527,etler,1,0.00037,41379,15.10491,273944
5528,eugeneotto,1,0.00037,41380,15.10528,273944
5529,eugenesmlv,1,0.00037,41381,15.10564,273944
5530,eungjun-yi,1,0.00037,41382,15.10601,273944
5531,evanbattaglia,1,0.00037,41383,15.10637,273944
5532,evanfuture,1,0.00037,41384,15.10674,273944
5533,evan-scott-zocdoc,1,0.00037,41385,15.10710,273944
5534,evanshortiss,1,0.00037,41386,15.10747,273944
5535,eventualbuddha,1,0.00037,41387,15.10783,273944
5536,everdimension,1,0.00037,41388,15.10820,273944
5537,ExalDraen,1,0.00037,41389,15.10856,273944
5538,exalted,1,0.00037,41390,15.10893,273944
5539,eximius313,1,0.00037,41391,15.10929,273944
5540,ezhlobo,1,0.00037,41392,15.10966,273944
5541,ezsilmar,1,0.00037,41393,15.11002,273944
5542,ezze,1,0.00037,41394,15.11039,273944
5543,faazshift,1,0.00037,41395,15.11075,273944
5544,fabienrenaud,1,0.00037,41396,15.11112,273944
5545,fabioloreggian,1,0.00037,41397,15.11148,273944
5546,fadamsen,1,0.00037,41398,15.11185,273944
5547,fanofxiaofeng,1,0.00037,41399,15.11221,273944
5548,faressoft,1,0.00037,41400,15.11258,273944
5549,faridfor,1,0.00037,41401,15.11294,273944
5550,farnabaz,1,0.00037,41402,15.11331,273944
5551,farrago,1,0.00037,41403,15.11367,273944
5552,FarSeeing,1,0.00037,41404,15.11404,273944
5553,fatfisz,1,0.00037,41405,15.11440,273944
5554,fatosmorina,1,0.00037,41406,15.11477,273944
5555,fazlerocks,1,0.00037,41407,15.11513,273944
5556,fb55,1,0.00037,41408,15.11550,273944
5557,fbaeta,1,0.00037,41409,15.11586,273944
5558,fbroda,1,0.00037,41410,15.11623,273944
5559,fckt,1,0.00037,41411,15.11659,273944
5560,fcostarodrigo,1,0.00037,41412,15.11696,273944
5561,fdaciuk,1,0.00037,41413,15.11732,273944
5562,fdesu,1,0.00037,41414,15.11769,273944
5563,fearphage,1,0.00037,41415,15.11805,273944
5564,federicojasson,1,0.00037,41416,15.11842,273944
5565,fedochet,1,0.00037,41417,15.11878,273944
5566,fedyk,1,0.00037,41418,15.11915,273944
5567,FelipeAdorno,1,0.00037,41419,15.11951,273944
5568,felipefcm,1,0.00037,41420,15.11988,273944
5569,feministy,1,0.00037,41421,15.12024,273944
5570,FermiDirak,1,0.00037,41422,15.12061,273944
5571,ferstl,1,0.00037,41423,15.12097,273944
5572,fetis,1,0.00037,41424,15.12134,273944
5573,ffoodd,1,0.00037,41425,15.12170,273944
5574,fgnass,1,0.00037,41426,15.12207,273944
5575,fhalde,1,0.00037,41427,15.12243,273944
5576,fhellwig,1,0.00037,41428,15.12280,273944
5577,fhinkel,1,0.00037,41429,15.12316,273944
5578,fhnaseer,1,0.00037,41430,15.12353,273944
5579,fictitious,1,0.00037,41431,15.12389,273944
5580,findepi,1,0.00037,41432,15.12426,273944
5581,fisherspy,1,0.00037,41433,15.12462,273944
5582,fisherwebdev,1,0.00037,41434,15.12499,273944
5583,fitiskin,1,0.00037,41435,15.12535,273944
5584,fiznool,1,0.00037,41436,15.12572,273944
5585,fk,1,0.00037,41437,15.12608,273944
5586,FlamesoFF,1,0.00037,41438,15.12645,273944
5587,FlatEarthTruth,1,0.00037,41439,15.12681,273944
5588,flaviommedeiros,1,0.00037,41440,15.12718,273944
5589,flcdrg,1,0.00037,41441,15.12754,273944
5590,FLGMwt,1,0.00037,41442,15.12791,273944
5591,floppym,1,0.00037,41443,15.12827,273944
5592,Floriferous,1,0.00037,41444,15.12864,273944
5593,FlorisXll,1,0.00037,41445,15.12900,273944
5594,flotwig,1,0.00037,41446,15.12937,273944
5595,flozz,1,0.00037,41447,15.12973,273944
5596,flugger,1,0.00037,41448,15.13010,273944
5597,flut1,1,0.00037,41449,15.13046,273944
5598,flx-dev,1,0.00037,41450,15.13083,273944
5599,flx-l,1,0.00037,41451,15.13119,273944
5600,flyingsouthwind,1,0.00037,41452,15.13156,273944
5601,fmoo,1,0.00037,41453,15.13192,273944
5602,fnll,1,0.00037,41454,15.13229,273944
5603,foladipo,1,0.00037,41455,15.13265,273944
5604,forforeach,1,0.00037,41456,15.13302,273944
5605,formido,1,0.00037,41457,15.13338,273944
5606,fouadnashat,1,0.00037,41458,15.13375,273944
5607,fourcolors,1,0.00037,41459,15.13412,273944
5608,FourwingsY,1,0.00037,41460,15.13448,273944
5609,fracmak,1,0.00037,41461,15.13485,273944
5610,framp,1,0.00037,41462,15.13521,273944
5611,franciscovelez,1,0.00037,41463,15.13558,273944
5612,francoiscote,1,0.00037,41464,15.13594,273944
5613,frangio,1,0.00037,41465,15.13631,273944
5614,frankadrian,1,0.00037,41466,15.13667,273944
5615,frankbuckley,1,0.00037,41467,15.13704,273944
5616,frankie567,1,0.00037,41468,15.13740,273944
5617,frankier,1,0.00037,41469,15.13777,273944
5618,FrankPeschel-Gallee,1,0.00037,41470,15.13813,273944
5619,frankwallis,1,0.00037,41471,15.13850,273944
5620,frbncis,1,0.00037,41472,15.13886,273944
5621,FreddieRidell,1,0.00037,41473,15.13923,273944
5622,freddyrangel,1,0.00037,41474,15.13959,273944
5623,fredeil,1,0.00037,41475,15.13996,273944
5624,FRedEnergy,1,0.00037,41476,15.14032,273944
5625,frederfred,1,0.00037,41477,15.14069,273944
5626,frederickfogerty,1,0.00037,41478,15.14105,273944
5627,frederikbosch,1,0.00037,41479,15.14142,273944
5628,frederikwh,1,0.00037,41480,15.14178,273944
5629,FreeleX,1,0.00037,41481,15.14215,273944
5630,FreezyLemon,1,0.00037,41482,15.14251,273944
5631,fregante,1,0.00037,41483,15.14288,273944
5632,FrenchHipster,1,0.00037,41484,15.14324,273944
5633,fricci,1,0.00037,41485,15.14361,273944
5634,frob,1,0.00037,41486,15.14397,273944
5635,fromheten,1,0.00037,41487,15.14434,273944
5636,frontsideair,1,0.00037,41488,15.14470,273944
5637,frux,1,0.00037,41489,15.14507,273944
5638,frxnz,1,0.00037,41490,15.14543,273944
5639,fryn,1,0.00037,41491,15.14580,273944
5640,frystpingvin,1,0.00037,41492,15.14616,273944
5641,fsateler,1,0.00037,41493,15.14653,273944
5642,fsbatista,1,0.00037,41494,15.14689,273944
5643,fschueller-ifd,1,0.00037,41495,15.14726,273944
5644,FSou1,1,0.00037,41496,15.14762,273944
5645,fubar-coder,1,0.00037,41497,15.14799,273944
5646,fullheightcoding,1,0.00037,41498,15.14835,273944
5647,fultonm,1,0.00037,41499,15.14872,273944
5648,FumiyaShibusawa,1,0.00037,41500,15.14908,273944
5649,funklos,1,0.00037,41501,15.14945,273944
5650,fureweb-com,1,0.00037,41502,15.14981,273944
5651,futurist,1,0.00037,41503,15.15018,273944
5652,fvictorio,1,0.00037,41504,15.15054,273944
5653,fxck,1,0.00037,41505,15.15091,273944
5654,fxfactorial,1,0.00037,41506,15.15127,273944
5655,fxleyu,1,0.00037,41507,15.15164,273944
5656,Fyers,1,0.00037,41508,15.15200,273944
5657,fz568573448,1,0.00037,41509,15.15237,273944
5658,fzxt,1,0.00037,41510,15.15273,273944
5659,G100g,1,0.00037,41511,15.15310,273944
5660,G1NA,1,0.00037,41512,15.15346,273944
5661,Gaafar,1,0.00037,41513,15.15383,273944
5662,Gabb1995,1,0.00037,41514,15.15419,273944
5663,gabegorelick,1,0.00037,41515,15.15456,273944
5664,gabrielmcoelho,1,0.00037,41516,15.15492,273944
5665,gabsferreira,1,0.00037,41517,15.15529,273944
5666,gabskoro,1,0.00037,41518,15.15565,273944
5667,gadtfly,1,0.00037,41519,15.15602,273944
5668,gaganis,1,0.00037,41520,15.15638,273944
5669,galadriel2143,1,0.00037,41521,15.15675,273944
5670,gallatin,1,0.00037,41522,15.15711,273944
5671,gamtiq,1,0.00037,41523,15.15748,273944
5672,gaohailang,1,0.00037,41524,15.15784,273944
5673,garbles,1,0.00037,41525,15.15821,273944
5674,gardiac2002,1,0.00037,41526,15.15857,273944
5675,GarethSmall,1,0.00037,41527,15.15894,273944
5676,garrypolley,1,0.00037,41528,15.15930,273944
5677,garthk,1,0.00037,41529,15.15967,273944
5678,garymathews,1,0.00037,41530,15.16003,273944
5679,Gary-Zh,1,0.00037,41531,15.16040,273944
5680,gaspard,1,0.00037,41532,15.16076,273944
5681,gaurav,1,0.00037,41533,15.16113,273944
5682,gavacho,1,0.00037,41534,15.16149,273944
5683,gbataille,1,0.00037,41535,15.16186,273944
5684,gcangussu,1,0.00037,41536,15.16222,273944
5685,GCHQDeveloper500,1,0.00037,41537,15.16259,273944
5686,gclaramunt,1,0.00037,41538,15.16295,273944
5687,gctmt,1,0.00037,41539,15.16332,273944
5688,gcxRun,1,0.00037,41540,15.16368,273944
5689,gdh1995,1,0.00037,41541,15.16405,273944
5690,geckon,1,0.00037,41542,15.16441,273944
5691,geek,1,0.00037,41543,15.16478,273944
5692,geekjob-ru,1,0.00037,41544,15.16514,273944
5693,gef756,1,0.00037,41545,15.16551,273944
5694,genepaul,1,0.00037,41546,15.16587,273944
5695,generalov,1,0.00037,41547,15.16624,273944
5696,gentoo90,1,0.00037,41548,15.16660,273944
5697,geobde,1,0.00037,41549,15.16697,273944
5698,geoffrey,1,0.00037,41550,15.16733,273944
5699,geoffreybauduin,1,0.00037,41551,15.16770,273944
5700,GeorgeGkas,1,0.00037,41552,15.16806,273944
5701,george-ranjan,1,0.00037,41553,15.16843,273944
5702,geraldolsribeiro,1,0.00037,41554,15.16879,273944
5703,geratorres,1,0.00037,41555,15.16916,273944
5704,GerjanOnline,1,0.00037,41556,15.16952,273944
5705,germ13,1,0.00037,41557,15.16989,273944
5706,getaaron,1,0.00037,41558,15.17025,273944
5707,getkey,1,0.00037,41559,15.17062,273944
5708,getsetbro,1,0.00037,41560,15.17098,273944
5709,gettinToasty,1,0.00037,41561,15.17135,273944
5710,gfx,1,0.00037,41562,15.17171,273944
5711,ghandhikus,1,0.00037,41563,15.17208,273944
5712,ghik,1,0.00037,41564,15.17244,273944
5713,ght,1,0.00037,41565,15.17281,273944
5714,Gi11i4m,1,0.00037,41566,15.17317,273944
5715,giacomocerquone,1,0.00037,41567,15.17354,273944
5716,GianlucaGuarini,1,0.00037,41568,15.17390,273944
5717,gibfahn,1,0.00037,41569,15.17427,273944
5718,gilad61,1,0.00037,41570,15.17463,273944
5719,gilbarbara,1,0.00037,41571,15.17500,273944
5720,gilbox,1,0.00037,41572,15.17536,273944
5721,gildean,1,0.00037,41573,15.17573,273944
5722,Ginden,1,0.00037,41574,15.17609,273944
5723,gingur,1,0.00037,41575,15.17646,273944
5724,Ginkooo,1,0.00037,41576,15.17682,273944
5725,Giorgi,1,0.00037,41577,15.17719,273944
5726,girtsernstsons,1,0.00037,41578,15.17755,273944
5727,gitgrimbo,1,0.00037,41579,15.17792,273944
5728,giuseppeg,1,0.00037,41580,15.17828,273944
5729,GiuseppePiscopo,1,0.00037,41581,15.17865,273944
5730,gj,1,0.00037,41582,15.17901,273944
5731,gka,1,0.00037,41583,15.17938,273944
5732,gkal19,1,0.00037,41584,15.17974,273944
5733,gkatsev,1,0.00037,41585,15.18011,273944
5734,gknauth,1,0.00037,41586,15.18047,273944
5735,glasperfan,1,0.00037,41587,15.18084,273944
5736,Glavin001,1,0.00037,41588,15.18120,273944
5737,Glease,1,0.00037,41589,15.18157,273944
5738,glena,1,0.00037,41590,15.18193,273944
5739,glennawatson,1,0.00037,41591,15.18230,273944
5740,glensc,1,0.00037,41592,15.18267,273944
5741,glorieux-f,1,0.00037,41593,15.18303,273944
5742,GlulkAlex,1,0.00037,41594,15.18340,273944
5743,gm758,1,0.00037,41595,15.18376,273944
5744,gmaclennan,1,0.00037,41596,15.18413,273944
5745,gmcquistin,1,0.00037,41597,15.18449,273944
5746,gnowland,1,0.00037,41598,15.18486,273944
5747,GochoMugo,1,0.00037,41599,15.18522,273944
5748,godban,1,0.00037,41600,15.18559,273944
5749,gokaco,1,0.00037,41601,15.18595,273944
5750,gokaygurcan,1,0.00037,41602,15.18632,273944
5751,golear91,1,0.00037,41603,15.18668,273944
5752,goleary,1,0.00037,41604,15.18705,273944
5753,Gommorach,1,0.00037,41605,15.18741,273944
5754,googya,1,0.00037,41606,15.18778,273944
5755,gortok,1,0.00037,41607,15.18814,273944
5756,gouch,1,0.00037,41608,15.18851,273944
5757,govert,1,0.00037,41609,15.18887,273944
5758,goyney,1,0.00037,41610,15.18924,273944
5759,gpapin,1,0.00037,41611,15.18960,273944
5760,grahamedgecombe,1,0.00037,41612,15.18997,273944
5761,GrahamWalters,1,0.00037,41613,15.19033,273944
5762,Granjow,1,0.00037,41614,15.19070,273944
5763,grantcarthew,1,0.00037,41615,15.19106,273944
5764,grassator,1,0.00037,41616,15.19143,273944
5765,greatjack1,1,0.00037,41617,15.19179,273944
5766,greenberga,1,0.00037,41618,15.19216,273944
5767,gregestren,1,0.00037,41619,15.19252,273944
5768,greggman,1,0.00037,41620,15.19289,273944
5769,Gregory-Bell,1,0.00037,41621,15.19325,273944
5770,gregorym,1,0.00037,41622,15.19362,273944
5771,gregrperkins,1,0.00037,41623,15.19398,273944
5772,gregsheremeta,1,0.00037,41624,15.19435,273944
5773,gregtyler,1,0.00037,41625,15.19471,273944
5774,gretzky,1,0.00037,41626,15.19508,273944
5775,grgur,1,0.00037,41627,15.19544,273944
5776,griffinmichl,1,0.00037,41628,15.19581,273944
5777,GrigoriyZander,1,0.00037,41629,15.19617,273944
5778,grubersjoe,1,0.00037,41630,15.19654,273944
5779,grushetsky,1,0.00037,41631,15.19690,273944
5780,gsfreema,1,0.00037,41632,15.19727,273944
5781,gtanner,1,0.00037,41633,15.19763,273944
5782,gugu,1,0.00037,41634,15.19800,273944
5783,guicar,1,0.00037,41635,15.19836,273944
5784,guiled,1,0.00037,41636,15.19873,273944
5785,guillaumebarranco,1,0.00037,41637,15.19909,273944
5786,guillaumebriday,1,0.00037,41638,15.19946,273944
5787,guptasourabh,1,0.00037,41639,15.19982,273944
5788,gurisko,1,0.00037,41640,15.20019,273944
5789,GurliGebis,1,0.00037,41641,15.20055,273944
5790,gusgard,1,0.00037,41642,15.20092,273944
5791,gustavnikolaj,1,0.00037,41643,15.20128,273944
5792,gustavomazzoni,1,0.00037,41644,15.20165,273944
5793,guyellis,1,0.00037,41645,15.20201,273944
5794,gvangool,1,0.00037,41646,15.20238,273944
5795,gwelr,1,0.00037,41647,15.20274,273944
5796,Gwerlas,1,0.00037,41648,15.20311,273944
5797,gwhenne,1,0.00037,41649,15.20347,273944
5798,gwmccull,1,0.00037,41650,15.20384,273944
5799,gxela,1,0.00037,41651,15.20420,273944
5800,Gxh-beGreat,1,0.00037,41652,15.20457,273944
5801,gyandeeps,1,0.00037,41653,15.20493,273944
5802,gyeates,1,0.00037,41654,15.20530,273944
5803,gypsydave5,1,0.00037,41655,15.20566,273944
5804,GyrosGeier,1,0.00037,41656,15.20603,273944
5805,ha404,1,0.00037,41657,15.20639,273944
5806,hacke2,1,0.00037,41658,15.20676,273944
5807,hakanostrom,1,0.00037,41659,15.20712,273944
5808,HakurouKen,1,0.00037,41660,15.20749,273944
5809,halex2005,1,0.00037,41661,15.20785,273944
5810,halvves,1,0.00037,41662,15.20822,273944
5811,hamlim,1,0.00037,41663,15.20858,273944
5812,hammy2899,1,0.00037,41664,15.20895,273944
5813,hand515,1,0.00037,41665,15.20931,273944
5814,handrews,1,0.00037,41666,15.20968,273944
5815,hanzichi,1,0.00037,41667,15.21004,273944
5816,happylolonly,1,0.00037,41668,15.21041,273944
5817,hareshambaliya,1,0.00037,41669,15.21077,273944
5818,harningt,1,0.00037,41670,15.21114,273944
5819,harpreetkhalsagtbit,1,0.00037,41671,15.21150,273944
5820,HarrisonJackson,1,0.00037,41672,15.21187,273944
5821,Harvinator,1,0.00037,41673,15.21223,273944
5822,hasegao,1,0.00037,41674,15.21260,273944
5823,hashplus,1,0.00037,41675,15.21296,273944
5824,haskellcamargo,1,0.00037,41676,15.21333,273944
5825,Hatlen,1,0.00037,41677,15.21369,273944
5826,havenchyk,1,0.00037,41678,15.21406,273944
5827,Hawkeye1909,1,0.00037,41679,15.21442,273944
5828,hawkins,1,0.00037,41680,15.21479,273944
5829,hayawata3626,1,0.00037,41681,15.21515,273944
5830,haydnhkim,1,0.00037,41682,15.21552,273944
5831,hazzik,1,0.00037,41683,15.21588,273944
5832,h-des,1,0.00037,41684,15.21625,273944
5833,hdeshev,1,0.00037,41685,15.21661,273944
5834,heath3,1,0.00037,41686,15.21698,273944
5835,hedgepigdaniel,1,0.00037,41687,15.21734,273944
5836,hedgerh,1,0.00037,41688,15.21771,273944
5837,heidid,1,0.00037,41689,15.21807,273944
5838,heikkilamarko,1,0.00037,41690,15.21844,273944
5839,hekar,1,0.00037,41691,15.21880,273944
5840,hekike,1,0.00037,41692,15.21917,273944
5841,helios1101,1,0.00037,41693,15.21953,273944
5842,hellectronic,1,0.00037,41694,15.21990,273944
5843,heloflier,1,0.00037,41695,15.22026,273944
5844,Hendeca,1,0.00037,41696,15.22063,273944
5845,hendrikebbers,1,0.00037,41697,15.22099,273944
5846,hendrysadrak,1,0.00037,41698,15.22136,273944
5847,henkmollema,1,0.00037,41699,15.22172,273944
5848,henrik,1,0.00037,41700,15.22209,273944
5849,HermanEldering,1,0.00037,41701,15.22245,273944
5850,herrkris,1,0.00037,41702,15.22282,273944
5851,HershVar,1,0.00037,41703,15.22318,273944
5852,heshamamin,1,0.00037,41704,15.22355,273944
5853,hesiod,1,0.00037,41705,15.22391,273944
5854,hessmjr,1,0.00037,41706,15.22428,273944
5855,heyamykate,1,0.00037,41707,15.22464,273944
5856,heygrady,1,0.00037,41708,15.22501,273944
5857,heyMP,1,0.00037,41709,15.22537,273944
5858,hile,1,0.00037,41710,15.22574,273944
5859,hillelcoren,1,0.00037,41711,15.22610,273944
5860,himkt,1,0.00037,41712,15.22647,273944
5861,hiroppy,1,0.00037,41713,15.22683,273944
5862,Hirse,1,0.00037,41714,15.22720,273944
5863,hitstergtd,1,0.00037,41715,15.22756,273944
5864,hmarr,1,0.00037,41716,15.22793,273944
5865,hmble,1,0.00037,41717,15.22829,273944
5866,hobbysoldat,1,0.00037,41718,15.22866,273944
5867,hogart,1,0.00037,41719,15.22902,273944
5868,HoldYourWaffle,1,0.00037,41720,15.22939,273944
5869,holm,1,0.00037,41721,15.22975,273944
5870,hom-bahrani,1,0.00037,41722,15.23012,273944
5871,homeworkprod,1,0.00037,41723,15.23049,273944
5872,Hongarc,1,0.00037,41724,15.23085,273944
5873,hongliang5316,1,0.00037,41725,15.23122,273944
5874,honzi,1,0.00037,41726,15.23158,273944
5875,hoobdeebla,1,0.00037,41727,15.23195,273944
5876,Hookyns,1,0.00037,41728,15.23231,273944
5877,horx,1,0.00037,41729,15.23268,273944
5878,hosamaly,1,0.00037,41730,15.23304,273944
5879,hosembafer,1,0.00037,41731,15.23341,273944
5880,hotaru355,1,0.00037,41732,15.23377,273944
5881,Hotell,1,0.00037,41733,15.23414,273944
5882,howlowck,1,0.00037,41734,15.23450,273944
5883,hozefaj,1,0.00037,41735,15.23487,273944
5884,hquan,1,0.00037,41736,15.23523,273944
5885,hqzxzwb,1,0.00037,41737,15.23560,273944
5886,hrldcpr,1,0.00037,41738,15.23596,273944
5887,hshankar,1,0.00037,41739,15.23633,273944
5888,huggaf,1,0.00037,41740,15.23669,273944
5889,HumanEquivalentUnit,1,0.00037,41741,15.23706,273944
5890,Hunrik,1,0.00037,41742,15.23742,273944
5891,hupfis,1,0.00037,41743,15.23779,273944
5892,HurricaneJames,1,0.00037,41744,15.23815,273944
5893,huseyinbabal,1,0.00037,41745,15.23852,273944
5894,huww98,1,0.00037,41746,15.23888,273944
5895,huxi,1,0.00037,41747,15.23925,273944
5896,hver,1,0.00037,41748,15.23961,273944
5897,hvrauhal,1,0.00037,41749,15.23998,273944
5898,hweeks,1,0.00037,41750,15.24034,273944
5899,hwesol13,1,0.00037,41751,15.24071,273944
5900,hxw,1,0.00037,41752,15.24107,273944
5901,Hypercubed,1,0.00037,41753,15.24144,273944
5902,iamakulov,1,0.00037,41754,15.24180,273944
5903,iamatinkerer,1,0.00037,41755,15.24217,273944
5904,iamdanfox,1,0.00037,41756,15.24253,273944
5905,iam-merlin,1,0.00037,41757,15.24290,273944
5906,iammerrick,1,0.00037,41758,15.24326,273944
5907,iamplugged,1,0.00037,41759,15.24363,273944
5908,iamravenous,1,0.00037,41760,15.24399,273944
5909,iamstiil,1,0.00037,41761,15.24436,273944
5910,iamtommcc,1,0.00037,41762,15.24472,273944
5911,iancmyers,1,0.00037,41763,15.24509,273944
5912,ianlyons,1,0.00037,41764,15.24545,273944
5913,ianstormtaylor,1,0.00037,41765,15.24582,273944
5914,ibnesayeed,1,0.00037,41766,15.24618,273944
5915,ibnIrshad,1,0.00037,41767,15.24655,273944
5916,ibrahimpg,1,0.00037,41768,15.24691,273944
5917,ibriq,1,0.00037,41769,15.24728,273944
5918,ichaki5748,1,0.00037,41770,15.24764,273944
5919,idangozlan,1,0.00037,41771,15.24801,273944
5920,id-ilych,1,0.00037,41772,15.24837,273944
5921,idirouhab,1,0.00037,41773,15.24874,273944
5922,idler8,1,0.00037,41774,15.24910,273944
5923,idlewinn,1,0.00037,41775,15.24947,273944
5924,idmontie,1,0.00037,41776,15.24983,273944
5925,ienzam,1,0.00037,41777,15.25020,273944
5926,ifyoumakeit,1,0.00037,41778,15.25056,273944
5927,ignacioiglesias,1,0.00037,41779,15.25093,273944
5928,ignasne,1,0.00037,41780,15.25129,273944
5929,igncp,1,0.00037,41781,15.25166,273944
5930,ignu,1,0.00037,41782,15.25202,273944
5931,igorgolovanov,1,0.00037,41783,15.25239,273944
5932,igorKryvenko,1,0.00037,41784,15.25275,273944
5933,IgorMiller,1,0.00037,41785,15.25312,273944
5934,igor-savin-ht,1,0.00037,41786,15.25348,273944
5935,igorskuhar,1,0.00037,41787,15.25385,273944
5936,igor-susic,1,0.00037,41788,15.25421,273944
5937,ijuma,1,0.00037,41789,15.25458,273944
5938,ikasumiwt,1,0.00037,41790,15.25494,273944
5939,ikea-dless,1,0.00037,41791,15.25531,273944
5940,iKevinY,1,0.00037,41792,15.25567,273944
5941,ikilled,1,0.00037,41793,15.25604,273944
5942,ikourfaln,1,0.00037,41794,15.25640,273944
5943,ileontiuc,1,0.00037,41795,15.25677,273944
5944,ilmarmors,1,0.00037,41796,15.25713,273944
5945,iluxonchik,1,0.00037,41797,15.25750,273944
5946,ilya-bin,1,0.00037,41798,15.25786,273944
5947,IlyaGrebnov,1,0.00037,41799,15.25823,273944
5948,ilyapx,1,0.00037,41800,15.25859,273944
5949,imakowski,1,0.00037,41801,15.25896,273944
5950,imbolo,1,0.00037,41802,15.25932,273944
5951,imbstack,1,0.00037,41803,15.25969,273944
5952,imdevin567,1,0.00037,41804,15.26005,273944
5953,ImmortalJINX,1,0.00037,41805,15.26042,273944
5954,imysak,1,0.00037,41806,15.26078,273944
5955,inabajunmr,1,0.00037,41807,15.26115,273944
5956,incompl,1,0.00037,41808,15.26151,273944
5957,indy-singh,1,0.00037,41809,15.26188,273944
5958,InfinityOne,1,0.00037,41810,15.26224,273944
5959,infused,1,0.00037,41811,15.26261,273944
5960,inglesp,1,0.00037,41812,15.26297,273944
5961,ingvarc,1,0.00037,41813,15.26334,273944
5962,Iniesta8,1,0.00037,41814,15.26370,273944
5963,inikulin,1,0.00037,41815,15.26407,273944
5964,insanity54,1,0.00037,41816,15.26443,273944
5965,insfrag,1,0.00037,41817,15.26480,273944
5966,Interfere,1,0.00037,41818,15.26516,273944
5967,intronic,1,0.00037,41819,15.26553,273944
5968,inversion,1,0.00037,41820,15.26589,273944
5969,InvertedAcceleration,1,0.00037,41821,15.26626,273944
5970,invictusmaneo,1,0.00037,41822,15.26662,273944
5971,io7m,1,0.00037,41823,15.26699,273944
5972,IOAyman,1,0.00037,41824,15.26735,273944
5973,IonicaBizau,1,0.00037,41825,15.26772,273944
5974,ioss,1,0.00037,41826,15.26808,273944
5975,ipetez,1,0.00037,41827,15.26845,273944
5976,ipolevoy,1,0.00037,41828,15.26881,273944
5977,irustm,1,0.00037,41829,15.26918,273944
5978,isaaclyman,1,0.00037,41830,15.26954,273944
5979,isabellatea,1,0.00037,41831,15.26991,273944
5980,isaiahnields,1,0.00037,41832,15.27027,273944
5981,isayme,1,0.00037,41833,15.27064,273944
5982,iskilled,1,0.00037,41834,15.27100,273944
5983,ismailarilik,1,0.00037,41835,15.27137,273944
5984,ismamz,1,0.00037,41836,15.27173,273944
5985,isTravis,1,0.00037,41837,15.27210,273944
5986,italopessoa,1,0.00037,41838,15.27246,273944
5987,ITonyLi,1,0.00037,41839,15.27283,273944
5988,itrofimow,1,0.00037,41840,15.27319,273944
5989,itslenny,1,0.00037,41841,15.27356,273944
5990,ivangabriele,1,0.00037,41842,15.27392,273944
5991,Ivan-Kalatchev,1,0.00037,41843,15.27429,273944
5992,IvanKishchenko,1,0.00037,41844,15.27465,273944
5993,IVLIU,1,0.00037,41845,15.27502,273944
5994,ivogabe,1,0.00037,41846,15.27538,273944
5995,ixalon,1,0.00037,41847,15.27575,273944
5996,izebit,1,0.00037,41848,15.27611,273944
5997,izeigerman,1,0.00037,41849,15.27648,273944
5998,J2TeaM,1,0.00037,41850,15.27684,273944
5999,jacamera,1,0.00037,41851,15.27721,273944
6000,jacenko,1,0.00037,41852,15.27757,273944
6001,jack4it,1,0.00037,41853,15.27794,273944
6002,jackiewung,1,0.00037,41854,15.27831,273944
6003,jackkoenig,1,0.00037,41855,15.27867,273944
6004,jackmarchant,1,0.00037,41856,15.27904,273944
6005,jacksdrobinson,1,0.00037,41857,15.27940,273944
6006,Jacksunwei,1,0.00037,41858,15.27977,273944
6007,JackuB,1,0.00037,41859,15.28013,273944
6008,jackwanders,1,0.00037,41860,15.28050,273944
6009,Jack-Works,1,0.00037,41861,15.28086,273944
6010,jacob87o2,1,0.00037,41862,15.28123,273944
6011,jacobangel,1,0.00037,41863,15.28159,273944
6012,jacobcarpenter,1,0.00037,41864,15.28196,273944
6013,jacobrossi,1,0.00037,41865,15.28232,273944
6014,jacobwindsor,1,0.00037,41866,15.28269,273944
6015,jacopofar,1,0.00037,41867,15.28305,273944
6016,JaeHunRo,1,0.00037,41868,15.28342,273944
6017,jaens,1,0.00037,41869,15.28378,273944
6018,JAFong,1,0.00037,41870,15.28415,273944
6019,jaimeagudo,1,0.00037,41871,15.28451,273944
6020,jakemingolla,1,0.00037,41872,15.28488,273944
6021,jakepetroules,1,0.00037,41873,15.28524,273944
6022,jalexanderfox,1,0.00037,41874,15.28561,273944
6023,jaller94,1,0.00037,41875,15.28597,273944
6024,jamesarosen,1,0.00037,41876,15.28634,273944
6025,jamesbechet,1,0.00037,41877,15.28670,273944
6026,jamesblacklock,1,0.00037,41878,15.28707,273944
6027,JamesCropcho,1,0.00037,41879,15.28743,273944
6028,James-Dunn,1,0.00037,41880,15.28780,273944
6029,jamesevickery,1,0.00037,41881,15.28816,273944
6030,jameslaneconkling,1,0.00037,41882,15.28853,273944
6031,JamesMessinger,1,0.00037,41883,15.28889,273944
6032,jamesmosier,1,0.00037,41884,15.28926,273944
6033,jamesreggio,1,0.00037,41885,15.28962,273944
6034,jamesseanwright,1,0.00037,41886,15.28999,273944
6035,jamischarles,1,0.00037,41887,15.29035,273944
6036,janaagaard75,1,0.00037,41888,15.29072,273944
6037,janczer,1,0.00037,41889,15.29108,273944
6038,janderudder,1,0.00037,41890,15.29145,273944
6039,jankal,1,0.00037,41891,15.29181,273944
6040,JanMalch,1,0.00037,41892,15.29218,273944
6041,janno-p,1,0.00037,41893,15.29254,273944
6042,janolivermr,1,0.00037,41894,15.29291,273944
6043,Janpopan,1,0.00037,41895,15.29327,273944
6044,Janpot,1,0.00037,41896,15.29364,273944
6045,janraasch,1,0.00037,41897,15.29400,273944
6046,japgolly,1,0.00037,41898,15.29437,273944
6047,jardilio,1,0.00037,41899,15.29473,273944
6048,jaredcacurak,1,0.00037,41900,15.29510,273944
6049,Jared-Dev,1,0.00037,41901,15.29546,273944
6050,jaredsuttles,1,0.00037,41902,15.29583,273944
6051,jarenduan,1,0.00037,41903,15.29619,273944
6052,jareware,1,0.00037,41904,15.29656,273944
6053,jarstingstall,1,0.00037,41905,15.29692,273944
6054,jarthod,1,0.00037,41906,15.29729,273944
6055,jas14,1,0.00037,41907,15.29765,273944
6056,Jas-n,1,0.00037,41908,15.29802,273944
6057,jasom,1,0.00037,41909,15.29838,273944
6058,Jason2031,1,0.00037,41910,15.29875,273944
6059,jasongrout,1,0.00037,41911,15.29911,273944
6060,jason-larigakis-hs,1,0.00037,41912,15.29948,273944
6061,jasonly,1,0.00037,41913,15.29984,273944
6062,jasonmerino,1,0.00037,41914,15.30021,273944
6063,jasononeil,1,0.00037,41915,15.30057,273944
6064,jasonslyvia,1,0.00037,41916,15.30094,273944
6065,jasonwoods-7,1,0.00037,41917,15.30130,273944
6066,jaubourg,1,0.00037,41918,15.30167,273944
6067,javabada,1,0.00037,41919,15.30203,273944
6068,Javache,1,0.00037,41920,15.30240,273944
6069,javawizard,1,0.00037,41921,15.30276,273944
6070,javespi,1,0.00037,41922,15.30313,273944
6071,javiercejudo,1,0.00037,41923,15.30349,273944
6072,jaw187,1,0.00037,41924,15.30386,273944
6073,jawish,1,0.00037,41925,15.30422,273944
6074,jawn,1,0.00037,41926,15.30459,273944
6075,JayArby,1,0.00037,41927,15.30495,273944
6076,jayeb,1,0.00037,41928,15.30532,273944
6077,jbasney,1,0.00037,41929,15.30568,273944
6078,jberry93,1,0.00037,41930,15.30605,273944
6079,jbleduigou,1,0.00037,41931,15.30641,273944
6080,jbmoelker,1,0.00037,41932,15.30678,273944
6081,jbogard,1,0.00037,41933,15.30714,273944
6082,jbojcic1,1,0.00037,41934,15.30751,273944
6083,jboulouloubi,1,0.00037,41935,15.30787,273944
6084,jbrower2,1,0.00037,41936,15.30824,273944
6085,jbrudvik,1,0.00037,41937,15.30860,273944
6086,jch,1,0.00037,41938,15.30897,273944
6087,jcroll,1,0.00037,41939,15.30933,273944
6088,jct-amzn,1,0.00037,41940,15.30970,273944
6089,jdai8,1,0.00037,41941,15.31006,273944
6090,jden,1,0.00037,41942,15.31043,273944
6091,jdevelop,1,0.00037,41943,15.31079,273944
6092,jdmichal,1,0.00037,41944,15.31116,273944
6093,jdreesen,1,0.00037,41945,15.31152,273944
6094,jdspugh,1,0.00037,41946,15.31189,273944
6095,jean-emmanuel,1,0.00037,41947,15.31225,273944
6096,jechevarria,1,0.00037,41948,15.31262,273944
6097,jeduan,1,0.00037,41949,15.31298,273944
6098,JeffAshton,1,0.00037,41950,15.31335,273944
6099,jeffbski,1,0.00037,41951,15.31371,273944
6100,jefffriesen,1,0.00037,41952,15.31408,273944
6101,jeffkole,1,0.00037,41953,15.31444,273944
6102,jeffnelson,1,0.00037,41954,15.31481,273944
6103,JeffQuandt,1,0.00037,41955,15.31517,273944
6104,jegtnes,1,0.00037,41956,15.31554,273944
6105,jehadja,1,0.00037,41957,15.31590,273944
6106,jehon,1,0.00037,41958,15.31627,273944
6107,jeltz,1,0.00037,41959,15.31663,273944
6108,jendib,1,0.00037,41960,15.31700,273944
6109,jennifer-shehane,1,0.00037,41961,15.31736,273944
6110,jeonghwan-kim,1,0.00037,41962,15.31773,273944
6111,jeremy-deutsch,1,0.00037,41963,15.31809,273944
6112,jeremy-w,1,0.00037,41964,15.31846,273944
6113,jerodsanto,1,0.00037,41965,15.31882,273944
6114,jeromepl,1,0.00037,41966,15.31919,273944
6115,jesperll,1,0.00037,41967,15.31955,273944
6116,jesperronn,1,0.00037,41968,15.31992,273944
6117,jesusfreak3,1,0.00037,41969,15.32028,273944
6118,jettcalleja,1,0.00037,41970,15.32065,273944
6119,jeyraof,1,0.00037,41971,15.32101,273944
6120,jezzay,1,0.00037,41972,15.32138,273944
6121,jf17,1,0.00037,41973,15.32174,273944
6122,jfairbank,1,0.00037,41974,15.32211,273944
6123,jfurie,1,0.00037,41975,15.32247,273944
6124,jgolieb,1,0.00037,41976,15.32284,273944
6125,jhalickman,1,0.00037,41977,15.32320,273944
6126,jha-naman,1,0.00037,41978,15.32357,273944
6127,jhecking,1,0.00037,41979,15.32393,273944
6128,jhen0409,1,0.00037,41980,15.32430,273944
6129,jhicken,1,0.00037,41981,15.32466,273944
6130,jhickson,1,0.00037,41982,15.32503,273944
6131,jhuang314,1,0.00037,41983,15.32539,273944
6132,jiakuan,1,0.00037,41984,15.32576,273944
6133,jibbajabba,1,0.00037,41985,15.32613,273944
6134,JimBobSquarePants,1,0.00037,41986,15.32649,273944
6135,jimbrowne,1,0.00037,41987,15.32686,273944
6136,jimf,1,0.00037,41988,15.32722,273944
6137,jimmy-e,1,0.00037,41989,15.32759,273944
6138,jimparsley,1,0.00037,41990,15.32795,273944
6139,jimreader,1,0.00037,41991,15.32832,273944
6140,JimTheMan,1,0.00037,41992,15.32868,273944
6141,JinHash5,1,0.00037,41993,15.32905,273944
6142,jintoppy,1,0.00037,41994,15.32941,273944
6143,JinxiuLee,1,0.00037,41995,15.32978,273944
6144,JiriHorky,1,0.00037,41996,15.33014,273944
6145,JitixPhotobox,1,0.00037,41997,15.33051,273944
6146,jiverson,1,0.00037,41998,15.33087,273944
6147,jiyeonseo,1,0.00037,41999,15.33124,273944
6148,jjhampton,1,0.00037,42000,15.33160,273944
6149,jjingrong,1,0.00037,42001,15.33197,273944
6150,jjjjw,1,0.00037,42002,15.33233,273944
6151,jjlharrison,1,0.00037,42003,15.33270,273944
6152,jjohannes,1,0.00037,42004,15.33306,273944
6153,jjoselv,1,0.00037,42005,15.33343,273944
6154,jkitchin,1,0.00037,42006,15.33379,273944
6155,jlanng,1,0.00037,42007,15.33416,273944
6156,jlewicki,1,0.00037,42008,15.33452,273944
6157,jlolling,1,0.00037,42009,15.33489,273944
6158,jmartin84,1,0.00037,42010,15.33525,273944
6159,jmmk,1,0.00037,42011,15.33562,273944
6160,JMounier,1,0.00037,42012,15.33598,273944
6161,jmsv,1,0.00037,42013,15.33635,273944
6162,jmthibault79,1,0.00037,42014,15.33671,273944
6163,jnfingerle,1,0.00037,42015,15.33708,273944
6164,jnu,1,0.00037,42016,15.33744,273944
6165,joankaradimov,1,0.00037,42017,15.33781,273944
6166,jobeland,1,0.00037,42018,15.33817,273944
6167,joefraley,1,0.00037,42019,15.33854,273944
6168,joelbrewer,1,0.00037,42020,15.33890,273944
6169,joeldenning,1,0.00037,42021,15.33927,273944
6170,joelee,1,0.00037,42022,15.33963,273944
6171,joelgallant,1,0.00037,42023,15.34000,273944
6172,joelittlejohn,1,0.00037,42024,15.34036,273944
6173,JoelOtter,1,0.00037,42025,15.34073,273944
6174,joelseq,1,0.00037,42026,15.34109,273944
6175,joemcelroy,1,0.00037,42027,15.34146,273944
6176,joepie91,1,0.00037,42028,15.34182,273944
6177,joewagner,1,0.00037,42029,15.34219,273944
6178,JoeWagner,1,0.00037,42030,15.34255,273944
6179,JoeyBurzynski,1,0.00037,42031,15.34292,273944
6180,JoeZheng2015,1,0.00037,42032,15.34328,273944
6181,johanhenrikssn,1,0.00037,42033,15.34365,273944
6182,johanlelan,1,0.00037,42034,15.34401,273944
6183,johanneslumpe,1,0.00037,42035,15.34438,273944
6184,johannesschaefer,1,0.00037,42036,15.34474,273944
6185,johncrisostomo,1,0.00037,42037,15.34511,273944
6186,john-d-pelingo,1,0.00037,42038,15.34547,273944
6187,JohnHughesAtlantech,1,0.00037,42039,15.34584,273944
6188,johnideal,1,0.00037,42040,15.34620,273944
6189,johnjacobkenny,1,0.00037,42041,15.34657,273944
6190,johnjelinek,1,0.00037,42042,15.34693,273944
6191,johnny-mh,1,0.00037,42043,15.34730,273944
6192,johnpapa,1,0.00037,42044,15.34766,273944
6193,johnynek,1,0.00037,42045,15.34803,273944
6194,joineral32,1,0.00037,42046,15.34839,273944
6195,jomeier,1,0.00037,42047,15.34876,273944
6196,jon301,1,0.00037,42048,15.34912,273944
6197,jonashdown,1,0.00037,42049,15.34949,273944
6198,jonathangarelick,1,0.00037,42050,15.34985,273944
6199,jonathanp,1,0.00037,42051,15.35022,273944
6200,jonathathan,1,0.00037,42052,15.35058,273944
6201,jonchester,1,0.00037,42053,15.35095,273944
6202,jondubois,1,0.00037,42054,15.35131,273944
6203,jonekdahl,1,0.00037,42055,15.35168,273944
6204,JonForest,1,0.00037,42056,15.35204,273944
6205,jonganc,1,0.00037,42057,15.35241,273944
6206,jongyoonlee,1,0.00037,42058,15.35277,273944
6207,jonmiles,1,0.00037,42059,15.35314,273944
6208,jonorossi,1,0.00037,42060,15.35350,273944
6209,jonoskar,1,0.00037,42061,15.35387,273944
6210,JonRimmer,1,0.00037,42062,15.35423,273944
6211,jonscottclark,1,0.00037,42063,15.35460,273944
6212,jontejj,1,0.00037,42064,15.35496,273944
6213,joordas,1,0.00037,42065,15.35533,273944
6214,joost-de-vries,1,0.00037,42066,15.35569,273944
6215,joostme,1,0.00037,42067,15.35606,273944
6216,jordalgo,1,0.00037,42068,15.35642,273944
6217,jordangray,1,0.00037,42069,15.35679,273944
6218,jordanhendricks,1,0.00037,42070,15.35715,273944
6219,jorgebay,1,0.00037,42071,15.35752,273944
6220,Joris-van-der-Wel,1,0.00037,42072,15.35788,273944
6221,jorrit-wehelp,1,0.00037,42073,15.35825,273944
6222,josdea,1,0.00037,42074,15.35861,273944
6223,jose4125,1,0.00037,42075,15.35898,273944
6224,josecolella,1,0.00037,42076,15.35934,273944
6225,joseigor,1,0.00037,42077,15.35971,273944
6226,JosephAmalfitanoSSA,1,0.00037,42078,15.36007,273944
6227,josephjaniga,1,0.00037,42079,15.36044,273944
6228,josephlbarnett,1,0.00037,42080,15.36080,273944
6229,josephrubin,1,0.00037,42081,15.36117,273944
6230,JosephWoodward,1,0.00037,42082,15.36153,273944
6231,Josh-a-e,1,0.00037,42083,15.36190,273944
6232,JoshAntBrown,1,0.00037,42084,15.36226,273944
6233,joshbambrick,1,0.00037,42085,15.36263,273944
6234,joshhunt,1,0.00037,42086,15.36299,273944
6235,joshk,1,0.00037,42087,15.36336,273944
6236,joshkurz,1,0.00037,42088,15.36372,273944
6237,joshomccarty,1,0.00037,42089,15.36409,273944
6238,JoshSGman,1,0.00037,42090,15.36445,273944
6239,joshuago,1,0.00037,42091,15.36482,273944
6240,JoshuaScript,1,0.00037,42092,15.36518,273944
6241,joshunger,1,0.00037,42093,15.36555,273944
6242,joshux,1,0.00037,42094,15.36591,273944
6243,JoshWillik,1,0.00037,42095,15.36628,273944
6244,josiasmontag,1,0.00037,42096,15.36664,273944
6245,joyeecheung,1,0.00037,42097,15.36701,273944
6246,joymufeng,1,0.00037,42098,15.36737,273944
6247,jozlnr,1,0.00037,42099,15.36774,273944
6248,jpaugh,1,0.00037,42100,15.36810,273944
6249,jpierson,1,0.00037,42101,15.36847,273944
6250,JProgrammer,1,0.00037,42102,15.36883,273944
6251,jpwiddy,1,0.00037,42103,15.36920,273944
6252,jramosf,1,0.00037,42104,15.36956,273944
6253,jrevillas,1,0.00037,42105,15.36993,273944
6254,jrgm,1,0.00037,42106,15.37029,273944
6255,jrmarino,1,0.00037,42107,15.37066,273944
6256,jrobison153,1,0.00037,42108,15.37102,273944
6257,jrouly,1,0.00037,42109,15.37139,273944
6258,jrvidal,1,0.00037,42110,15.37175,273944
6259,jsampson2,1,0.00037,42111,15.37212,273944
6260,jsamr,1,0.00037,42112,15.37248,273944
6261,jschaf,1,0.00037,42113,15.37285,273944
6262,jsdevel,1,0.00037,42114,15.37321,273944
6263,jsdf,1,0.00037,42115,15.37358,273944
6264,jsha,1,0.00037,42116,15.37395,273944
6265,jskierbi,1,0.00037,42117,15.37431,273944
6266,jsong0605,1,0.00037,42118,15.37468,273944
6267,jstamerj,1,0.00037,42119,15.37504,273944
6268,jstrutz,1,0.00037,42120,15.37541,273944
6269,jsumners,1,0.00037,42121,15.37577,273944
6270,jtbandes,1,0.00037,42122,15.37614,273944
6271,jthelin,1,0.00037,42123,15.37650,273944
6272,jtmalinowski,1,0.00037,42124,15.37687,273944
6273,jtrumbull,1,0.00037,42125,15.37723,273944
6274,jtwebman,1,0.00037,42126,15.37760,273944
6275,juancho1,1,0.00037,42127,15.37796,273944
6276,JuanjoSalvador,1,0.00037,42128,15.37833,273944
6277,judikdavid,1,0.00037,42129,15.37869,273944
6278,juliankrispel,1,0.00037,42130,15.37906,273944
6279,juliuszsompolski,1,0.00037,42131,15.37942,273944
6280,julmot,1,0.00037,42132,15.37979,273944
6281,Jun711,1,0.00037,42133,15.38015,273944
6282,junajan,1,0.00037,42134,15.38052,273944
6283,jung-kim,1,0.00037,42135,15.38088,273944
6284,JunhoKim01,1,0.00037,42136,15.38125,273944
6285,junosuarez,1,0.00037,42137,15.38161,273944
6286,JustArchi,1,0.00037,42138,15.38198,273944
6287,JustBlackBird,1,0.00037,42139,15.38234,273944
6288,justincy,1,0.00037,42140,15.38271,273944
6289,justinmchase,1,0.00037,42141,15.38307,273944
6290,JustinPihony,1,0.00037,42142,15.38344,273944
6291,JustinTRoss,1,0.00037,42143,15.38380,273944
6292,jvanoostveen,1,0.00037,42144,15.38417,273944
6293,jvcjunior,1,0.00037,42145,15.38453,273944
6294,jvelo,1,0.00037,42146,15.38490,273944
6295,jviereck,1,0.00037,42147,15.38526,273944
6296,jviotti,1,0.00037,42148,15.38563,273944
6297,jw-00000,1,0.00037,42149,15.38599,273944
6298,jwcarman,1,0.00037,42150,15.38636,273944
6299,jwcarroll,1,0.00037,42151,15.38672,273944
6300,jwKimo,1,0.00037,42152,15.38709,273944
6301,jwkratz,1,0.00037,42153,15.38745,273944
6302,jwp3243,1,0.00037,42154,15.38782,273944
6303,JWTappert,1,0.00037,42155,15.38818,273944
6304,jysoo,1,0.00037,42156,15.38855,273944
6305,jyterencekim,1,0.00037,42157,15.38891,273944
6306,jzabroski,1,0.00037,42158,15.38928,273944
6307,jzischkau,1,0.00037,42159,15.38964,273944
6308,k0st1x,1,0.00037,42160,15.39001,273944
6309,kafein,1,0.00037,42161,15.39037,273944
6310,kahunacohen,1,0.00037,42162,15.39074,273944
6311,kaie,1,0.00037,42163,15.39110,273944
6312,kaiyuanw,1,0.00037,42164,15.39147,273944
6313,kaizora,1,0.00037,42165,15.39183,273944
6314,kambo,1,0.00037,42166,15.39220,273944
6315,kamilduda,1,0.00037,42167,15.39256,273944
6316,kamioftea,1,0.00037,42168,15.39293,273944
6317,kamlekar,1,0.00037,42169,15.39329,273944
6318,Kamshak,1,0.00037,42170,15.39366,273944
6319,kannanekanath,1,0.00037,42171,15.39402,273944
6320,kant,1,0.00037,42172,15.39439,273944
6321,kapilgorve,1,0.00037,42173,15.39475,273944
6322,kapooostin,1,0.00037,42174,15.39512,273944
6323,Karamell,1,0.00037,42175,15.39548,273944
6324,karan-96,1,0.00037,42176,15.39585,273944
6325,karanjthakkar,1,0.00037,42177,15.39621,273944
6326,karataev,1,0.00037,42178,15.39658,273944
6327,karczk,1,0.00037,42179,15.39694,273944
6328,karlcoelho,1,0.00037,42180,15.39731,273944
6329,karlnorling,1,0.00037,42181,15.39767,273944
6330,karlpatrickespiritu,1,0.00037,42182,15.39804,273944
6331,Karthikvenkat86,1,0.00037,42183,15.39840,273944
6332,kartiklad,1,0.00037,42184,15.39877,273944
6333,kashiro,1,0.00037,42185,15.39913,273944
6334,kasiditi,1,0.00037,42186,15.39950,273944
6335,kassemsandarusi,1,0.00037,42187,15.39986,273944
6336,kasunt84,1,0.00037,42188,15.40023,273944
6337,katemihalikova,1,0.00037,42189,15.40059,273944
6338,Katherraptor,1,0.00037,42190,15.40096,273944
6339,katiaeirin,1,0.00037,42191,15.40132,273944
6340,katsos,1,0.00037,42192,15.40169,273944
6341,Kaushik1987,1,0.00037,42193,15.40205,273944
6342,kausters,1,0.00037,42194,15.40242,273944
6343,kaypro4,1,0.00037,42195,15.40278,273944
6344,kazssym,1,0.00037,42196,15.40315,273944
6345,kazuki229,1,0.00037,42197,15.40351,273944
6346,kbariotis,1,0.00037,42198,15.40388,273944
6347,kbrgl,1,0.00037,42199,15.40424,273944
6348,k-cheng,1,0.00037,42200,15.40461,273944
6349,kchirls,1,0.00037,42201,15.40497,273944
6350,kcthota,1,0.00037,42202,15.40534,273944
6351,keigo,1,0.00037,42203,15.40570,273944
6352,keirog,1,0.00037,42204,15.40607,273944
6353,kelebra,1,0.00037,42205,15.40643,273944
6354,kellypleahy,1,0.00037,42206,15.40680,273944
6355,kellyrmilligan,1,0.00037,42207,15.40716,273944
6356,kenhowardpdx,1,0.00037,42208,15.40753,273944
6357,kennynaoh,1,0.00037,42209,15.40789,273944
6358,kenrota,1,0.00037,42210,15.40826,273944
6359,kepta,1,0.00037,42211,15.40862,273944
6360,kevin940726,1,0.00037,42212,15.40899,273944
6361,Kevinci,1,0.00037,42213,15.40935,273944
6362,kevincupp,1,0.00037,42214,15.40972,273944
6363,Kevin-K,1,0.00037,42215,15.41008,273944
6364,kevinkassimo,1,0.00037,42216,15.41045,273944
6365,kevinmost,1,0.00037,42217,15.41081,273944
6366,kevinphelps,1,0.00037,42218,15.41118,273944
6367,kevinsawicki,1,0.00037,42219,15.41154,273944
6368,kevinslin,1,0.00037,42220,15.41191,273944
6369,KevinTCoughlin,1,0.00037,42221,15.41227,273944
6370,kevinwestern,1,0.00037,42222,15.41264,273944
6371,KeweiCodes,1,0.00037,42223,15.41300,273944
6372,keyten,1,0.00037,42224,15.41337,273944
6373,khernyo,1,0.00037,42225,15.41373,273944
6374,Khez,1,0.00037,42226,15.41410,273944
6375,kiavashp,1,0.00037,42227,15.41446,273944
6376,kidonng,1,0.00037,42228,15.41483,273944
6377,kilianc,1,0.00037,42229,15.41519,273944
6378,kilida,1,0.00037,42230,15.41556,273944
6379,KillaBee1985,1,0.00037,42231,15.41592,273944
6380,KillWolfVlad,1,0.00037,42232,15.41629,273944
6381,kilotaras,1,0.00037,42233,15.41665,273944
6382,kimmobrunfeldt,1,0.00037,42234,15.41702,273944
6383,kingdido999,1,0.00037,42235,15.41738,273944
6384,kini,1,0.00037,42236,15.41775,273944
6385,kira1928,1,0.00037,42237,15.41811,273944
6386,kirill-konshin,1,0.00037,42238,15.41848,273944
6387,KirillOsenkov,1,0.00037,42239,15.41884,273944
6388,kirill-vlasov,1,0.00037,42240,15.41921,273944
6389,kitsonk,1,0.00037,42241,15.41957,273944
6390,KittieCrash,1,0.00037,42242,15.41994,273944
6391,kjivan,1,0.00037,42243,15.42030,273944
6392,klamping,1,0.00037,42244,15.42067,273944
6393,klausbayrhammer,1,0.00037,42245,15.42103,273944
6394,klemenoslaj,1,0.00037,42246,15.42140,273944
6395,klimashkin,1,0.00037,42247,15.42177,273944
6396,klis87,1,0.00037,42248,15.42213,273944
6397,kloun,1,0.00037,42249,15.42250,273944
6398,Kmaschta,1,0.00037,42250,15.42286,273944
6399,knholland,1,0.00037,42251,15.42323,273944
6400,knjk04,1,0.00037,42252,15.42359,273944
6401,kno10,1,0.00037,42253,15.42396,273944
6402,knoxcard,1,0.00037,42254,15.42432,273944
6403,k-nut,1,0.00037,42255,15.42469,273944
6404,kobayashi,1,0.00037,42256,15.42505,273944
6405,KodrAus,1,0.00037,42257,15.42542,273944
6406,koenigst,1,0.00037,42258,15.42578,273944
6407,kohashi,1,0.00037,42259,15.42615,273944
6408,koh-taka,1,0.00037,42260,15.42651,273944
6409,koistya,1,0.00037,42261,15.42688,273944
6410,kolomiichenko,1,0.00037,42262,15.42724,273944
6411,KoltesDigital,1,0.00037,42263,15.42761,273944
6412,konekoya,1,0.00037,42264,15.42797,273944
6413,kon-shou,1,0.00037,42265,15.42834,273944
6414,KonstaL,1,0.00037,42266,15.42870,273944
6415,konteck,1,0.00037,42267,15.42907,273944
6416,koopero,1,0.00037,42268,15.42943,273944
6417,kootoopas,1,0.00037,42269,15.42980,273944
6418,kopylovvlad,1,0.00037,42270,15.43016,273944
6419,koraytugay,1,0.00037,42271,15.43053,273944
6420,Kouzukii,1,0.00037,42272,15.43089,273944
6421,kp96,1,0.00037,42273,15.43126,273944
6422,Krajsnick,1,0.00037,42274,15.43162,273944
6423,krenor,1,0.00037,42275,15.43199,273944
6424,Kreozot,1,0.00037,42276,15.43235,273944
6425,KristofMorva,1,0.00037,42277,15.43272,273944
6426,krnsripati,1,0.00037,42278,15.43308,273944
6427,krosenberg,1,0.00037,42279,15.43345,273944
6428,kryogenic,1,0.00037,42280,15.43381,273944
6429,kryops,1,0.00037,42281,15.43418,273944
6430,krzyk,1,0.00037,42282,15.43454,273944
6431,krzywiecki,1,0.00037,42283,15.43491,273944
6432,k-schneider,1,0.00037,42284,15.43527,273944
6433,ksheedlo,1,0.00037,42285,15.43564,273944
6434,kshetline,1,0.00037,42286,15.43600,273944
6435,kshitijb,1,0.00037,42287,15.43637,273944
6436,ksloan,1,0.00037,42288,15.43673,273944
6437,ksnabb,1,0.00037,42289,15.43710,273944
6438,kspearrin,1,0.00037,42290,15.43746,273944
6439,KSXGitHub,1,0.00037,42291,15.43783,273944
6440,ku8ar,1,0.00037,42292,15.43819,273944
6441,kubosho,1,0.00037,42293,15.43856,273944
6442,kuitos,1,0.00037,42294,15.43892,273944
6443,kukat,1,0.00037,42295,15.43929,273944
6444,kukjevov,1,0.00037,42296,15.43965,273944
6445,kulek1,1,0.00037,42297,15.44002,273944
6446,Kundan28,1,0.00037,42298,15.44038,273944
6447,kunxian-xia,1,0.00037,42299,15.44075,273944
6448,kusold,1,0.00037,42300,15.44111,273944
6449,kutagh,1,0.00037,42301,15.44148,273944
6450,kwelch,1,0.00037,42302,15.44184,273944
6451,kwizzn,1,0.00037,42303,15.44221,273944
6452,kyeotic,1,0.00037,42304,15.44257,273944
6453,kyle116,1,0.00037,42305,15.44294,273944
6454,kylezeeuwen,1,0.00037,42306,15.44330,273944
6455,kyoz,1,0.00037,42307,15.44367,273944
6456,kyranet,1,0.00037,42308,15.44403,273944
6457,Laassari,1,0.00037,42309,15.44440,273944
6458,laat,1,0.00037,42310,15.44476,273944
6459,lahmatiy,1,0.00037,42311,15.44513,273944
6460,lalithpolepeddi,1,0.00037,42312,15.44549,273944
6461,lambdageek,1,0.00037,42313,15.44586,273944
6462,lambdista,1,0.00037,42314,15.44622,273944
6463,lamby,1,0.00037,42315,15.44659,273944
6464,lamo2k123,1,0.00037,42316,15.44695,273944
6465,Lange,1,0.00037,42317,15.44732,273944
6466,laranhee,1,0.00037,42318,15.44768,273944
6467,larrywest42,1,0.00037,42319,15.44805,273944
6468,larsrh,1,0.00037,42320,15.44841,273944
6469,LarsTi,1,0.00037,42321,15.44878,273944
6470,larzknoke,1,0.00037,42322,15.44914,273944
6471,Lasering,1,0.00037,42323,15.44951,273944
6472,lashad,1,0.00037,42324,15.44987,273944
6473,laurentgoudet,1,0.00037,42325,15.45024,273944
6474,laurentkempe,1,0.00037,42326,15.45060,273944
6475,lauriejones,1,0.00037,42327,15.45097,273944
6476,laurio,1,0.00037,42328,15.45133,273944
6477,lazaroalvarenga,1,0.00037,42329,15.45170,273944
6478,lbesson,1,0.00037,42330,15.45206,273944
6479,lbogdan,1,0.00037,42331,15.45243,273944
6480,lboullo0,1,0.00037,42332,15.45279,273944
6481,lbragaglia,1,0.00037,42333,15.45316,273944
6482,lcarva,1,0.00037,42334,15.45352,273944
6483,lcoote,1,0.00037,42335,15.45389,273944
6484,lddubeau,1,0.00037,42336,15.45425,273944
6485,ledbit,1,0.00037,42337,15.45462,273944
6486,lehni,1,0.00037,42338,15.45498,273944
6487,leibale,1,0.00037,42339,15.45535,273944
6488,leighsn,1,0.00037,42340,15.45571,273944
6489,leipert,1,0.00037,42341,15.45608,273944
6490,lenisha,1,0.00037,42342,15.45644,273944
6491,lennym,1,0.00037,42343,15.45681,273944
6492,lenovouser,1,0.00037,42344,15.45717,273944
6493,leocaseiro,1,0.00037,42345,15.45754,273944
6494,LeoDanielsson,1,0.00037,42346,15.45790,273944
6495,leoger,1,0.00037,42347,15.45827,273944
6496,leonardodino,1,0.00037,42348,15.45863,273944
6497,leongjiameng,1,0.00037,42349,15.45900,273944
6498,leongrdic,1,0.00037,42350,15.45936,273944
6499,leoselig,1,0.00037,42351,15.45973,273944
6500,leosvelperez,1,0.00037,42352,15.46009,273944
6501,leothorp,1,0.00037,42353,15.46046,273944
6502,leotsarev,1,0.00037,42354,15.46082,273944
6503,lesiak,1,0.00037,42355,15.46119,273944
6504,lessfish,1,0.00037,42356,15.46155,273944
6505,letiemble,1,0.00037,42357,15.46192,273944
6506,LetItRock,1,0.00037,42358,15.46228,273944
6507,letrhee-nsr,1,0.00037,42359,15.46265,273944
6508,levibotelho,1,0.00037,42360,15.46301,273944
6509,LeviticusMB,1,0.00037,42361,15.46338,273944
6510,lewurm,1,0.00037,42362,15.46374,273944
6511,lex111,1,0.00037,42363,15.46411,273944
6512,lexdene,1,0.00037,42364,15.46447,273944
6513,lexinerus,1,0.00037,42365,15.46484,273944
6514,lgaticaq,1,0.00037,42366,15.46520,273944
6515,lgraubner,1,0.00037,42367,15.46557,273944
6516,LiadIdan,1,0.00037,42368,15.46593,273944
6517,liady,1,0.00037,42369,15.46630,273944
6518,libetl,1,0.00037,42370,15.46666,273944
6519,LichKing-lee,1,0.00037,42371,15.46703,273944
6520,lielfr,1,0.00037,42372,15.46739,273944
6521,lifeisfoo,1,0.00037,42373,15.46776,273944
6522,lifuhuang,1,0.00037,42374,15.46812,273944
6523,lifus,1,0.00037,42375,15.46849,273944
6524,lightbringer1991,1,0.00037,42376,15.46885,273944
6525,lillo42,1,0.00037,42377,15.46922,273944
6526,lina,1,0.00037,42378,15.46959,273944
6527,Linard11,1,0.00037,42379,15.46995,273944
6528,lindboe,1,0.00037,42380,15.47032,273944
6529,link-alex,1,0.00037,42381,15.47068,273944
6530,lioman,1,0.00037,42382,15.47105,273944
6531,lionello,1,0.00037,42383,15.47141,273944
6532,liorcode,1,0.00037,42384,15.47178,273944
6533,liranc,1,0.00037,42385,15.47214,273944
6534,liry,1,0.00037,42386,15.47251,273944
6535,lisapfisterer,1,0.00037,42387,15.47287,273944
6536,liskin,1,0.00037,42388,15.47324,273944
6537,liudongmiao,1,0.00037,42389,15.47360,273944
6538,liuhelen10,1,0.00037,42390,15.47397,273944
6539,liunian,1,0.00037,42391,15.47433,273944
6540,liutao,1,0.00037,42392,15.47470,273944
6541,LKI,1,0.00037,42393,15.47506,273944
6542,llekn,1,0.00037,42394,15.47543,273944
6543,lloy0076,1,0.00037,42395,15.47579,273944
6544,lm1,1,0.00037,42396,15.47616,273944
6545,lndbrg,1,0.00037,42397,15.47652,273944
6546,lnkvisitor,1,0.00037,42398,15.47689,273944
6547,lobster2012-user,1,0.00037,42399,15.47725,273944
6548,locknono,1,0.00037,42400,15.47762,273944
6549,logiclrd,1,0.00037,42401,15.47798,273944
6550,logihome,1,0.00037,42402,15.47835,273944
6551,loilo,1,0.00037,42403,15.47871,273944
6552,Lokua,1,0.00037,42404,15.47908,273944
6553,longagofaraway,1,0.00037,42405,15.47944,273944
6554,lopezcjf,1,0.00037,42406,15.47981,273944
6555,LordMike,1,0.00037,42407,15.48017,273944
6556,lorenzph,1,0.00037,42408,15.48054,273944
6557,LosBunkos,1,0.00037,42409,15.48090,273944
6558,LotharOfTheHillPeople,1,0.00037,42410,15.48127,273944
6559,lpandzic,1,0.00037,42411,15.48163,273944
6560,lpolepeddi,1,0.00037,42412,15.48200,273944
6561,Lroca88,1,0.00037,42413,15.48236,273944
6562,lrstanley,1,0.00037,42414,15.48273,273944
6563,ls-guillaume-rebesche,1,0.00037,42415,15.48309,273944
6564,LTMenezes,1,0.00037,42416,15.48346,273944
6565,luanmuniz,1,0.00037,42417,15.48382,273944
6566,luanpotter,1,0.00037,42418,15.48419,273944
6567,lucalas,1,0.00037,42419,15.48455,273944
6568,lucas-aragno,1,0.00037,42420,15.48492,273944
6569,luccioman,1,0.00037,42421,15.48528,273944
6570,Luciferius,1,0.00037,42422,15.48565,273944
6571,luciferous,1,0.00037,42423,15.48601,273944
6572,Ludevik,1,0.00037,42424,15.48638,273944
6573,ludovic-henry,1,0.00037,42425,15.48674,273944
6574,ludovicofischer,1,0.00037,42426,15.48711,273944
6575,ludovicoforace,1,0.00037,42427,15.48747,273944
6576,ludvigsen,1,0.00037,42428,15.48784,273944
6577,LudwikJaniuk,1,0.00037,42429,15.48820,273944
6578,lufegit,1,0.00037,42430,15.48857,273944
6579,luggage66,1,0.00037,42431,15.48893,273944
6580,luislobo,1,0.00037,42432,15.48930,273944
6581,lukas-lansky,1,0.00037,42433,15.48966,273944
6582,lukechilds,1,0.00037,42434,15.49003,273944
6583,lukeed,1,0.00037,42435,15.49039,273944
6584,lukemcgregor,1,0.00037,42436,15.49076,273944
6585,lukepolo,1,0.00037,42437,15.49112,273944
6586,lukewagner,1,0.00037,42438,15.49149,273944
6587,lullajd,1,0.00037,42439,15.49185,273944
6588,lunaticare,1,0.00037,42440,15.49222,273944
6589,lusarz,1,0.00037,42441,15.49258,273944
6590,lutovich,1,0.00037,42442,15.49295,273944
6591,lvivski,1,0.00037,42443,15.49331,273944
6592,lvzhenbang,1,0.00037,42444,15.49368,273944
6593,lx1036,1,0.00037,42445,15.49404,273944
6594,lxxxvi,1,0.00037,42446,15.49441,273944
6595,lydell,1,0.00037,42447,15.49477,273944
6596,lylek,1,0.00037,42448,15.49514,273944
6597,Ly-lns,1,0.00037,42449,15.49550,273944
6598,lyonplus,1,0.00037,42450,15.49587,273944
6599,Lysander6,1,0.00037,42451,15.49623,273944
6600,lzybkr,1,0.00037,42452,15.49660,273944
6601,m08pvv-zz,1,0.00037,42453,15.49696,273944
6602,m0xb,1,0.00037,42454,15.49733,273944
6603,m1guelpf,1,0.00037,42455,15.49769,273944
6604,m1neral,1,0.00037,42456,15.49806,273944
6605,m59peacemaker,1,0.00037,42457,15.49842,273944
6606,maartentibau,1,0.00037,42458,15.49879,273944
6607,Maciek416,1,0.00037,42459,15.49915,273944
6608,Macil,1,0.00037,42460,15.49952,273944
6609,madarche,1,0.00037,42461,15.49988,273944
6610,madelson,1,0.00037,42462,15.50025,273944
6611,madenwala,1,0.00037,42463,15.50061,273944
6612,MadLittleMods,1,0.00037,42464,15.50098,273944
6613,madrob,1,0.00037,42465,15.50134,273944
6614,magicdawn,1,0.00037,42466,15.50171,273944
6615,MagikSquirrel,1,0.00037,42467,15.50207,273944
6616,magnudae,1,0.00037,42468,15.50244,273944
6617,magro,1,0.00037,42469,15.50280,273944
6618,maherbeg,1,0.00037,42470,15.50317,273944
6619,MahmudH,1,0.00037,42471,15.50353,273944
6620,mainakae,1,0.00037,42472,15.50390,273944
6621,maiph,1,0.00037,42473,15.50426,273944
6622,Maistho,1,0.00037,42474,15.50463,273944
6623,majecty,1,0.00037,42475,15.50499,273944
6624,makrandgupta,1,0.00037,42476,15.50536,273944
6625,maks-rafalko,1,0.00037,42477,15.50572,273944
6626,malcolmrebughini,1,0.00037,42478,15.50609,273944
6627,malfist,1,0.00037,42479,15.50645,273944
6628,Malizor,1,0.00037,42480,15.50682,273944
6629,malladi-s,1,0.00037,42481,15.50718,273944
6630,malthejorgensen,1,0.00037,42482,15.50755,273944
6631,malud,1,0.00037,42483,15.50791,273944
6632,Mamboleoo,1,0.00037,42484,15.50828,273944
6633,mandawah,1,0.00037,42485,15.50864,273944
6634,mani-mishra,1,0.00037,42486,15.50901,273944
6635,Manishearth,1,0.00037,42487,15.50937,273944
6636,ManoelLobo,1,0.00037,42488,15.50974,273944
6637,manospasj,1,0.00037,42489,15.51010,273944
6638,manrueda,1,0.00037,42490,15.51047,273944
6639,manudwarf,1,0.00037,42491,15.51083,273944
6640,manuelkollus,1,0.00037,42492,15.51120,273944
6641,manveru,1,0.00037,42493,15.51156,273944
6642,marado,1,0.00037,42494,15.51193,273944
6643,marc-christian-schulze,1,0.00037,42495,15.51229,273944
6644,MarcelGerber,1,0.00037,42496,15.51266,273944
6645,marcelometal,1,0.00037,42497,15.51302,273944
6646,marcfallows,1,0.00037,42498,15.51339,273944
6647,marchant,1,0.00037,42499,15.51375,273944
6648,marclipovsky,1,0.00037,42500,15.51412,273944
6649,marcnet80,1,0.00037,42501,15.51448,273944
6650,marcoil,1,0.00037,42502,15.51485,273944
6651,Marcono1234,1,0.00037,42503,15.51521,273944
6652,marcoow,1,0.00037,42504,15.51558,273944
6653,marcprux,1,0.00037,42505,15.51594,273944
6654,marcrocny,1,0.00037,42506,15.51631,273944
6655,MarcT512,1,0.00037,42507,15.51667,273944
6656,marcus-h,1,0.00037,42508,15.51704,273944
6657,marcusmolchany,1,0.00037,42509,15.51741,273944
6658,marcuspoehls,1,0.00037,42510,15.51777,273944
6659,marcusradell,1,0.00037,42511,15.51814,273944
6660,marcuswhybrow,1,0.00037,42512,15.51850,273944
6661,mardibiase,1,0.00037,42513,15.51887,273944
6662,marekventur,1,0.00037,42514,15.51923,273944
6663,MaridProject,1,0.00037,42515,15.51960,273944
6664,mariecl,1,0.00037,42516,15.51996,273944
6665,mariodu,1,0.00037,42517,15.52033,273944
6666,marioestradarosa,1,0.00037,42518,15.52069,273944
6667,marios-zindilis,1,0.00037,42519,15.52106,273944
6668,marjakh,1,0.00037,42520,15.52142,273944
6669,marjan-georgiev,1,0.00037,42521,15.52179,273944
6670,markandrus,1,0.00037,42522,15.52215,273944
6671,MarkArranz,1,0.00037,42523,15.52252,273944
6672,markau,1,0.00037,42524,15.52288,273944
6673,markbirbeck,1,0.00037,42525,15.52325,273944
6674,MarkChrisLevy,1,0.00037,42526,15.52361,273944
6675,Marketionist,1,0.00037,42527,15.52398,273944
6676,markhurd,1,0.00037,42528,15.52434,273944
6677,markjackson02,1,0.00037,42529,15.52471,273944
6678,marko-asplund,1,0.00037,42530,15.52507,273944
6679,marko-bekhta,1,0.00037,42531,15.52544,273944
6680,marko-vasic,1,0.00037,42532,15.52580,273944
6681,MarkPollmann,1,0.00037,42533,15.52617,273944
6682,marksanghoonkim,1,0.00037,42534,15.52653,273944
6683,markshannon,1,0.00037,42535,15.52690,273944
6684,markspolakovs,1,0.00037,42536,15.52726,273944
6685,marktinsley,1,0.00037,42537,15.52763,273944
6686,markusjura,1,0.00037,42538,15.52799,273944
6687,markyen,1,0.00037,42539,15.52836,273944
6688,marlonbarcarol,1,0.00037,42540,15.52872,273944
6689,marlonmleite,1,0.00037,42541,15.52909,273944
6690,marshall007,1,0.00037,42542,15.52945,273944
6691,marthagenaars,1,0.00037,42543,15.52982,273944
6692,MartinKamenov,1,0.00037,42544,15.53018,273944
6693,martinwoodward,1,0.00037,42545,15.53055,273944
6694,martomi,1,0.00037,42546,15.53091,273944
6695,Marv51,1,0.00037,42547,15.53128,273944
6696,masao,1,0.00037,42548,15.53164,273944
6697,Maskedman99,1,0.00037,42549,15.53201,273944
6698,masteradhoc,1,0.00037,42550,15.53237,273944
6699,masterots,1,0.00037,42551,15.53274,273944
6700,mastojun,1,0.00037,42552,15.53310,273944
6701,matankb,1,0.00037,42553,15.53347,273944
6702,matchu,1,0.00037,42554,15.53383,273944
6703,matejskubic,1,0.00037,42555,15.53420,273944
6704,matejstrasek,1,0.00037,42556,15.53456,273944
6705,mateusz-matela,1,0.00037,42557,15.53493,273944
6706,matheusazzi,1,0.00037,42558,15.53529,273944
6707,matheushf,1,0.00037,42559,15.53566,273944
6708,mathhun,1,0.00037,42560,15.53602,273944
6709,mathiasrw,1,0.00037,42561,15.53639,273944
6710,mathielo,1,0.00037,42562,15.53675,273944
6711,Mathieuu,1,0.00037,42563,15.53712,273944
6712,mathisonian,1,0.00037,42564,15.53748,273944
6713,matias-capeletto,1,0.00037,42565,15.53785,273944
6714,matiaszanolli,1,0.00037,42566,15.53821,273944
6715,matildasmeds,1,0.00037,42567,15.53858,273944
6716,matryo,1,0.00037,42568,15.53894,273944
6717,mattbab,1,0.00037,42569,15.53931,273944
6718,mattc41190,1,0.00037,42570,15.53967,273944
6719,MattCain,1,0.00037,42571,15.54004,273944
6720,MattCBowman,1,0.00037,42572,15.54040,273944
6721,matt-duch,1,0.00037,42573,15.54077,273944
6722,matteason,1,0.00037,42574,15.54113,273944
6723,matteosuppo,1,0.00037,42575,15.54150,273944
6724,matthargett,1,0.00037,42576,15.54186,273944
6725,matt-hernandez,1,0.00037,42577,15.54223,273944
6726,MatthewBeardmore,1,0.00037,42578,15.54259,273944
6727,matthewcm,1,0.00037,42579,15.54296,273944
6728,Matthew-Davey,1,0.00037,42580,15.54332,273944
6729,matthewlooi,1,0.00037,42581,15.54369,273944
6730,matthiasdebaere,1,0.00037,42582,15.54405,273944
6731,MatthieuLemoine,1,0.00037,42583,15.54442,273944
6732,matthijsbreemans,1,0.00037,42584,15.54478,273944
6733,mattiamanzati,1,0.00037,42585,15.54515,273944
6734,MattiasBuelens,1,0.00037,42586,15.54551,273944
6735,MattijsKneppers,1,0.00037,42587,15.54588,273944
6736,MattKotsenas,1,0.00037,42588,15.54624,273944
6737,mattlubner,1,0.00037,42589,15.54661,273944
6738,MattMcFarland,1,0.00037,42590,15.54697,273944
6739,mattnelson,1,0.00037,42591,15.54734,273944
6740,mattpwhite,1,0.00037,42592,15.54770,273944
6741,MattSturgeon,1,0.00037,42593,15.54807,273944
6742,matt-thomson,1,0.00037,42594,15.54843,273944
6743,mauricedb,1,0.00037,42595,15.54880,273944
6744,maxd,1,0.00037,42596,15.54916,273944
6745,MaxHorstmann,1,0.00037,42597,15.54953,273944
6746,MaximAbramchuck,1,0.00037,42598,15.54989,273944
6747,maximandrews,1,0.00037,42599,15.55026,273944
6748,maximelafarie,1,0.00037,42600,15.55062,273944
6749,maximevaly,1,0.00037,42601,15.55099,273944
6750,maximgatilin,1,0.00037,42602,15.55135,273944
6751,maxisam,1,0.00037,42603,15.55172,273944
6752,maxjoehnk,1,0.00037,42604,15.55208,273944
6753,maxkoryukov,1,0.00037,42605,15.55245,273944
6754,maxkostow,1,0.00037,42606,15.55281,273944
6755,MaxMommersteeg,1,0.00037,42607,15.55318,273944
6756,Max-Moro,1,0.00037,42608,15.55354,273944
6757,max-mykhailenko,1,0.00037,42609,15.55391,273944
6758,MaxShoshin,1,0.00037,42610,15.55427,273944
6759,maxthyen,1,0.00037,42611,15.55464,273944
6760,maxweldsouza,1,0.00037,42612,15.55500,273944
6761,Mazuh,1,0.00037,42613,15.55537,273944
6762,mbad0la,1,0.00037,42614,15.55573,273944
6763,mborst,1,0.00037,42615,15.55610,273944
6764,mbusso,1,0.00037,42616,15.55646,273944
6765,mcauser,1,0.00037,42617,15.55683,273944
6766,MCAxiaz,1,0.00037,42618,15.55719,273944
6767,mccbraxton,1,0.00037,42619,15.55756,273944
6768,mcgraphix,1,0.00037,42620,15.55792,273944
6769,mches,1,0.00037,42621,15.55829,273944
6770,mciezadlo,1,0.00037,42622,15.55865,273944
6771,mcintdan,1,0.00037,42623,15.55902,273944
6772,mcjlnrtwcz,1,0.00037,42624,15.55938,273944
6773,mcobrien,1,0.00037,42625,15.55975,273944
6774,mdaverde,1,0.00037,42626,15.56011,273944
6775,mderriey,1,0.00037,42627,15.56048,273944
6776,mdisg,1,0.00037,42628,15.56084,273944
6777,mdogadailo,1,0.00037,42629,15.56121,273944
6778,mduu,1,0.00037,42630,15.56157,273944
6779,me89,1,0.00037,42631,15.56194,273944
6780,mechpen,1,0.00037,42632,15.56230,273944
6781,medanat,1,0.00037,42633,15.56267,273944
6782,mehcode,1,0.00037,42634,15.56303,273944
6783,mehrabisajad,1,0.00037,42635,15.56340,273944
6784,meletisf,1,0.00037,42636,15.56376,273944
6785,melezov,1,0.00037,42637,15.56413,273944
6786,melloware,1,0.00037,42638,15.56449,273944
6787,melnikov-s,1,0.00037,42639,15.56486,273944
6788,melquiadess,1,0.00037,42640,15.56523,273944
6789,melvin0008,1,0.00037,42641,15.56559,273944
6790,memoryhole,1,0.00037,42642,15.56596,273944
6791,mempf,1,0.00037,42643,15.56632,273944
6792,mergebandit,1,0.00037,42644,15.56669,273944
6793,merriam,1,0.00037,42645,15.56705,273944
6794,mesaugat,1,0.00037,42646,15.56742,273944
6795,mestremuten,1,0.00037,42647,15.56778,273944
6796,meteorlxy,1,0.00037,42648,15.56815,273944
6797,meyertee,1,0.00037,42649,15.56851,273944
6798,mgalante,1,0.00037,42650,15.56888,273944
6799,mgilson,1,0.00037,42651,15.56924,273944
6800,mgorabbani,1,0.00037,42652,15.56961,273944
6801,mhassan1,1,0.00037,42653,15.56997,273944
6802,mh-cbon,1,0.00037,42654,15.57034,273944
6803,mholo65,1,0.00037,42655,15.57070,273944
6804,micha149,1,0.00037,42656,15.57107,273944
6805,Michael77,1,0.00037,42657,15.57143,273944
6806,michaelbjames,1,0.00037,42658,15.57180,273944
6807,MichaelBuerge,1,0.00037,42659,15.57216,273944
6808,michaelcheng924,1,0.00037,42660,15.57253,273944
6809,MichaelEvans,1,0.00037,42661,15.57289,273944
6810,MichaelFoss,1,0.00037,42662,15.57326,273944
6811,michaelhixson,1,0.00037,42663,15.57362,273944
6812,michaelhofer,1,0.00037,42664,15.57399,273944
6813,michaelhofer-slg,1,0.00037,42665,15.57435,273944
6814,michaeljota,1,0.00037,42666,15.57472,273944
6815,michaellieberherr,1,0.00037,42667,15.57508,273944
6816,michaellieberherrr,1,0.00037,42668,15.57545,273944
6817,michaelpg,1,0.00037,42669,15.57581,273944
6818,michaelpigg,1,0.00037,42670,15.57618,273944
6819,michaelsavich,1,0.00037,42671,15.57654,273944
6820,michaelthe,1,0.00037,42672,15.57691,273944
6821,MichaReiser,1,0.00037,42673,15.57727,273944
6822,michastreppel,1,0.00037,42674,15.57764,273944
6823,michelsalib,1,0.00037,42675,15.57800,273944
6824,michi84o,1,0.00037,42676,15.57837,273944
6825,Mickael-van-der-Beek,1,0.00037,42677,15.57873,273944
6826,miestasmia,1,0.00037,42678,15.57910,273944
6827,migg24,1,0.00037,42679,15.57946,273944
6828,MiguelCastillo,1,0.00037,42680,15.57983,273944
6829,migueldeicaza,1,0.00037,42681,15.58019,273944
6830,migueloller,1,0.00037,42682,15.58056,273944
6831,MihaiB,1,0.00037,42683,15.58092,273944
6832,mihailik,1,0.00037,42684,15.58129,273944
6833,Miha-x64,1,0.00037,42685,15.58165,273944
6834,MihaZupan,1,0.00037,42686,15.58202,273944
6835,Mik13,1,0.00037,42687,15.58238,273944
6836,MikailBag,1,0.00037,42688,15.58275,273944
6837,Mike96Angelo,1,0.00037,42689,15.58311,273944
6838,MikeFH,1,0.00037,42690,15.58348,273944
6839,mikelseverson,1,0.00037,42691,15.58384,273944
6840,mikemaccana,1,0.00037,42692,15.58421,273944
6841,mikenikles,1,0.00037,42693,15.58457,273944
6842,mikeparas,1,0.00037,42694,15.58494,273944
6843,MikePopoloski,1,0.00037,42695,15.58530,273944
6844,MikeRogers0,1,0.00037,42696,15.58567,273944
6845,MikeRyanDev,1,0.00037,42697,15.58603,273944
6846,miketaylr,1,0.00037,42698,15.58640,273944
6847,MikevanDongen,1,0.00037,42699,15.58676,273944
6848,mike-weshop,1,0.00037,42700,15.58713,273944
6849,mikexstudios,1,0.00037,42701,15.58749,273944
6850,mikeybyker,1,0.00037,42702,15.58786,273944
6851,mikhailshilkov,1,0.00037,42703,15.58822,273944
6852,mikrofusion,1,0.00037,42704,15.58859,273944
6853,miksh7,1,0.00037,42705,15.58895,273944
6854,mildis,1,0.00037,42706,15.58932,273944
6855,milesthedisch,1,0.00037,42707,15.58968,273944
6856,milk54,1,0.00037,42708,15.59005,273944
6857,milosprv,1,0.00037,42709,15.59041,273944
6858,miloush,1,0.00037,42710,15.59078,273944
6859,MiltonAkash,1,0.00037,42711,15.59114,273944
6860,Mindstormer619,1,0.00037,42712,15.59151,273944
6861,MingYinLv,1,0.00037,42713,15.59187,273944
6862,MinhNguyenDev,1,0.00037,42714,15.59224,273944
6863,minho42,1,0.00037,42715,15.59260,273944
6864,MiniGod,1,0.00037,42716,15.59297,273944
6865,mips-r6,1,0.00037,42717,15.59333,273944
6866,mirekfranc,1,0.00037,42718,15.59370,273944
6867,mirhagk,1,0.00037,42719,15.59406,273944
6868,mirkods,1,0.00037,42720,15.59443,273944
6869,miserylee,1,0.00037,42721,15.59479,273944
6870,mismith,1,0.00037,42722,15.59516,273944
6871,misogl,1,0.00037,42723,15.59552,273944
6872,miteshaghera,1,0.00037,42724,15.59589,273944
6873,miteshvmehta,1,0.00037,42725,15.59625,273944
6874,mitranim,1,0.00037,42726,15.59662,273944
6875,mittcoats,1,0.00037,42727,15.59698,273944
6876,mjawulski,1,0.00037,42728,15.59735,273944
6877,mjedrzejek,1,0.00037,42729,15.59771,273944
6878,mjesun,1,0.00037,42730,15.59808,273944
6879,mjgs,1,0.00037,42731,15.59844,273944
6880,mjhasbach,1,0.00037,42732,15.59881,273944
6881,mjpieters,1,0.00037,42733,15.59917,273944
6882,mjw56,1,0.00037,42734,15.59954,273944
6883,mkantor,1,0.00037,42735,15.59990,273944
6884,mkawalec,1,0.00037,42736,15.60027,273944
6885,mkborg,1,0.00037,42737,15.60063,273944
6886,mkell85,1,0.00037,42738,15.60100,273944
6887,mkennedy3000,1,0.00037,42739,15.60136,273944
6888,mking,1,0.00037,42740,15.60173,273944
6889,mklement0,1,0.00037,42741,15.60209,273944
6890,mkokho,1,0.00037,42742,15.60246,273944
6891,mkupiniak,1,0.00037,42743,15.60282,273944
6892,mlacouture,1,0.00037,42744,15.60319,273944
6893,mleibman,1,0.00037,42745,15.60355,273944
6894,mlewand,1,0.00037,42746,15.60392,273944
6895,mlissner,1,0.00037,42747,15.60428,273944
6896,mlostekk,1,0.00037,42748,15.60465,273944
6897,mmedal,1,0.00037,42749,15.60501,273944
6898,mmimica,1,0.00037,42750,15.60538,273944
6899,mminer,1,0.00037,42751,15.60574,273944
6900,mmis1000,1,0.00037,42752,15.60611,273944
6901,mmorearty,1,0.00037,42753,15.60647,273944
6902,mmoss,1,0.00037,42754,15.60684,273944
6903,mmynsted,1,0.00037,42755,15.60720,273944
6904,mnahkies,1,0.00037,42756,15.60757,273944
6905,mnmtanish,1,0.00037,42757,15.60793,273944
6906,mnpenner,1,0.00037,42758,15.60830,273944
6907,mnutt,1,0.00037,42759,15.60866,273944
6908,mo,1,0.00037,42760,15.60903,273944
6909,modernlegend,1,0.00037,42761,15.60939,273944
6910,MoenCertiK,1,0.00037,42762,15.60976,273944
6911,Moeriki,1,0.00037,42763,15.61012,273944
6912,mohamed-ismat,1,0.00037,42764,15.61049,273944
6913,mohan-mu,1,0.00037,42765,15.61085,273944
6914,Mohit21GoJs,1,0.00037,42766,15.61122,273944
6915,mohitchugh,1,0.00037,42767,15.61158,273944
6916,mohnmu,1,0.00037,42768,15.61195,273944
6917,mohuk,1,0.00037,42769,15.61231,273944
6918,moismat,1,0.00037,42770,15.61268,273944
6919,mondaychen,1,0.00037,42771,15.61305,273944
6920,monkeym4ster,1,0.00037,42772,15.61341,273944
6921,MoonBall,1,0.00037,42773,15.61378,273944
6922,morchard,1,0.00037,42774,15.61414,273944
6923,Morhaus,1,0.00037,42775,15.61451,273944
6924,Moriadry,1,0.00037,42776,15.61487,273944
6925,morishitter,1,0.00037,42777,15.61524,273944
6926,morningmemo,1,0.00037,42778,15.61560,273944
6927,morsdyce,1,0.00037,42779,15.61597,273944
6928,MosheZemah,1,0.00037,42780,15.61633,273944
6929,mostwired,1,0.00037,42781,15.61670,273944
6930,motet-a,1,0.00037,42782,15.61706,273944
6931,motlin,1,0.00037,42783,15.61743,273944
6932,mouadennaciri,1,0.00037,42784,15.61779,273944
6933,mourawaldson,1,0.00037,42785,15.61816,273944
6934,MouriNaruto,1,0.00037,42786,15.61852,273944
6935,Mozilla-GitHub-Standards,1,0.00037,42787,15.61889,273944
6936,mpabst,1,0.00037,42788,15.61925,273944
6937,mpccolorado,1,0.00037,42789,15.61962,273944
6938,Mpdreamz,1,0.00037,42790,15.61998,273944
6939,mperham,1,0.00037,42791,15.62035,273944
6940,m-przybylski,1,0.00037,42792,15.62071,273944
6941,mrac,1,0.00037,42793,15.62108,273944
6942,mrbar42,1,0.00037,42794,15.62144,273944
6943,MrDesjardins,1,0.00037,42795,15.62181,273944
6944,mrdoob,1,0.00037,42796,15.62217,273944
6945,mrjgreen,1,0.00037,42797,15.62254,273944
6946,mr-july,1,0.00037,42798,15.62290,273944
6947,mrkev,1,0.00037,42799,15.62327,273944
6948,mrngoitall,1,0.00037,42800,15.62363,273944
6949,mrohr,1,0.00037,42801,15.62400,273944
6950,mr-yamraj,1,0.00037,42802,15.62436,273944
6951,MSaifAsif,1,0.00037,42803,15.62473,273944
6952,msal4,1,0.00037,42804,15.62509,273944
6953,msebire,1,0.00037,42805,15.62546,273944
6954,msemtd,1,0.00037,42806,15.62582,273944
6955,mshaaban088,1,0.00037,42807,15.62619,273944
6956,mshibuya,1,0.00037,42808,15.62655,273944
6957,msmshazan,1,0.00037,42809,15.62692,273944
6958,msrose,1,0.00037,42810,15.62728,273944
6959,msteiger,1,0.00037,42811,15.62765,273944
6960,mstone6769,1,0.00037,42812,15.62801,273944
6961,mtone,1,0.00037,42813,15.62838,273944
6962,mtotoWamkwe,1,0.00037,42814,15.62874,273944
6963,mtpetros,1,0.00037,42815,15.62911,273944
6964,MuhanZou,1,0.00037,42816,15.62947,273944
6965,multicolaure,1,0.00037,42817,15.62984,273944
6966,munificent,1,0.00037,42818,15.63020,273944
6967,munro,1,0.00037,42819,15.63057,273944
6968,murillo128,1,0.00037,42820,15.63093,273944
6969,mvasin,1,0.00037,42821,15.63130,273944
6970,mvdnbrk,1,0.00037,42822,15.63166,273944
6971,mvila,1,0.00037,42823,15.63203,273944
6972,mvitz,1,0.00037,42824,15.63239,273944
6973,MWGitHub,1,0.00037,42825,15.63276,273944
6974,mwiencek,1,0.00037,42826,15.63312,273944
6975,m-wilczynski,1,0.00037,42827,15.63349,273944
6976,mwindle,1,0.00037,42828,15.63385,273944
6977,mwittig,1,0.00037,42829,15.63422,273944
6978,mxlbzn,1,0.00037,42830,15.63458,273944
6979,mxviteri,1,0.00037,42831,15.63495,273944
6980,mydea,1,0.00037,42832,15.63531,273944
6981,MYDIH,1,0.00037,42833,15.63568,273944
6982,mykhal,1,0.00037,42834,15.63604,273944
6983,mymattcarroll,1,0.00037,42835,15.63641,273944
6984,myshov,1,0.00037,42836,15.63677,273944
6985,mytuny,1,0.00037,42837,15.63714,273944
6986,mziwisky,1,0.00037,42838,15.63750,273944
6987,mzlee,1,0.00037,42839,15.63787,273944
6988,n0nick,1,0.00037,42840,15.63823,273944
6989,n1c,1,0.00037,42841,15.63860,273944
6990,n1ru4l,1,0.00037,42842,15.63896,273944
6991,nabeelvalley,1,0.00037,42843,15.63933,273944
6992,nacimgoura,1,0.00037,42844,15.63969,273944
6993,nadavkaner,1,0.00037,42845,15.64006,273944
6994,nadavsinai,1,0.00037,42846,15.64042,273944
6995,nadavwe,1,0.00037,42847,15.64079,273944
6996,naicko,1,0.00037,42848,15.64115,273944
6997,naistran,1,0.00037,42849,15.64152,273944
6998,nakazye,1,0.00037,42850,15.64188,273944
6999,nallar,1,0.00037,42851,15.64225,273944
7000,nallwhy,1,0.00037,42852,15.64261,273944
7001,namannigam,1,0.00037,42853,15.64298,273944
7002,nanonyme,1,0.00037,42854,15.64334,273944
7003,naoufal,1,0.00037,42855,15.64371,273944
7004,narainsagar,1,0.00037,42856,15.64407,273944
7005,natec8,1,0.00037,42857,15.64444,273944
7006,natejlee,1,0.00037,42858,15.64480,273944
7007,natenorberg,1,0.00037,42859,15.64517,273944
7008,nathanpower,1,0.00037,42860,15.64553,273944
7009,Natim,1,0.00037,42861,15.64590,273944
7010,natsid,1,0.00037,42862,15.64626,273944
7011,natsuhikok,1,0.00037,42863,15.64663,273944
7012,Nautigsam,1,0.00037,42864,15.64699,273944
7013,navarroaxel,1,0.00037,42865,15.64736,273944
7014,nazrhyn,1,0.00037,42866,15.64772,273944
7015,nbarbettini,1,0.00037,42867,15.64809,273944
7016,nbaztec,1,0.00037,42868,15.64845,273944
7017,nbjahan,1,0.00037,42869,15.64882,273944
7018,nbougalis,1,0.00037,42870,15.64918,273944
7019,nbsaw,1,0.00037,42871,15.64955,273944
7020,ncoghlan,1,0.00037,42872,15.64991,273944
7021,ndresx,1,0.00037,42873,15.65028,273944
7022,Ne4istb,1,0.00037,42874,15.65064,273944
7023,Neamar,1,0.00037,42875,15.65101,273944
7024,Neaox,1,0.00037,42876,15.65137,273944
7025,neeldeep,1,0.00037,42877,15.65174,273944
7026,negezor,1,0.00037,42878,15.65210,273944
7027,neighbads,1,0.00037,42879,15.65247,273944
7028,neoziro,1,0.00037,42880,15.65283,273944
7029,nerfologist,1,0.00037,42881,15.65320,273944
7030,nescalante,1,0.00037,42882,15.65356,273944
7031,netil,1,0.00037,42883,15.65393,273944
7032,Nettsentrisk,1,0.00037,42884,15.65429,273944
7033,neu5,1,0.00037,42885,15.65466,273944
7034,neuralsandwich,1,0.00037,42886,15.65502,273944
7035,Nevaan,1,0.00037,42887,15.65539,273944
7036,newyork-anthonyng,1,0.00037,42888,15.65575,273944
7037,Nexeuz,1,0.00037,42889,15.65612,273944
7038,neytema,1,0.00037,42890,15.65648,273944
7039,nfer,1,0.00037,42891,15.65685,273944
7040,nfriedly,1,0.00037,42892,15.65721,273944
7041,nfroidure,1,0.00037,42893,15.65758,273944
7042,ngfelixl,1,0.00037,42894,15.65794,273944
7043,ngryman,1,0.00037,42895,15.65831,273944
7044,NhatDinh,1,0.00037,42896,15.65867,273944
7045,nhduc296,1,0.00037,42897,15.65904,273944
7046,nhducit,1,0.00037,42898,15.65940,273944
7047,nhydock,1,0.00037,42899,15.65977,273944
7048,nibblebot,1,0.00037,42900,15.66013,273944
7049,Nicholas-Eng,1,0.00037,42901,15.66050,273944
7050,nicholasserra,1,0.00037,42902,15.66086,273944
7051,nickbalestra,1,0.00037,42903,15.66123,273944
7052,NickCraver,1,0.00037,42904,15.66160,273944
7053,nickdandakis,1,0.00037,42905,15.66196,273944
7054,nickknissen,1,0.00037,42906,15.66233,273944
7055,nickmessing,1,0.00037,42907,15.66269,273944
7056,nickpresta,1,0.00037,42908,15.66306,273944
7057,NickPresta,1,0.00037,42909,15.66342,273944
7058,nickskalkin,1,0.00037,42910,15.66379,273944
7059,nickthetait,1,0.00037,42911,15.66415,273944
7060,nickzelei,1,0.00037,42912,15.66452,273944
7061,NiclasvanEyk,1,0.00037,42913,15.66488,273944
7062,nicoabie,1,0.00037,42914,15.66525,273944
7063,Nicolaidavies,1,0.00037,42915,15.66561,273944
7064,Nicolapps,1,0.00037,42916,15.66598,273944
7065,nicolasbd,1,0.00037,42917,15.66634,273944
7066,nicosommi,1,0.00037,42918,15.66671,273944
7067,nictas,1,0.00037,42919,15.66707,273944
7068,niexias,1,0.00037,42920,15.66744,273944
7069,nigel5,1,0.00037,42921,15.66780,273944
7070,NightElfik,1,0.00037,42922,15.66817,273944
7071,nightshinez,1,0.00037,42923,15.66853,273944
7072,Nikhil22,1,0.00037,42924,15.66890,273944
7073,nikhilpatil,1,0.00037,42925,15.66926,273944
7074,niklas-dahl,1,0.00037,42926,15.66963,273944
7075,NikosKeyz,1,0.00037,42927,15.66999,273944
7076,NikV,1,0.00037,42928,15.67036,273944
7077,nil4,1,0.00037,42929,15.67072,273944
7078,niloc132,1,0.00037,42930,15.67109,273944
7079,nilsceberg,1,0.00037,42931,15.67145,273944
7080,niltoncsr,1,0.00037,42932,15.67182,273944
7081,Nimelrian,1,0.00037,42933,15.67218,273944
7082,nimerritt,1,0.00037,42934,15.67255,273944
7083,nimish,1,0.00037,42935,15.67291,273944
7084,niole,1,0.00037,42936,15.67328,273944
7085,nishp1,1,0.00037,42937,15.67364,273944
7086,nivs,1,0.00037,42938,15.67401,273944
7087,njb-said,1,0.00037,42939,15.67437,273944
7088,nknapp,1,0.00037,42940,15.67474,273944
7089,nkollar,1,0.00037,42941,15.67510,273944
7090,nkt,1,0.00037,42942,15.67547,273944
7091,nkzawa,1,0.00037,42943,15.67583,273944
7092,nlouahedj,1,0.00037,42944,15.67620,273944
7093,nmav,1,0.00037,42945,15.67656,273944
7094,nmn,1,0.00037,42946,15.67693,273944
7095,nmschulte,1,0.00037,42947,15.67729,273944
7096,nnuggets,1,0.00037,42948,15.67766,273944
7097,nobezawa,1,0.00037,42949,15.67802,273944
7098,NobodysNightmare,1,0.00037,42950,15.67839,273944
7099,NogsMPLS,1,0.00037,42951,15.67875,273944
7100,NoHomey,1,0.00037,42952,15.67912,273944
7101,Noitidart,1,0.00037,42953,15.67948,273944
7102,Nolanus,1,0.00037,42954,15.67985,273944
7103,NomadBlacky,1,0.00037,42955,15.68021,273944
7104,nomadster,1,0.00037,42956,15.68058,273944
7105,noodleswww,1,0.00037,42957,15.68094,273944
7106,noopur-tiwari,1,0.00037,42958,15.68131,273944
7107,nordligulv,1,0.00037,42959,15.68167,273944
7108,nornagon,1,0.00037,42960,15.68204,273944
7109,noseglid,1,0.00037,42961,15.68240,273944
7110,nOstap,1,0.00037,42962,15.68277,273944
7111,nottrobin,1,0.00037,42963,15.68313,273944
7112,noumaans,1,0.00037,42964,15.68350,273944
7113,now-raymond,1,0.00037,42965,15.68386,273944
7114,noyesa,1,0.00037,42966,15.68423,273944
7115,noyobo,1,0.00037,42967,15.68459,273944
7116,nrinaudo,1,0.00037,42968,15.68496,273944
7117,nscornia,1,0.00037,42969,15.68532,273944
7118,nsoranzo,1,0.00037,42970,15.68569,273944
7119,nstanard,1,0.00037,42971,15.68605,273944
7120,nstraub,1,0.00037,42972,15.68642,273944
7121,nthcircle,1,0.00037,42973,15.68678,273944
7122,ntherning,1,0.00037,42974,15.68715,273944
7123,nuessgens,1,0.00037,42975,15.68751,273944
7124,NukaPunk,1,0.00037,42976,15.68788,273944
7125,nullvariable,1,0.00037,42977,15.68824,273944
7126,numb86,1,0.00037,42978,15.68861,273944
7127,nurkiewicz,1,0.00037,42979,15.68897,273944
7128,NuSkooler,1,0.00037,42980,15.68934,273944
7129,nusretparlak,1,0.00037,42981,15.68970,273944
7130,NV4RE,1,0.00037,42982,15.69007,273944
7131,nvdh,1,0.00037,42983,15.69043,273944
7132,nwhittaker,1,0.00037,42984,15.69080,273944
7133,nxtstep,1,0.00037,42985,15.69116,273944
7134,nykolaslima,1,0.00037,42986,15.69153,273944
7135,nyurik,1,0.00037,42987,15.69189,273944
7136,oakfang,1,0.00037,42988,15.69226,273944
7137,oburakevych,1,0.00037,42989,15.69262,273944
7138,oconn,1,0.00037,42990,15.69299,273944
7139,oddsson,1,0.00037,42991,15.69335,273944
7140,odersky,1,0.00037,42992,15.69372,273944
7141,odykyi,1,0.00037,42993,15.69408,273944
7142,odysseuscm,1,0.00037,42994,15.69445,273944
7143,odyth,1,0.00037,42995,15.69481,273944
7144,odziem,1,0.00037,42996,15.69518,273944
7145,ofirmakmal,1,0.00037,42997,15.69554,273944
7146,ogix,1,0.00037,42998,15.69591,273944
7147,Oire,1,0.00037,42999,15.69627,273944
7148,okdistribute,1,0.00037,43000,15.69664,273944
7149,okonet,1,0.00037,43001,15.69700,273944
7150,oktav777,1,0.00037,43002,15.69737,273944
7151,Olafski,1,0.00037,43003,15.69773,273944
7152,oldj,1,0.00037,43004,15.69810,273944
7153,olegafx,1,0.00037,43005,15.69846,273944
7154,olehsrh,1,0.00037,43006,15.69883,273944
7155,OleksiiBondar,1,0.00037,43007,15.69919,273944
7156,Olivier-Moreau,1,0.00037,43008,15.69956,273944
7157,oluckyman,1,0.00037,43009,15.69992,273944
7158,omerson,1,0.00037,43010,15.70029,273944
7159,omnichronous,1,0.00037,43011,15.70065,273944
7160,ompraash,1,0.00037,43012,15.70102,273944
7161,oneam,1,0.00037,43013,15.70138,273944
7162,onlywei,1,0.00037,43014,15.70175,273944
7163,onstash,1,0.00037,43015,15.70211,273944
7164,oocx,1,0.00037,43016,15.70248,273944
7165,oorijsonar,1,0.00037,43017,15.70284,273944
7166,opensignature,1,0.00037,43018,15.70321,273944
7167,opensrcery,1,0.00037,43019,15.70357,273944
7168,oporko,1,0.00037,43020,15.70394,273944
7169,Opticsponge,1,0.00037,43021,15.70430,273944
7170,ORdinarycas,1,0.00037,43022,15.70467,273944
7171,oreissig,1,0.00037,43023,15.70503,273944
7172,osamaq,1,0.00037,43024,15.70540,273944
7173,oscarlvp,1,0.00037,43025,15.70576,273944
7174,oscarotero,1,0.00037,43026,15.70613,273944
7175,Oseenix,1,0.00037,43027,15.70649,273944
7176,osman-turan,1,0.00037,43028,15.70686,273944
7177,ossdev07,1,0.00037,43029,15.70722,273944
7178,oughter,1,0.00037,43030,15.70759,273944
7179,ouq77,1,0.00037,43031,15.70795,273944
7180,outofambit,1,0.00037,43032,15.70832,273944
7181,outofgamut,1,0.00037,43033,15.70868,273944
7182,outspace,1,0.00037,43034,15.70905,273944
7183,overridesh,1,0.00037,43035,15.70942,273944
7184,ovpv,1,0.00037,43036,15.70978,273944
7185,Ovyerus,1,0.00037,43037,15.71015,273944
7186,owap,1,0.00037,43038,15.71051,273944
7187,owenconti,1,0.00037,43039,15.71088,273944
7188,paambaati,1,0.00037,43040,15.71124,273944
7189,pablofmena,1,0.00037,43041,15.71161,273944
7190,pablotarga,1,0.00037,43042,15.71197,273944
7191,packtpartner,1,0.00037,43043,15.71234,273944
7192,Page-,1,0.00037,43044,15.71270,273944
7193,Page-Not-Found,1,0.00037,43045,15.71307,273944
7194,pahomov,1,0.00037,43046,15.71343,273944
7195,PaitoAnderson,1,0.00037,43047,15.71380,273944
7196,paladox2015,1,0.00037,43048,15.71416,273944
7197,palek,1,0.00037,43049,15.71453,273944
7198,panckreous,1,0.00037,43050,15.71489,273944
7199,pandrushka,1,0.00037,43051,15.71526,273944
7200,panzj,1,0.00037,43052,15.71562,273944
7201,papb,1,0.00037,43053,15.71599,273944
7202,Paradox41,1,0.00037,43054,15.71635,273944
7203,paragi,1,0.00037,43055,15.71672,273944
7204,Parcley,1,0.00037,43056,15.71708,273944
7205,paroga,1,0.00037,43057,15.71745,273944
7206,parrainc,1,0.00037,43058,15.71781,273944
7207,parse,1,0.00037,43059,15.71818,273944
7208,passaro,1,0.00037,43060,15.71854,273944
7209,pataar,1,0.00037,43061,15.71891,273944
7210,pathikrit,1,0.00037,43062,15.71927,273944
7211,patik,1,0.00037,43063,15.71964,273944
7212,patrickcjh,1,0.00037,43064,15.72000,273944
7213,patrickmcd,1,0.00037,43065,15.72037,273944
7214,PatrickMcDonald,1,0.00037,43066,15.72073,273944
7215,patriksimek,1,0.00037,43067,15.72110,273944
7216,patriksvensson,1,0.00037,43068,15.72146,273944
7217,patsplat,1,0.00037,43069,15.72183,273944
7218,paul1956,1,0.00037,43070,15.72219,273944
7219,pauldraper,1,0.00037,43071,15.72256,273944
7220,paulirwin,1,0.00037,43072,15.72292,273944
7221,paulkass,1,0.00037,43073,15.72329,273944
7222,paulmanta,1,0.00037,43074,15.72365,273944
7223,paulmelnikow,1,0.00037,43075,15.72402,273944
7224,paulomcnally,1,0.00037,43076,15.72438,273944
7225,paulovieira,1,0.00037,43077,15.72475,273944
7226,paulp,1,0.00037,43078,15.72511,273944
7227,paulradzkov,1,0.00037,43079,15.72548,273944
7228,PaulRBerg,1,0.00037,43080,15.72584,273944
7229,paulshen,1,0.00037,43081,15.72621,273944
7230,paustria,1,0.00037,43082,15.72657,273944
7231,pavel-agarkov,1,0.00037,43083,15.72694,273944
7232,Pawel-Janik,1,0.00037,43084,15.72730,273944
7233,paxl13,1,0.00037,43085,15.72767,273944
7234,Paxxi,1,0.00037,43086,15.72803,273944
7235,paynoattn,1,0.00037,43087,15.72840,273944
7236,pazguille,1,0.00037,43088,15.72876,273944
7237,pcornelissen,1,0.00037,43089,15.72913,273944
7238,pdiniz13,1,0.00037,43090,15.72949,273944
7239,peabnuts123,1,0.00037,43091,15.72986,273944
7240,pearcemerritt,1,0.00037,43092,15.73022,273944
7241,PedroMiguelSS,1,0.00037,43093,15.73059,273944
7242,pedronauck,1,0.00037,43094,15.73095,273944
7243,pedroprado010,1,0.00037,43095,15.73132,273944
7244,pedrouid,1,0.00037,43096,15.73168,273944
7245,pegurnee,1,0.00037,43097,15.73205,273944
7246,peitek,1,0.00037,43098,15.73241,273944
7247,pekeq,1,0.00037,43099,15.73278,273944
7248,peleghila,1,0.00037,43100,15.73314,273944
7249,peltco,1,0.00037,43101,15.73351,273944
7250,pensivebrian,1,0.00037,43102,15.73387,273944
7251,Pephers,1,0.00037,43103,15.73424,273944
7252,peplin,1,0.00037,43104,15.73460,273944
7253,pepone,1,0.00037,43105,15.73497,273944
7254,perceptron8,1,0.00037,43106,15.73533,273944
7255,PerfectPixel,1,0.00037,43107,15.73570,273944
7256,peritpatrio,1,0.00037,43108,15.73606,273944
7257,petarpetrovt,1,0.00037,43109,15.73643,273944
7258,peteboere,1,0.00037,43110,15.73679,273944
7259,petehunt,1,0.00037,43111,15.73716,273944
7260,peterdettman,1,0.00037,43112,15.73752,273944
7261,peteretelej,1,0.00037,43113,15.73789,273944
7262,PeterHatch,1,0.00037,43114,15.73825,273944
7263,peterhpchen,1,0.00037,43115,15.73862,273944
7264,peterjmag,1,0.00037,43116,15.73898,273944
7265,peter-kehl,1,0.00037,43117,15.73935,273944
7266,peterlenagh,1,0.00037,43118,15.73971,273944
7267,Peter-Liang,1,0.00037,43119,15.74008,273944
7268,petermbenjamin,1,0.00037,43120,15.74044,273944
7269,petermikitsh,1,0.00037,43121,15.74081,273944
7270,PeterMosmans,1,0.00037,43122,15.74117,273944
7271,peterthompson,1,0.00037,43123,15.74154,273944
7272,peterwurzinger,1,0.00037,43124,15.74190,273944
7273,petvas,1,0.00037,43125,15.74227,273944
7274,PezCoder,1,0.00037,43126,15.74263,273944
7275,pfcoperez,1,0.00037,43127,15.74300,273944
7276,pfhayes,1,0.00037,43128,15.74336,273944
7277,pfitzsimons-r7,1,0.00037,43129,15.74373,273944
7278,pgonzal,1,0.00037,43130,15.74409,273944
7279,phanning,1,0.00037,43131,15.74446,273944
7280,phenomnomnominal,1,0.00037,43132,15.74482,273944
7281,philfreo,1,0.00037,43133,15.74519,273944
7282,philipa,1,0.00037,43134,15.74555,273944
7283,philipbordallo,1,0.00037,43135,15.74592,273944
7284,Philipp91,1,0.00037,43136,15.74628,273944
7285,philippgille,1,0.00037,43137,15.74665,273944
7286,philipschwarz,1,0.00037,43138,15.74701,273944
7287,philjohnson789,1,0.00037,43139,15.74738,273944
7288,philleonard,1,0.00037,43140,15.74774,273944
7289,phillipj,1,0.00037,43141,15.74811,273944
7290,phillipsj,1,0.00037,43142,15.74847,273944
7291,philraj,1,0.00037,43143,15.74884,273944
7292,phoenixbox,1,0.00037,43144,15.74920,273944
7293,phurytw,1,0.00037,43145,15.74957,273944
7294,pi0,1,0.00037,43146,15.74993,273944
7295,picapixa,1,0.00037,43147,15.75030,273944
7296,Piccirello,1,0.00037,43148,15.75066,273944
7297,PiDelport,1,0.00037,43149,15.75103,273944
7298,pietvandongen,1,0.00037,43150,15.75139,273944
7299,pigelvy,1,0.00037,43151,15.75176,273944
7300,Pilchie,1,0.00037,43152,15.75212,273944
7301,pimverkerk,1,0.00037,43153,15.75249,273944
7302,pine3ree,1,0.00037,43154,15.75285,273944
7303,pingan1927,1,0.00037,43155,15.75322,273944
7304,pingfengafei,1,0.00037,43156,15.75358,273944
7305,pinyin,1,0.00037,43157,15.75395,273944
7306,piotrjurkiewicz,1,0.00037,43158,15.75431,273944
7307,PiotrKlecha,1,0.00037,43159,15.75468,273944
7308,piotros,1,0.00037,43160,15.75504,273944
7309,piotrturski,1,0.00037,43161,15.75541,273944
7310,piranna,1,0.00037,43162,15.75577,273944
7311,pirate,1,0.00037,43163,15.75614,273944
7312,pirxpilot,1,0.00037,43164,15.75650,273944
7313,pischke,1,0.00037,43165,15.75687,273944
7314,piyush-jaiswal,1,0.00037,43166,15.75724,273944
7315,p-jackson,1,0.00037,43167,15.75760,273944
7316,pjbgf,1,0.00037,43168,15.75797,273944
7317,pjhjohn,1,0.00037,43169,15.75833,273944
7318,pjmonks,1,0.00037,43170,15.75870,273944
7319,PK1A,1,0.00037,43171,15.75906,273944
7320,PKief,1,0.00037,43172,15.75943,273944
7321,pkukol,1,0.00037,43173,15.75979,273944
7322,planser,1,0.00037,43174,15.76016,273944
7323,platinumazure,1,0.00037,43175,15.76052,273944
7324,platosha,1,0.00037,43176,15.76089,273944
7325,pletcher,1,0.00037,43177,15.76125,273944
7326,pleunv,1,0.00037,43178,15.76162,273944
7327,plokhotnyuk,1,0.00037,43179,15.76198,273944
7328,plroebuck,1,0.00037,43180,15.76235,273944
7329,plumpNation,1,0.00037,43181,15.76271,273944
7330,poeschko,1,0.00037,43182,15.76308,273944
7331,Poimen,1,0.00037,43183,15.76344,273944
7332,poislagarde,1,0.00037,43184,15.76381,273944
7333,poldridge,1,0.00037,43185,15.76417,273944
7334,PolinaRodimova,1,0.00037,43186,15.76454,273944
7335,polpo,1,0.00037,43187,15.76490,273944
7336,polybuildr,1,0.00037,43188,15.76527,273944
7337,Ponant,1,0.00037,43189,15.76563,273944
7338,portolucas,1,0.00037,43190,15.76600,273944
7339,postama,1,0.00037,43191,15.76636,273944
7340,posva,1,0.00037,43192,15.76673,273944
7341,potmo,1,0.00037,43193,15.76709,273944
7342,poulad,1,0.00037,43194,15.76746,273944
7343,powens,1,0.00037,43195,15.76782,273944
7344,pranjalk,1,0.00037,43196,15.76819,273944
7345,pratik14,1,0.00037,43197,15.76855,273944
7346,praveenn-vbi,1,0.00037,43198,15.76892,273944
7347,praveenpuglia,1,0.00037,43199,15.76928,273944
7348,prempalsingh,1,0.00037,43200,15.76965,273944
7349,primarilysoftware,1,0.00037,43201,15.77001,273944
7350,PRIMETSS,1,0.00037,43202,15.77038,273944
7351,princemaple,1,0.00037,43203,15.77074,273944
7352,pRizz,1,0.00037,43204,15.77111,273944
7353,probablyup,1,0.00037,43205,15.77147,273944
7354,prodis,1,0.00037,43206,15.77184,273944
7355,proflayton,1,0.00037,43207,15.77220,273944
7356,propensive,1,0.00037,43208,15.77257,273944
7357,proteriax,1,0.00037,43209,15.77293,273944
7358,protyposis,1,0.00037,43210,15.77330,273944
7359,prtksxna,1,0.00037,43211,15.77366,273944
7360,psachs21,1,0.00037,43212,15.77403,273944
7361,psibi,1,0.00037,43213,15.77439,273944
7362,psmyrak,1,0.00037,43214,15.77476,273944
7363,pthong,1,0.00037,43215,15.77512,273944
7364,ptrain,1,0.00037,43216,15.77549,273944
7365,puku0x,1,0.00037,43217,15.77585,273944
7366,pulasthibandara,1,0.00037,43218,15.77622,273944
7367,Punit-wingify,1,0.00037,43219,15.77658,273944
7368,puppybits,1,0.00037,43220,15.77695,273944
7369,PxyUp,1,0.00037,43221,15.77731,273944
7370,pyliaorachel,1,0.00037,43222,15.77768,273944
7371,PyroSA,1,0.00037,43223,15.77804,273944
7372,q1226085152,1,0.00037,43224,15.77841,273944
7373,qas612820704,1,0.00037,43225,15.77877,273944
7374,qerub,1,0.00037,43226,15.77914,273944
7375,qiu8310,1,0.00037,43227,15.77950,273944
7376,qix,1,0.00037,43228,15.77987,273944
7377,qlikTERror,1,0.00037,43229,15.78023,273944
7378,qodesmith,1,0.00037,43230,15.78060,273944
7379,qqbuby,1,0.00037,43231,15.78096,273944
7380,qstearns,1,0.00037,43232,15.78133,273944
7381,quadrupleslap,1,0.00037,43233,15.78169,273944
7382,qubbit,1,0.00037,43234,15.78206,273944
7383,Quogu,1,0.00037,43235,15.78242,273944
7384,QwerMike,1,0.00037,43236,15.78279,273944
7385,qw-in,1,0.00037,43237,15.78315,273944
7386,Qw-in,1,0.00037,43238,15.78352,273944
7387,qwwdfsad,1,0.00037,43239,15.78388,273944
7388,r349,1,0.00037,43240,15.78425,273944
7389,rabryst,1,0.00037,43241,15.78461,273944
7390,radii,1,0.00037,43242,15.78498,273944
7391,radiocane,1,0.00037,43243,15.78534,273944
7392,radiovisual,1,0.00037,43244,15.78571,273944
7393,radotzki,1,0.00037,43245,15.78607,273944
7394,rafaelrenanpacheco,1,0.00037,43246,15.78644,273944
7395,rafaelrpinto,1,0.00037,43247,15.78680,273944
7396,rafaelstz,1,0.00037,43248,15.78717,273944
7397,rafidka,1,0.00037,43249,15.78753,273944
7398,rafrex,1,0.00037,43250,15.78790,273944
7399,ragmani,1,0.00037,43251,15.78826,273944
7400,rajatsehgal,1,0.00037,43252,15.78863,273944
7401,rakudrama,1,0.00037,43253,15.78899,273944
7402,raleksandar,1,0.00037,43254,15.78936,273944
7403,ralinc,1,0.00037,43255,15.78972,273944
7404,Ralith,1,0.00037,43256,15.79009,273944
7405,ralvarezo123,1,0.00037,43257,15.79045,273944
7406,ramaboo,1,0.00037,43258,15.79082,273944
7407,ramiloif,1,0.00037,43259,15.79118,273944
7408,randombk,1,0.00037,43260,15.79155,273944
7409,RandScullard,1,0.00037,43261,15.79191,273944
7410,RaneWallin,1,0.00037,43262,15.79228,273944
7411,Raniz85,1,0.00037,43263,15.79264,273944
7412,Rantanen,1,0.00037,43264,15.79301,273944
7413,Rasulbeeek,1,0.00037,43265,15.79337,273944
7414,ratbeard,1,0.00037,43266,15.79374,273944
7415,ratson,1,0.00037,43267,15.79410,273944
7416,ravensorb,1,0.00037,43268,15.79447,273944
7417,ravihamsa,1,0.00037,43269,15.79483,273944
7418,ravipra,1,0.00037,43270,15.79520,273944
7419,rayhatfield,1,0.00037,43271,15.79556,273944
7420,razfriman,1,0.00037,43272,15.79593,273944
7421,rbergman,1,0.00037,43273,15.79629,273944
7422,RBLU,1,0.00037,43274,15.79666,273944
7423,r-browser-app-team,1,0.00037,43275,15.79702,273944
7424,rcabr,1,0.00037,43276,15.79739,273944
7425,rclai,1,0.00037,43277,15.79775,273944
7426,rclanan,1,0.00037,43278,15.79812,273944
7427,rcmurphy,1,0.00037,43279,15.79848,273944
7428,rcombs,1,0.00037,43280,15.79885,273944
7429,rdahbura,1,0.00037,43281,15.79921,273944
7430,rdela,1,0.00037,43282,15.79958,273944
7431,realbisoye,1,0.00037,43283,15.79994,273944
7432,realityforge,1,0.00037,43284,15.80031,273944
7433,realronchi,1,0.00037,43285,15.80067,273944
7434,red2678,1,0.00037,43286,15.80104,273944
7435,redeyes2015,1,0.00037,43287,15.80140,273944
7436,Redouane64,1,0.00037,43288,15.80177,273944
7437,RedTn,1,0.00037,43289,15.80213,273944
7438,reecefenwick,1,0.00037,43290,15.80250,273944
7439,reedfeng,1,0.00037,43291,15.80286,273944
7440,reinaldoarrosi,1,0.00037,43292,15.80323,273944
7441,reinhapa,1,0.00037,43293,15.80359,273944
7442,Relequestual,1,0.00037,43294,15.80396,273944
7443,rellect,1,0.00037,43295,15.80432,273944
7444,remcoros,1,0.00037,43296,15.80469,273944
7445,RemiBou,1,0.00037,43297,15.80506,273944
7446,remko,1,0.00037,43298,15.80542,273944
7447,renancaraujo,1,0.00037,43299,15.80579,273944
7448,renanpvaz,1,0.00037,43300,15.80615,273944
7449,renanvalentin,1,0.00037,43301,15.80652,273944
7450,renewooller,1,0.00037,43302,15.80688,273944
7451,renjithspace,1,0.00037,43303,15.80725,273944
7452,rentalhost,1,0.00037,43304,15.80761,273944
7453,reviewher,1,0.00037,43305,15.80798,273944
7454,revik,1,0.00037,43306,15.80834,273944
7455,revington,1,0.00037,43307,15.80871,273944
7456,rexxars,1,0.00037,43308,15.80907,273944
7457,rfreydi,1,0.00037,43309,15.80944,273944
7458,rgacogne,1,0.00037,43310,15.80980,273944
7459,rgarcia,1,0.00037,43311,15.81017,273944
7460,rgarifullin,1,0.00037,43312,15.81053,273944
7461,rgeraldporter,1,0.00037,43313,15.81090,273944
7462,rgoldberg,1,0.00037,43314,15.81126,273944
7463,rgoliveira,1,0.00037,43315,15.81163,273944
7464,rgra,1,0.00037,43316,15.81199,273944
7465,rgraffbrd,1,0.00037,43317,15.81236,273944
7466,rhagigi,1,0.00037,43318,15.81272,273944
7467,rhinoxi,1,0.00037,43319,15.81309,273944
7468,rhmoller,1,0.00037,43320,15.81345,273944
7469,rhysmccaig,1,0.00037,43321,15.81382,273944
7470,RIanDeLaCruz,1,0.00037,43322,15.81418,273944
7471,ricardogama,1,0.00037,43323,15.81455,273944
7472,richardfearn,1,0.00037,43324,15.81491,273944
7473,RichardLitt,1,0.00037,43325,15.81528,273944
7474,richardscarrott,1,0.00037,43326,15.81564,273944
7475,RickCraig,1,0.00037,43327,15.81601,273944
7476,ricksbrown,1,0.00037,43328,15.81637,273944
7477,rickyblaha,1,0.00037,43329,15.81674,273944
7478,rickyes,1,0.00037,43330,15.81710,273944
7479,rickyvetter,1,0.00037,43331,15.81747,273944
7480,rigdern,1,0.00037,43332,15.81783,273944
7481,rike422,1,0.00037,43333,15.81820,273944
7482,rise2semi,1,0.00037,43334,15.81856,273944
7483,rishabh-rajgarhia,1,0.00037,43335,15.81893,273944
7484,ritave,1,0.00037,43336,15.81929,273944
7485,riverspirit,1,0.00037,43337,15.81966,273944
7486,rivertam,1,0.00037,43338,15.82002,273944
7487,rjruizes,1,0.00037,43339,15.82039,273944
7488,rjxby,1,0.00037,43340,15.82075,273944
7489,rkusa,1,0.00037,43341,15.82112,273944
7490,rmariuzzo,1,0.00037,43342,15.82148,273944
7491,rmharrison,1,0.00037,43343,15.82185,273944
7492,RMHonor,1,0.00037,43344,15.82221,273944
7493,robahl,1,0.00037,43345,15.82258,273944
7494,robaxelsen,1,0.00037,43346,15.82294,273944
7495,robbiecloset,1,0.00037,43347,15.82331,273944
7496,RobDesideri,1,0.00037,43348,15.82367,273944
7497,robertmirro,1,0.00037,43349,15.82404,273944
7498,RobertRad,1,0.00037,43350,15.82440,273944
7499,RobertSmits,1,0.00037,43351,15.82477,273944
7500,robertswiecki,1,0.00037,43352,15.82513,273944
7501,robertzk,1,0.00037,43353,15.82550,273944
7502,robinkanters,1,0.00037,43354,15.82586,273944
7503,RobinStephenson,1,0.00037,43355,15.82623,273944
7504,roblourens,1,0.00037,43356,15.82659,273944
7505,RoboBurned,1,0.00037,43357,15.82696,273944
7506,robosek,1,0.00037,43358,15.82732,273944
7507,roboshoes,1,0.00037,43359,15.82769,273944
7508,robotdan,1,0.00037,43360,15.82805,273944
7509,RobRuana,1,0.00037,43361,15.82842,273944
7510,RoCat,1,0.00037,43362,15.82878,273944
7511,roccomuso,1,0.00037,43363,15.82915,273944
7512,rochestb,1,0.00037,43364,15.82951,273944
7513,rocketmonkeys,1,0.00037,43365,15.82988,273944
7514,rockymeza,1,0.00037,43366,15.83024,273944
7515,rodrigobdz,1,0.00037,43367,15.83061,273944
7516,RodrigoEspinosa,1,0.00037,43368,15.83097,273944
7517,rodrigopr,1,0.00037,43369,15.83134,273944
7518,roederja2,1,0.00037,43370,15.83170,273944
7519,roger2hk,1,0.00037,43371,15.83207,273944
7520,rolandasb,1,0.00037,43372,15.83243,273944
7521,RolfKoenders,1,0.00037,43373,15.83280,273944
7522,roman01la,1,0.00037,43374,15.83316,273944
7523,roman0yurin,1,0.00037,43375,15.83353,273944
7524,RomanHargrave,1,0.00037,43376,15.83389,273944
7525,RomanHotsiy,1,0.00037,43377,15.83426,273944
7526,roman-mazur,1,0.00037,43378,15.83462,273944
7527,romellogood,1,0.00037,43379,15.83499,273944
7528,romellogoodman,1,0.00037,43380,15.83535,273944
7529,romeovs,1,0.00037,43381,15.83572,273944
7530,RomeroMsk,1,0.00037,43382,15.83608,273944
7531,RonanC,1,0.00037,43383,15.83645,273944
7532,RonanDConnolly,1,0.00037,43384,15.83681,273944
7533,ronanww,1,0.00037,43385,15.83718,273944
7534,ronchifabricio,1,0.00037,43386,15.83754,273944
7535,RonnBlack,1,0.00037,43387,15.83791,273944
7536,rootsher,1,0.00037,43388,15.83827,273944
7537,rose,1,0.00037,43389,15.83864,273944
7538,roseperrone,1,0.00037,43390,15.83900,273944
7539,rossgardt,1,0.00037,43391,15.83937,273944
7540,rossslaney,1,0.00037,43392,15.83973,273944
7541,rostalevicek,1,0.00037,43393,15.84010,273944
7542,rosyatrandom,1,0.00037,43394,15.84046,273944
7543,rouanw,1,0.00037,43395,15.84083,273944
7544,roura356a,1,0.00037,43396,15.84119,273944
7545,rowantran,1,0.00037,43397,15.84156,273944
7546,royipressburger,1,0.00037,43398,15.84192,273944
7547,royling,1,0.00037,43399,15.84229,273944
7548,RoyLING,1,0.00037,43400,15.84265,273944
7549,roymiloh,1,0.00037,43401,15.84302,273944
7550,royteeuwen,1,0.00037,43402,15.84338,273944
7551,rpaterson,1,0.00037,43403,15.84375,273944
7552,rpmcdougall,1,0.00037,43404,15.84411,273944
7553,rpocklin,1,0.00037,43405,15.84448,273944
7554,rpominov,1,0.00037,43406,15.84484,273944
7555,rralian,1,0.00037,43407,15.84521,273944
7556,rreusser,1,0.00037,43408,15.84557,273944
7557,rssteffey,1,0.00037,43409,15.84594,273944
7558,rszalski,1,0.00037,43410,15.84630,273944
7559,rtfpessoa,1,0.00037,43411,15.84667,273944
7560,rtpHarry,1,0.00037,43412,15.84703,273944
7561,rtsao,1,0.00037,43413,15.84740,273944
7562,rubennorte,1,0.00037,43414,15.84776,273944
7563,rubycut,1,0.00037,43415,15.84813,273944
7564,ruimarques,1,0.00037,43416,15.84849,273944
7565,Runrioter,1,0.00037,43417,15.84886,273944
7566,ruphin,1,0.00037,43418,15.84922,273944
7567,RuslanPopenko,1,0.00037,43419,15.84959,273944
7568,ruslansennov,1,0.00037,43420,15.84995,273944
7569,russellpwirtz,1,0.00037,43421,15.85032,273944
7570,RussKeldorph,1,0.00037,43422,15.85068,273944
7571,rvanlaak,1,0.00037,43423,15.85105,273944
7572,rvolgers,1,0.00037,43424,15.85141,273944
7573,rwaltenberg,1,0.00037,43425,15.85178,273944
7574,rwieruch,1,0.00037,43426,15.85214,273944
7575,rwjblue,1,0.00037,43427,15.85251,273944
7576,rwky,1,0.00037,43428,15.85288,273944
7577,ry8806,1,0.00037,43429,15.85324,273944
7578,ryancyq,1,0.00037,43430,15.85361,273944
7579,ryandivis,1,0.00037,43431,15.85397,273944
7580,ryaninvents,1,0.00037,43432,15.85434,273944
7581,ryanthara,1,0.00037,43433,15.85470,273944
7582,ryanwholey,1,0.00037,43434,15.85507,273944
7583,ryan-williams,1,0.00037,43435,15.85543,273944
7584,rybon,1,0.00037,43436,15.85580,273944
7585,ryota-murakami,1,0.00037,43437,15.85616,273944
7586,ryouaki,1,0.00037,43438,15.85653,273944
7587,RytisLT,1,0.00037,43439,15.85689,273944
7588,s2-abdo,1,0.00037,43440,15.85726,273944
7589,s4nk,1,0.00037,43441,15.85762,273944
7590,saadq,1,0.00037,43442,15.85799,273944
7591,saagarjha,1,0.00037,43443,15.85835,273944
7592,Sabartius,1,0.00037,43444,15.85872,273944
7593,saboya,1,0.00037,43445,15.85908,273944
7594,Sacret,1,0.00037,43446,15.85945,273944
7595,sadhen,1,0.00037,43447,15.85981,273944
7596,SaeedPrez,1,0.00037,43448,15.86018,273944
7597,sagar-shah94,1,0.00037,43449,15.86054,273944
7598,saifelse,1,0.00037,43450,15.86091,273944
7599,saiyagg,1,0.00037,43451,15.86127,273944
7600,sajadtorkamani,1,0.00037,43452,15.86164,273944
7601,sakinac,1,0.00037,43453,15.86200,273944
7602,sakoh,1,0.00037,43454,15.86237,273944
7603,salyh,1,0.00037,43455,15.86273,273944
7604,salzhrani,1,0.00037,43456,15.86310,273944
7605,sam09,1,0.00037,43457,15.86346,273944
7606,sam918,1,0.00037,43458,15.86383,273944
7607,sambev,1,0.00037,43459,15.86419,273944
7608,samdenty,1,0.00037,43460,15.86456,273944
7609,samerbuna,1,0.00037,43461,15.86492,273944
7610,samertm,1,0.00037,43462,15.86529,273944
7611,samherrmann,1,0.00037,43463,15.86565,273944
7612,SamHH,1,0.00037,43464,15.86602,273944
7613,samjross,1,0.00037,43465,15.86638,273944
7614,samkline,1,0.00037,43466,15.86675,273944
7615,samliebow,1,0.00037,43467,15.86711,273944
7616,sammyhk,1,0.00037,43468,15.86748,273944
7617,samneirinck,1,0.00037,43469,15.86784,273944
7618,samrap,1,0.00037,43470,15.86821,273944
7619,Samsy,1,0.00037,43471,15.86857,273944
7620,samtheson,1,0.00037,43472,15.86894,273944
7621,samverneck,1,0.00037,43473,15.86930,273944
7622,sandro-pasquali,1,0.00037,43474,15.86967,273944
7623,sandwichsudo,1,0.00037,43475,15.87003,273944
7624,Sanjo,1,0.00037,43476,15.87040,273944
7625,sanniassin,1,0.00037,43477,15.87076,273944
7626,santiagoaguiar,1,0.00037,43478,15.87113,273944
7627,santiagocanti,1,0.00037,43479,15.87149,273944
7628,santiph,1,0.00037,43480,15.87186,273944
7629,sarangjo,1,0.00037,43481,15.87222,273944
7630,sarbbottam,1,0.00037,43482,15.87259,273944
7631,SargoDarya,1,0.00037,43483,15.87295,273944
7632,sashashakun,1,0.00037,43484,15.87332,273944
7633,sasivishnu,1,0.00037,43485,15.87368,273944
7634,sassquad,1,0.00037,43486,15.87405,273944
7635,satansk,1,0.00037,43487,15.87441,273944
7636,satta,1,0.00037,43488,15.87478,273944
7637,saulotoledo,1,0.00037,43489,15.87514,273944
7638,savardc,1,0.00037,43490,15.87551,273944
7639,SavePointSam,1,0.00037,43491,15.87587,273944
7640,sa-wilson,1,0.00037,43492,15.87624,273944
7641,sbaechler,1,0.00037,43493,15.87660,273944
7642,sbaudray,1,0.00037,43494,15.87697,273944
7643,sbauer322,1,0.00037,43495,15.87733,273944
7644,sbezludny,1,0.00037,43496,15.87770,273944
7645,sbley,1,0.00037,43497,15.87806,273944
7646,sbrl,1,0.00037,43498,15.87843,273944
7647,ScaldingBlood,1,0.00037,43499,15.87879,273944
7648,schliflo,1,0.00037,43500,15.87916,273944
7649,schmuli,1,0.00037,43501,15.87952,273944
7650,SchnWalter,1,0.00037,43502,15.87989,273944
7651,Schreini,1,0.00037,43503,15.88025,273944
7652,scottburch,1,0.00037,43504,15.88062,273944
7653,scottdomes,1,0.00037,43505,15.88098,273944
7654,Scoup,1,0.00037,43506,15.88135,273944
7655,Scoutski,1,0.00037,43507,15.88171,273944
7656,ScriptSmith,1,0.00037,43508,15.88208,273944
7657,sdecandelario,1,0.00037,43509,15.88244,273944
7658,sdtsui,1,0.00037,43510,15.88281,273944
7659,sduquej,1,0.00037,43511,15.88317,273944
7660,sdwebster,1,0.00037,43512,15.88354,273944
7661,seangransee,1,0.00037,43513,15.88390,273944
7662,SeanGroff,1,0.00037,43514,15.88427,273944
7663,seanharr11,1,0.00037,43515,15.88463,273944
7664,searls,1,0.00037,43516,15.88500,273944
7665,sebasrp,1,0.00037,43517,15.88536,273944
7666,sebastiandeutsch,1,0.00037,43518,15.88573,273944
7667,SebastianM,1,0.00037,43519,15.88609,273944
7668,SebastianOsuna,1,0.00037,43520,15.88646,273944
7669,sebastienpl,1,0.00037,43521,15.88682,273944
7670,sec,1,0.00037,43522,15.88719,273944
7671,sedovsek,1,0.00037,43523,15.88755,273944
7672,seekshiva,1,0.00037,43524,15.88792,273944
7673,sehrope,1,0.00037,43525,15.88828,273944
7674,seiyria,1,0.00037,43526,15.88865,273944
7675,Seldaek,1,0.00037,43527,15.88901,273944
7676,sengelha,1,0.00037,43528,15.88938,273944
7677,seokju-other,1,0.00037,43529,15.88974,273944
7678,seratch,1,0.00037,43530,15.89011,273944
7679,serchavalos,1,0.00037,43531,15.89047,273944
7680,sergeir82,1,0.00037,43532,15.89084,273944
7681,sergei-zelinsky,1,0.00037,43533,15.89120,273944
7682,sergejmueller,1,0.00037,43534,15.89157,273944
7683,sergiopantoja,1,0.00037,43535,15.89193,273944
7684,seritools,1,0.00037,43536,15.89230,273944
7685,serozaki,1,0.00037,43537,15.89266,273944
7686,sethcardoza,1,0.00037,43538,15.89303,273944
7687,seyDoggy,1,0.00037,43539,15.89339,273944
7688,sfrieson,1,0.00037,43540,15.89376,273944
7689,sgaliamov,1,0.00037,43541,15.89412,273944
7690,sgorsh,1,0.00037,43542,15.89449,273944
7691,sh3ev,1,0.00037,43543,15.89485,273944
7692,shabanovd,1,0.00037,43544,15.89522,273944
7693,shadaj,1,0.00037,43545,15.89558,273944
7694,s-h-a-d-o-w,1,0.00037,43546,15.89595,273944
7695,Shadow53,1,0.00037,43547,15.89631,273944
7696,shadow-cs,1,0.00037,43548,15.89668,273944
7697,shaggygi,1,0.00037,43549,15.89704,273944
7698,shahmeet999,1,0.00037,43550,15.89741,273944
7699,ShaishavGandhi,1,0.00037,43551,15.89777,273944
7700,shakib609,1,0.00037,43552,15.89814,273944
7701,shakyShane,1,0.00037,43553,15.89850,273944
7702,shankarshastri,1,0.00037,43554,15.89887,273944
7703,sharkbrainguy,1,0.00037,43555,15.89923,273944
7704,sharpmachine,1,0.00037,43556,15.89960,273944
7705,Shashwat986,1,0.00037,43557,15.89996,273944
7706,shavipathania,1,0.00037,43558,15.90033,273944
7707,shawninder,1,0.00037,43559,15.90070,273944
7708,shawnmclean,1,0.00037,43560,15.90106,273944
7709,shenqioa,1,0.00037,43561,15.90143,273944
7710,shergin,1,0.00037,43562,15.90179,273944
7711,shifengchen,1,0.00037,43563,15.90216,273944
7712,ShiFengChen,1,0.00037,43564,15.90252,273944
7713,shigi,1,0.00037,43565,15.90289,273944
7714,shirshak55,1,0.00037,43566,15.90325,273944
7715,shlomif,1,0.00037,43567,15.90362,273944
7716,shoma,1,0.00037,43568,15.90398,273944
7717,shortspider,1,0.00037,43569,15.90435,273944
7718,shubhamgautam,1,0.00037,43570,15.90471,273944
7719,shubhamranjan,1,0.00037,43571,15.90508,273944
7720,shumsky,1,0.00037,43572,15.90544,273944
7721,shutdown256,1,0.00037,43573,15.90581,273944
7722,shvaikalesh,1,0.00037,43574,15.90617,273944
7723,sialcasa,1,0.00037,43575,15.90654,273944
7724,siamak,1,0.00037,43576,15.90690,273944
7725,sibStephen,1,0.00037,43577,15.90727,273944
7726,sichbo,1,0.00037,43578,15.90763,273944
7727,SiddAjmera,1,0.00037,43579,15.90800,273944
7728,siddii,1,0.00037,43580,15.90836,273944
7729,SidTheEngineer,1,0.00037,43581,15.90873,273944
7730,siebrand,1,0.00037,43582,15.90909,273944
7731,Siegrift,1,0.00037,43583,15.90946,273944
7732,sigurdga,1,0.00037,43584,15.90982,273944
7733,Silthus,1,0.00037,43585,15.91019,273944
7734,silvermanj7,1,0.00037,43586,15.91055,273944
7735,silvestrijonathan,1,0.00037,43587,15.91092,273944
7736,simeg,1,0.00037,43588,15.91128,273944
7737,simison,1,0.00037,43589,15.91165,273944
7738,simonewebdesign,1,0.00037,43590,15.91201,273944
7739,simongareste,1,0.00037,43591,15.91238,273944
7740,simonratner,1,0.00037,43592,15.91274,273944
7741,simplejackcoder,1,0.00037,43593,15.91311,273944
7742,simpulton,1,0.00037,43594,15.91347,273944
7743,siriak,1,0.00037,43595,15.91384,273944
7744,sirkadirov,1,0.00037,43596,15.91420,273944
7745,sivagao,1,0.00037,43597,15.91457,273944
7746,skeggse,1,0.00037,43598,15.91493,273944
7747,skjolber,1,0.00037,43599,15.91530,273944
7748,skotniczny,1,0.00037,43600,15.91566,273944
7749,skovy,1,0.00037,43601,15.91603,273944
7750,Skovy,1,0.00037,43602,15.91639,273944
7751,skrobinson,1,0.00037,43603,15.91676,273944
7752,skyline-123,1,0.00037,43604,15.91712,273944
7753,skyzyx,1,0.00037,43605,15.91749,273944
7754,slavanga,1,0.00037,43606,15.91785,273944
7755,sliceofbytes,1,0.00037,43607,15.91822,273944
7756,slim-hmidi,1,0.00037,43608,15.91858,273944
7757,slinlee,1,0.00037,43609,15.91895,273944
7758,slothspot,1,0.00037,43610,15.91931,273944
7759,Slowyn,1,0.00037,43611,15.91968,273944
7760,slozier,1,0.00037,43612,15.92004,273944
7761,smaant,1,0.00037,43613,15.92041,273944
7762,smaclell,1,0.00037,43614,15.92077,273944
7763,smartftp,1,0.00037,43615,15.92114,273944
7764,smelukov,1,0.00037,43616,15.92150,273944
7765,Smert,1,0.00037,43617,15.92187,273944
7766,smockle,1,0.00037,43618,15.92223,273944
7767,smondal,1,0.00037,43619,15.92260,273944
7768,smurphy333,1,0.00037,43620,15.92296,273944
7769,smusali,1,0.00037,43621,15.92333,273944
7770,SMUsamaShah,1,0.00037,43622,15.92369,273944
7771,snater,1,0.00037,43623,15.92406,273944
7772,snood1205,1,0.00037,43624,15.92442,273944
7773,snuggs,1,0.00037,43625,15.92479,273944
7774,snyamathi,1,0.00037,43626,15.92515,273944
7775,softcraft-development,1,0.00037,43627,15.92552,273944
7776,soheilpro,1,0.00037,43628,15.92588,273944
7777,sokolovstas,1,0.00037,43629,15.92625,273944
7778,sokra,1,0.00037,43630,15.92661,273944
7779,soldair,1,0.00037,43631,15.92698,273944
7780,solzimer,1,0.00037,43632,15.92734,273944
7781,SomeoneWeird,1,0.00037,43633,15.92771,273944
7782,sondrele,1,0.00037,43634,15.92807,273944
7783,songawee,1,0.00037,43635,15.92844,273944
7784,sophiegit,1,0.00037,43636,15.92880,273944
7785,Sornelo,1,0.00037,43637,15.92917,273944
7786,sothawo,1,0.00037,43638,15.92953,273944
7787,sottar,1,0.00037,43639,15.92990,273944
7788,Souhail-5,1,0.00037,43640,15.93026,273944
7789,sowcow,1,0.00037,43641,15.93063,273944
7790,spacebeers,1,0.00037,43642,15.93099,273944
7791,SpainTrain,1,0.00037,43643,15.93136,273944
7792,SpartaSixZero,1,0.00037,43644,15.93172,273944
7793,speedskater,1,0.00037,43645,15.93209,273944
7794,spegelref,1,0.00037,43646,15.93245,273944
7795,spen,1,0.00037,43647,15.93282,273944
7796,sphire,1,0.00037,43648,15.93318,273944
7797,Spikef,1,0.00037,43649,15.93355,273944
7798,spinfooser,1,0.00037,43650,15.93391,273944
7799,spirosikmd,1,0.00037,43651,15.93428,273944
7800,splintercode,1,0.00037,43652,15.93464,273944
7801,sprockow,1,0.00037,43653,15.93501,273944
7802,spshant,1,0.00037,43654,15.93537,273944
7803,sputier,1,0.00037,43655,15.93574,273944
7804,srcdes,1,0.00037,43656,15.93610,273944
7805,sriggin,1,0.00037,43657,15.93647,273944
7806,srittau,1,0.00037,43658,15.93683,273944
7807,srn,1,0.00037,43659,15.93720,273944
7808,srph,1,0.00037,43660,15.93756,273944
7809,ss18,1,0.00037,43661,15.93793,273944
7810,sschueller,1,0.00037,43662,15.93829,273944
7811,stam,1,0.00037,43663,15.93866,273944
7812,Standard8,1,0.00037,43664,15.93902,273944
7813,stasmaxymov,1,0.00037,43665,15.93939,273944
7814,stefan-staynov,1,0.00037,43666,15.93975,273944
7815,steffenweber,1,0.00037,43667,15.94012,273944
7816,StefMa,1,0.00037,43668,15.94048,273944
7817,steida,1,0.00037,43669,15.94085,273944
7818,stephan281094,1,0.00037,43670,15.94121,273944
7819,stephantabor,1,0.00037,43671,15.94158,273944
7820,stephan-v,1,0.00037,43672,15.94194,273944
7821,StephenCleary,1,0.00037,43673,15.94231,273944
7822,stephengroat,1,0.00037,43674,15.94267,273944
7823,stephennancekivell,1,0.00037,43675,15.94304,273944
7824,stephen-puiszis,1,0.00037,43676,15.94340,273944
7825,stephenreddek,1,0.00037,43677,15.94377,273944
7826,stephlag,1,0.00037,43678,15.94413,273944
7827,SteveAndrewArcher,1,0.00037,43679,15.94450,273944
7828,stevedesmond-ca,1,0.00037,43680,15.94486,273944
7829,steveklabnik,1,0.00037,43681,15.94523,273944
7830,stevenbenitez,1,0.00037,43682,15.94559,273944
7831,StevenHeinrich,1,0.00037,43683,15.94596,273944
7832,stevenp,1,0.00037,43684,15.94632,273944
7833,stevenschlansker,1,0.00037,43685,15.94669,273944
7834,stevenw,1,0.00037,43686,15.94705,273944
7835,SteveShaffer,1,0.00037,43687,15.94742,273944
7836,steve-taylor,1,0.00037,43688,15.94778,273944
7837,SteveVanOpstal,1,0.00037,43689,15.94815,273944
7838,steveyken,1,0.00037,43690,15.94852,273944
7839,StewPoll,1,0.00037,43691,15.94888,273944
7840,sth,1,0.00037,43692,15.94925,273944
7841,stkb,1,0.00037,43693,15.94961,273944
7842,stof,1,0.00037,43694,15.94998,273944
7843,stonio,1,0.00037,43695,15.95034,273944
7844,stovocor,1,0.00037,43696,15.95071,273944
7845,stoyandimov,1,0.00037,43697,15.95107,273944
7846,strajkovmsft,1,0.00037,43698,15.95144,273944
7847,straker,1,0.00037,43699,15.95180,273944
7848,strayobject,1,0.00037,43700,15.95217,273944
7849,sttk,1,0.00037,43701,15.95253,273944
7850,stuartsan,1,0.00037,43702,15.95290,273944
7851,studyjan,1,0.00037,43703,15.95326,273944
7852,subzey,1,0.00037,43704,15.95363,273944
7853,Suchiman,1,0.00037,43705,15.95399,273944
7854,suchipi,1,0.00037,43706,15.95436,273944
7855,sudodoki,1,0.00037,43707,15.95472,273944
7856,sugarshin,1,0.00037,43708,15.95509,273944
7857,sukjae,1,0.00037,43709,15.95545,273944
7858,sullis,1,0.00037,43710,15.95582,273944
7859,sumanla13a,1,0.00037,43711,15.95618,273944
7860,sumanvyj,1,0.00037,43712,15.95655,273944
7861,sunorry,1,0.00037,43713,15.95691,273944
7862,sunshineKE,1,0.00037,43714,15.95728,273944
7863,Superpencil,1,0.00037,43715,15.95764,273944
7864,suvjunmd,1,0.00037,43716,15.95801,273944
7865,svatsan,1,0.00037,43717,15.95837,273944
7866,svenheden,1,0.00037,43718,15.95874,273944
7867,sventschui,1,0.00037,43719,15.95910,273944
7868,svenvarkel,1,0.00037,43720,15.95947,273944
7869,sverrejoh,1,0.00037,43721,15.95983,273944
7870,svetlyak40wt,1,0.00037,43722,15.96020,273944
7871,svi3c,1,0.00037,43723,15.96056,273944
7872,SwamWithTurtles,1,0.00037,43724,15.96093,273944
7873,swestwood,1,0.00037,43725,15.96129,273944
7874,SwooshyCueb,1,0.00037,43726,15.96166,273944
7875,swrobel,1,0.00037,43727,15.96202,273944
7876,s-yadav,1,0.00037,43728,15.96239,273944
7877,sylveon,1,0.00037,43729,15.96275,273944
7878,sYnfo,1,0.00037,43730,15.96312,273944
7879,Syrok,1,0.00037,43731,15.96348,273944
7880,szastupov,1,0.00037,43732,15.96385,273944
7881,szedlakmate,1,0.00037,43733,15.96421,273944
7882,szepeviktor,1,0.00037,43734,15.96458,273944
7883,szhu,1,0.00037,43735,15.96494,273944
7884,szwacz,1,0.00037,43736,15.96531,273944
7885,szymonkups,1,0.00037,43737,15.96567,273944
7886,tag,1,0.00037,43738,15.96604,273944
7887,taku0,1,0.00037,43739,15.96640,273944
7888,TalAter,1,0.00037,43740,15.96677,273944
7889,talgautb,1,0.00037,43741,15.96713,273944
7890,talum,1,0.00037,43742,15.96750,273944
7891,TamarChristinaArm,1,0.00037,43743,15.96786,273944
7892,tanyabrassie,1,0.00037,43744,15.96823,273944
7893,tareqhs,1,0.00037,43745,15.96859,273944
7894,tarrow,1,0.00037,43746,15.96896,273944
7895,TATDK,1,0.00037,43747,15.96932,273944
7896,TautvydasZilys,1,0.00037,43748,15.96969,273944
7897,taylorhutchison,1,0.00037,43749,15.97005,273944
7898,tbartley,1,0.00037,43750,15.97042,273944
7899,tbepdb,1,0.00037,43751,15.97078,273944
7900,tdg5,1,0.00037,43752,15.97115,273944
7901,tdhooper,1,0.00037,43753,15.97151,273944
7902,tdupont750,1,0.00037,43754,15.97188,273944
7903,tdzienniak,1,0.00037,43755,15.97224,273944
7904,teabyii,1,0.00037,43756,15.97261,273944
7905,teameh,1,0.00037,43757,15.97297,273944
7906,TechDimension,1,0.00037,43758,15.97334,273944
7907,TechQuery,1,0.00037,43759,15.97370,273944
7908,teeram,1,0.00037,43760,15.97407,273944
7909,tehapo,1,0.00037,43761,15.97443,273944
7910,teldosas,1,0.00037,43762,15.97480,273944
7911,teleaziz,1,0.00037,43763,15.97516,273944
7912,temega,1,0.00037,43764,15.97553,273944
7913,tendant,1,0.00037,43765,15.97589,273944
7914,tengis,1,0.00037,43766,15.97626,273944
7915,teosz,1,0.00037,43767,15.97662,273944
7916,TepigMC,1,0.00037,43768,15.97699,273944
7917,terrawheat,1,0.00037,43769,15.97735,273944
7918,terry3,1,0.00037,43770,15.97772,273944
7919,testcenter,1,0.00037,43771,15.97808,273944
7920,testfirstcoder,1,0.00037,43772,15.97845,273944
7921,Tetsuya3850,1,0.00037,43773,15.97881,273944
7922,tetv,1,0.00037,43774,15.97918,273944
7923,teunw,1,0.00037,43775,15.97954,273944
7924,texasbruce,1,0.00037,43776,15.97991,273944
7925,tgallacher,1,0.00037,43777,15.98027,273944
7926,th0r,1,0.00037,43778,15.98064,273944
7927,th507,1,0.00037,43779,15.98100,273944
7928,ThaddeusJiang,1,0.00037,43780,15.98137,273944
7929,tharunjose,1,0.00037,43781,15.98173,273944
7930,thatJavaNerd,1,0.00037,43782,15.98210,273944
7931,thattanmay,1,0.00037,43783,15.98246,273944
7932,thbt,1,0.00037,43784,15.98283,273944
7933,theawesomenayak,1,0.00037,43785,15.98319,273944
7934,thebergamo,1,0.00037,43786,15.98356,273944
7935,TheBusCantSwim,1,0.00037,43787,15.98392,273944
7936,thechutrain,1,0.00037,43788,15.98429,273944
7937,theely,1,0.00037,43789,15.98465,273944
7938,thefliik,1,0.00037,43790,15.98502,273944
7939,theHasanas,1,0.00037,43791,15.98538,273944
7940,thehungrycoder,1,0.00037,43792,15.98575,273944
7941,TheIke,1,0.00037,43793,15.98611,273944
7942,theimowski,1,0.00037,43794,15.98648,273944
7943,TheInnerParty,1,0.00037,43795,15.98684,273944
7944,TheJaredWilcurt,1,0.00037,43796,15.98721,273944
7945,theJian,1,0.00037,43797,15.98757,273944
7946,theKashey,1,0.00037,43798,15.98794,273944
7947,thekeenant,1,0.00037,43799,15.98830,273944
7948,thekevlau,1,0.00037,43800,15.98867,273944
7949,TheLastAlly,1,0.00037,43801,15.98903,273944
7950,thepont,1,0.00037,43802,15.98940,273944
7951,therealklanni,1,0.00037,43803,15.98976,273944
7952,Theriault,1,0.00037,43804,15.99013,273944
7953,theromis,1,0.00037,43805,15.99049,273944
7954,TheSharpieOne,1,0.00037,43806,15.99086,273944
7955,the-simian,1,0.00037,43807,15.99122,273944
7956,the-vampiire,1,0.00037,43808,15.99159,273944
7957,thewarpaint,1,0.00037,43809,15.99195,273944
7958,thewilly,1,0.00037,43810,15.99232,273944
7959,thezerobit,1,0.00037,43811,15.99268,273944
7960,thezim,1,0.00037,43812,15.99305,273944
7961,thg303,1,0.00037,43813,15.99341,273944
7962,thiagoh,1,0.00037,43814,15.99378,273944
7963,thiagopaiva99,1,0.00037,43815,15.99414,273944
7964,thibaultmeyer,1,0.00037,43816,15.99451,273944
7965,thibautRe,1,0.00037,43817,15.99487,273944
7966,Thiez,1,0.00037,43818,15.99524,273944
7967,thinker3197,1,0.00037,43819,15.99560,273944
7968,Third9,1,0.00037,43820,15.99597,273944
7969,thisconnect,1,0.00037,43821,15.99634,273944
7970,ThisNameWasTaken,1,0.00037,43822,15.99670,273944
7971,thisRaptori,1,0.00037,43823,15.99707,273944
7972,thodorisbais,1,0.00037,43824,15.99743,273944
7973,thoger,1,0.00037,43825,15.99780,273944
7974,thokrae,1,0.00037,43826,15.99816,273944
7975,thomas-klambauer,1,0.00037,43827,15.99853,273944
7976,ThomasSimoens,1,0.00037,43828,15.99889,273944
7977,thomasyimgit,1,0.00037,43829,15.99926,273944
7978,thommymo,1,0.00037,43830,15.99962,273944
7979,thoughtpalette,1,0.00037,43831,15.99999,273944
7980,thoys,1,0.00037,43832,16.00035,273944
7981,ThrawnCA,1,0.00037,43833,16.00072,273944
7982,thtg88,1,0.00037,43834,16.00108,273944
7983,TiagoDanin,1,0.00037,43835,16.00145,273944
7984,tiangolo,1,0.00037,43836,16.00181,273944
7985,tianyin,1,0.00037,43837,16.00218,273944
7986,tidusjar,1,0.00037,43838,16.00254,273944
7987,Tidyzq,1,0.00037,43839,16.00291,273944
7988,tierfire,1,0.00037,43840,16.00327,273944
7989,TillaTheHun0,1,0.00037,43841,16.00364,273944
7990,timbell,1,0.00037,43842,16.00400,273944
7991,TimeBomb,1,0.00037,43843,16.00437,273944
7992,Timer,1,0.00037,43844,16.00473,273944
7993,timfish,1,0.00037,43845,16.00510,273944
7994,timjk,1,0.00037,43846,16.00546,273944
7995,TimJohns,1,0.00037,43847,16.00583,273944
7996,timkindberg,1,0.00037,43848,16.00619,273944
7997,timlesallen,1,0.00037,43849,16.00656,273944
7998,TimonVS,1,0.00037,43850,16.00692,273944
7999,timotei,1,0.00037,43851,16.00729,273944
8000,timotheeg,1,0.00037,43852,16.00765,273944
8001,TimothyKrell,1,0.00037,43853,16.00802,273944
8002,timoweiss,1,0.00037,43854,16.00838,273944
8003,timuric,1,0.00037,43855,16.00875,273944
8004,TimvdEijnden,1,0.00037,43856,16.00911,273944
8005,TimWSpence,1,0.00037,43857,16.00948,273944
8006,tim-zh,1,0.00037,43858,16.00984,273944
8007,TimZhang0926,1,0.00037,43859,16.01021,273944
8008,tingstad,1,0.00037,43860,16.01057,273944
8009,Titozzz,1,0.00037,43861,16.01094,273944
8010,tiwarivikash,1,0.00037,43862,16.01130,273944
8011,tj,1,0.00037,43863,16.01167,273944
8012,t-j-h,1,0.00037,43864,16.01203,273944
8013,tjmehta,1,0.00037,43865,16.01240,273944
8014,tjwallace,1,0.00037,43866,16.01276,273944
8015,tjwebb,1,0.00037,43867,16.01313,273944
8016,tjwudi,1,0.00037,43868,16.01349,273944
8017,tkopczuk,1,0.00037,43869,16.01386,273944
8018,tkp1n,1,0.00037,43870,16.01422,273944
8019,tkrugg,1,0.00037,43871,16.01459,273944
8020,tkshnwesper,1,0.00037,43872,16.01495,273944
8021,tlancina,1,0.00037,43873,16.01532,273944
8022,tlantz,1,0.00037,43874,16.01568,273944
8023,tlk,1,0.00037,43875,16.01605,273944
8024,tlrx,1,0.00037,43876,16.01641,273944
8025,TMiNus,1,0.00037,43877,16.01678,273944
8026,tmousaw-ptc,1,0.00037,43878,16.01714,273944
8027,tmybr11,1,0.00037,43879,16.01751,273944
8028,tmysz,1,0.00037,43880,16.01787,273944
8029,tnga,1,0.00037,43881,16.01824,273944
8030,tnunes,1,0.00037,43882,16.01860,273944
8031,tobarja,1,0.00037,43883,16.01897,273944
8032,TobiTonner,1,0.00037,43884,16.01933,273944
8033,tobyee,1,0.00037,43885,16.01970,273944
8034,toddobryan,1,0.00037,43886,16.02006,273944
8035,todoubaba,1,0.00037,43887,16.02043,273944
8036,tom5760,1,0.00037,43888,16.02079,273944
8037,tomalec,1,0.00037,43889,16.02116,273944
8038,tomap,1,0.00037,43890,16.02152,273944
8039,tomarad,1,0.00037,43891,16.02189,273944
8040,tomaschyly,1,0.00037,43892,16.02225,273944
8041,tomasisonfire,1,0.00037,43893,16.02262,273944
8042,tomduncalf,1,0.00037,43894,16.02298,273944
8043,tomergg,1,0.00037,43895,16.02335,273944
8044,tomfuertes,1,0.00037,43896,16.02371,273944
8045,tomjridge,1,0.00037,43897,16.02408,273944
8046,TomK32,1,0.00037,43898,16.02444,273944
8047,tommagnusson,1,0.00037,43899,16.02481,273944
8048,tomoyukikashiro,1,0.00037,43900,16.02517,273944
8049,tomquirk,1,0.00037,43901,16.02554,273944
8050,Tomschi,1,0.00037,43902,16.02590,273944
8051,tomvlk,1,0.00037,43903,16.02627,273944
8052,TomyJaya,1,0.00037,43904,16.02663,273944
8053,tony99nyr,1,0.00037,43905,16.02700,273944
8054,tonybaloney,1,0.00037,43906,16.02736,273944
8055,tonyhallett,1,0.00037,43907,16.02773,273944
8056,tonyspiro,1,0.00037,43908,16.02809,273944
8057,tordans,1,0.00037,43909,16.02846,273944
8058,Torwori,1,0.00037,43910,16.02882,273944
8059,toshiD,1,0.00037,43911,16.02919,273944
8060,toshihidetagami,1,0.00037,43912,16.02955,273944
8061,toubou91,1,0.00037,43913,16.02992,273944
8062,tpolecat,1,0.00037,43914,16.03028,273944
8063,TracyGJG,1,0.00037,43915,16.03065,273944
8064,translucens,1,0.00037,43916,16.03101,273944
8065,travishohl,1,0.00037,43917,16.03138,273944
8066,trentclowater,1,0.00037,43918,16.03174,273944
8067,Treora,1,0.00037,43919,16.03211,273944
8068,trevorsmith,1,0.00037,43920,16.03247,273944
8069,tribou,1,0.00037,43921,16.03284,273944
8070,trickford,1,0.00037,43922,16.03320,273944
8071,trierra,1,0.00037,43923,16.03357,273944
8072,triggerNZ,1,0.00037,43924,16.03393,273944
8073,trivikr,1,0.00037,43925,16.03430,273944
8074,trodrigues,1,0.00037,43926,16.03466,273944
8075,troeggla,1,0.00037,43927,16.03503,273944
8076,TRowbotham,1,0.00037,43928,16.03539,273944
8077,troyastorino,1,0.00037,43929,16.03576,273944
8078,trshafer,1,0.00037,43930,16.03612,273944
8079,truckingsim,1,0.00037,43931,16.03649,273944
8080,truelixin,1,0.00037,43932,16.03685,273944
8081,truongduy134,1,0.00037,43933,16.03722,273944
8082,trusktr,1,0.00037,43934,16.03758,273944
8083,tsing,1,0.00037,43935,16.03795,273944
8084,tsjost,1,0.00037,43936,16.03831,273944
8085,ttulka,1,0.00037,43937,16.03868,273944
8086,tuespetre,1,0.00037,43938,16.03904,273944
8087,tugh,1,0.00037,43939,16.03941,273944
8088,tugrul,1,0.00037,43940,16.03977,273944
8089,TundraFizz,1,0.00037,43941,16.04014,273944
8090,turbanoff,1,0.00037,43942,16.04050,273944
8091,TurtleShip,1,0.00037,43943,16.04087,273944
8092,tuurbo,1,0.00037,43944,16.04123,273944
8093,tvillaluz,1,0.00037,43945,16.04160,273944
8094,twilker,1,0.00037,43946,16.04196,273944
8095,twillouer,1,0.00037,43947,16.04233,273944
8096,twiss,1,0.00037,43948,16.04269,273944
8097,twk-b,1,0.00037,43949,16.04306,273944
8098,twlkyao,1,0.00037,43950,16.04342,273944
8099,twogood,1,0.00037,43951,16.04379,273944
8100,TylerDixon,1,0.00037,43952,16.04416,273944
8101,tyleriguchi,1,0.00037,43953,16.04452,273944
8102,tymlipari,1,0.00037,43954,16.04489,273944
8103,typytype,1,0.00037,43955,16.04525,273944
8104,Tyriar,1,0.00037,43956,16.04562,273944
8105,tyrw,1,0.00037,43957,16.04598,273944
8106,tzvipm,1,0.00037,43958,16.04635,273944
8107,uday4vunnam,1,0.00037,43959,16.04671,273944
8108,udayvunnam,1,0.00037,43960,16.04708,273944
8109,ueg1990,1,0.00037,43961,16.04744,273944
8110,ueshin,1,0.00037,43962,16.04781,273944
8111,ufcpp,1,0.00037,43963,16.04817,273944
8112,ufologist,1,0.00037,43964,16.04854,273944
8113,uhhhh2,1,0.00037,43965,16.04890,273944
8114,ukreator,1,0.00037,43966,16.04927,273944
8115,ulope,1,0.00037,43967,16.04963,273944
8116,ultrafez,1,0.00037,43968,16.05000,273944
8117,umberbeard,1,0.00037,43969,16.05036,273944
8118,umcodemonkey,1,0.00037,43970,16.05073,273944
8119,undirectlookable,1,0.00037,43971,16.05109,273944
8120,unframework,1,0.00037,43972,16.05146,273944
8121,Unit03,1,0.00037,43973,16.05182,273944
8122,unlimitedsola,1,0.00037,43974,16.05219,273944
8123,unlucio,1,0.00037,43975,16.05255,273944
8124,unRob,1,0.00037,43976,16.05292,273944
8125,unstubbable,1,0.00037,43977,16.05328,273944
8126,up9cloud,1,0.00037,43978,16.05365,273944
8127,urimor,1,0.00037,43979,16.05401,273944
8128,user890104,1,0.00037,43980,16.05438,273944
8129,user9209,1,0.00037,43981,16.05474,273944
8130,usmanajmal,1,0.00037,43982,16.05511,273944
8131,UttejG,1,0.00037,43983,16.05547,273944
8132,uvegla,1,0.00037,43984,16.05584,273944
8133,uweschaefer,1,0.00037,43985,16.05620,273944
8134,uxfed,1,0.00037,43986,16.05657,273944
8135,uyu423,1,0.00037,43987,16.05693,273944
8136,uzyn,1,0.00037,43988,16.05730,273944
8137,VadimDez,1,0.00037,43989,16.05766,273944
8138,vaintroub,1,0.00037,43990,16.05803,273944
8139,ValentinTrinque,1,0.00037,43991,16.05839,273944
8140,valydia,1,0.00037,43992,16.05876,273944
8141,Vampire,1,0.00037,43993,16.05912,273944
8142,vanbujm,1,0.00037,43994,16.05949,273944
8143,vanderlee,1,0.00037,43995,16.05985,273944
8144,vanjacosic,1,0.00037,43996,16.06022,273944
8145,VarelloThemes,1,0.00037,43997,16.06058,273944
8146,varocarbas,1,0.00037,43998,16.06095,273944
8147,varunrau,1,0.00037,43999,16.06131,273944
8148,vbarbaresi,1,0.00037,44000,16.06168,273944
8149,vecode,1,0.00037,44001,16.06204,273944
8150,Vedin,1,0.00037,44002,16.06241,273944
8151,veera83372,1,0.00037,44003,16.06277,273944
8152,vegetableman,1,0.00037,44004,16.06314,273944
8153,VEINHORN,1,0.00037,44005,16.06350,273944
8154,vernondegoede,1,0.00037,44006,16.06387,273944
8155,vgulaev,1,0.00037,44007,16.06423,273944
8156,vicneanschi,1,0.00037,44008,16.06460,273944
8157,vicrdguez,1,0.00037,44009,16.06496,273944
8158,victorhermes,1,0.00037,44010,16.06533,273944
8159,VictorKoenders,1,0.00037,44011,16.06569,273944
8160,victormejia,1,0.00037,44012,16.06606,273944
8161,victorwss,1,0.00037,44013,16.06642,273944
8162,Victorystick,1,0.00037,44014,16.06679,273944
8163,vigneshTheDev,1,0.00037,44015,16.06715,273944
8164,vijayk2019,1,0.00037,44016,16.06752,273944
8165,vijaykcm,1,0.00037,44017,16.06788,273944
8166,vikhyat,1,0.00037,44018,16.06825,273944
8167,ViKomprenas,1,0.00037,44019,16.06861,273944
8168,ViktorSlavov,1,0.00037,44020,16.06898,273944
8169,vinaydate,1,0.00037,44021,16.06934,273944
8170,VincentBailly,1,0.00037,44022,16.06971,273944
8171,vincentdehaan,1,0.00037,44023,16.07007,273944
8172,viniciusdacal,1,0.00037,44024,16.07044,273944
8173,VipSaran,1,0.00037,44025,16.07080,273944
8174,vitaliy-bobrov,1,0.00037,44026,16.07117,273944
8175,vitaliyterziev,1,0.00037,44027,16.07153,273944
8176,vitalymak,1,0.00037,44028,16.07190,273944
8177,vitaly-t,1,0.00037,44029,16.07226,273944
8178,VitoNordloh,1,0.00037,44030,16.07263,273944
8179,vjovanov,1,0.00037,44031,16.07299,273944
8180,vkhv,1,0.00037,44032,16.07336,273944
8181,vkramskikh,1,0.00037,44033,16.07372,273944
8182,VladBlow,1,0.00037,44034,16.07409,273944
8183,vladdrozd,1,0.00037,44035,16.07445,273944
8184,vladgolubev,1,0.00037,44036,16.07482,273944
8185,vladimir-barsuchenko,1,0.00037,44037,16.07518,273944
8186,VladimirKhvostov,1,0.00037,44038,16.07555,273944
8187,Vladlis,1,0.00037,44039,16.07591,273944
8188,vladris,1,0.00037,44040,16.07628,273944
8189,vlcheong,1,0.00037,44041,16.07664,273944
8190,vmalloc,1,0.00037,44042,16.07701,273944
8191,vmosyaykin,1,0.00037,44043,16.07737,273944
8192,vnathalye,1,0.00037,44044,16.07774,273944
8193,vnctaing,1,0.00037,44045,16.07810,273944
8194,vogella,1,0.00037,44046,16.07847,273944
8195,Voker57,1,0.00037,44047,16.07883,273944
8196,volshibenik,1,0.00037,44048,16.07920,273944
8197,vontangen,1,0.00037,44049,16.07956,273944
8198,vovkvlad,1,0.00037,44050,16.07993,273944
8199,voxlet,1,0.00037,44051,16.08029,273944
8200,voyageth,1,0.00037,44052,16.08066,273944
8201,vp2177,1,0.00037,44053,16.08102,273944
8202,vpavic,1,0.00037,44054,16.08139,273944
8203,vsemozhetbyt,1,0.00037,44055,16.08175,273944
8204,vsetka,1,0.00037,44056,16.08212,273944
8205,vseventer,1,0.00037,44057,16.08248,273944
8206,vsiao,1,0.00037,44058,16.08285,273944
8207,vstinner,1,0.00037,44059,16.08321,273944
8208,vuakko,1,0.00037,44060,16.08358,273944
8209,vwxyutarooo,1,0.00037,44061,16.08394,273944
8210,vzaidman,1,0.00037,44062,16.08431,273944
8211,waahhhh,1,0.00037,44063,16.08467,273944
8212,waclawjacek,1,0.00037,44064,16.08504,273944
8213,wadewegner,1,0.00037,44065,16.08540,273944
8214,WaeCo,1,0.00037,44066,16.08577,273944
8215,WallacePinho,1,0.00037,44067,16.08613,273944
8216,wallali,1,0.00037,44068,16.08650,273944
8217,walshie4,1,0.00037,44069,16.08686,273944
8218,Wang-Sen,1,0.00037,44070,16.08723,273944
8219,warapitiya,1,0.00037,44071,16.08759,273944
8220,warrenseymour,1,0.00037,44072,16.08796,273944
8221,watilde,1,0.00037,44073,16.08832,273944
8222,wavebeem,1,0.00037,44074,16.08869,273944
8223,wazave,1,0.00037,44075,16.08905,273944
8224,wbecker,1,0.00037,44076,16.08942,273944
8225,wbinnssmith,1,0.00037,44077,16.08978,273944
8226,wbyoko,1,0.00037,44078,16.09015,273944
8227,wcjordan,1,0.00037,44079,16.09051,273944
8228,wclear,1,0.00037,44080,16.09088,273944
8229,WdeBruin,1,0.00037,44081,16.09124,273944
8230,webdeveloperpr,1,0.00037,44082,16.09161,273944
8231,webgene,1,0.00037,44083,16.09198,273944
8232,webmaster128,1,0.00037,44084,16.09234,273944
8233,webprofusion-chrisc,1,0.00037,44085,16.09271,273944
8234,webyom,1,0.00037,44086,16.09307,273944
8235,weiluntong,1,0.00037,44087,16.09344,273944
8236,wejendorp,1,0.00037,44088,16.09380,273944
8237,WellingR,1,0.00037,44089,16.09417,273944
8238,wellingWilliam,1,0.00037,44090,16.09453,273944
8239,weltkante,1,0.00037,44091,16.09490,273944
8240,wendy,1,0.00037,44092,16.09526,273944
8241,westonruter,1,0.00037,44093,16.09563,273944
8242,weswigham,1,0.00037,44094,16.09599,273944
8243,weswinder,1,0.00037,44095,16.09636,273944
8244,wgottschalk,1,0.00037,44096,16.09672,273944
8245,wgpsutherland,1,0.00037,44097,16.09709,273944
8246,whitej17,1,0.00037,44098,16.09745,273944
8247,WickyNilliams,1,0.00037,44099,16.09782,273944
8248,wikibootup,1,0.00037,44100,16.09818,273944
8249,wikinee,1,0.00037,44101,16.09855,273944
8250,WilcoFiers,1,0.00037,44102,16.09891,273944
8251,Wildenhaus,1,0.00037,44103,16.09928,273944
8252,wildwilder,1,0.00037,44104,16.09964,273944
8253,wilka,1,0.00037,44105,16.10001,273944
8254,willbeaufoy,1,0.00037,44106,16.10037,273944
8255,willfarrell,1,0.00037,44107,16.10074,273944
8256,willgm,1,0.00037,44108,16.10110,273944
8257,williamdes,1,0.00037,44109,16.10147,273944
8258,william-lohan,1,0.00037,44110,16.10183,273944
8259,Willv19,1,0.00037,44111,16.10220,273944
8260,willyelm,1,0.00037,44112,16.10256,273944
8261,wilmol,1,0.00037,44113,16.10293,273944
8262,wilx,1,0.00037,44114,16.10329,273944
8263,wilzbach,1,0.00037,44115,16.10366,273944
8264,wiml,1,0.00037,44116,16.10402,273944
8265,withsilen,1,0.00037,44117,16.10439,273944
8266,wizardnet972,1,0.00037,44118,16.10475,273944
8267,wizawu,1,0.00037,44119,16.10512,273944
8268,wizpig64,1,0.00037,44120,16.10548,273944
8269,wKovacs64,1,0.00037,44121,16.10585,273944
8270,wla80,1,0.00037,44122,16.10621,273944
8271,wllm-rbnt,1,0.00037,44123,16.10658,273944
8272,wltsmrz,1,0.00037,44124,16.10694,273944
8273,WLun001,1,0.00037,44125,16.10731,273944
8274,wobbol,1,0.00037,44126,16.10767,273944
8275,wodify,1,0.00037,44127,16.10804,273944
8276,wodomierz,1,0.00037,44128,16.10840,273944
8277,WojciechNagorski,1,0.00037,44129,16.10877,273944
8278,wojtekmaj,1,0.00037,44130,16.10913,273944
8279,wojtpl2,1,0.00037,44131,16.10950,273944
8280,woloski,1,0.00037,44132,16.10986,273944
8281,wonderdogone,1,0.00037,44133,16.11023,273944
8282,woodyhymns,1,0.00037,44134,16.11059,273944
8283,woppa684,1,0.00037,44135,16.11096,273944
8284,worldsense-tms,1,0.00037,44136,16.11132,273944
8285,worthy7,1,0.00037,44137,16.11169,273944
8286,WouterG,1,0.00037,44138,16.11205,273944
8287,woverton,1,0.00037,44139,16.11242,273944
8288,wrakky,1,0.00037,44140,16.11278,273944
8289,wtokuno,1,0.00037,44141,16.11315,273944
8290,wtorsi,1,0.00037,44142,16.11351,273944
8291,wuwen5,1,0.00037,44143,16.11388,273944
8292,wwcline,1,0.00037,44144,16.11424,273944
8293,wy1009,1,0.00037,44145,16.11461,273944
8294,wyantb,1,0.00037,44146,16.11497,273944
8295,wybb,1,0.00037,44147,16.11534,273944
8296,Wykks,1,0.00037,44148,16.11570,273944
8297,wzr1337,1,0.00037,44149,16.11607,273944
8298,xavierchow,1,0.00037,44150,16.11643,273944
8299,Xazzzi,1,0.00037,44151,16.11680,273944
8300,xbrightmatterx,1,0.00037,44152,16.11716,273944
8301,xdumaine,1,0.00037,44153,16.11753,273944
8302,XeCycle,1,0.00037,44154,16.11789,273944
8303,xelad1,1,0.00037,44155,16.11826,273944
8304,xfh,1,0.00037,44156,16.11862,273944
8305,xied75,1,0.00037,44157,16.11899,273944
8306,ximex,1,0.00037,44158,16.11935,273944
8307,xixixao,1,0.00037,44159,16.11972,273944
8308,xlaguna,1,0.00037,44160,16.12008,273944
8309,xmo-odoo,1,0.00037,44161,16.12045,273944
8310,xobotyi,1,0.00037,44162,16.12081,273944
8311,xoloki,1,0.00037,44163,16.12118,273944
8312,xoofx,1,0.00037,44164,16.12154,273944
8313,xtoolkit,1,0.00037,44165,16.12191,273944
8314,Xuanwo,1,0.00037,44166,16.12227,273944
8315,XueWei,1,0.00037,44167,16.12264,273944
8316,YairHalberstadt,1,0.00037,44168,16.12300,273944
8317,yakovmeister,1,0.00037,44169,16.12337,273944
8318,yanandcoffee,1,0.00037,44170,16.12373,273944
8319,yanick,1,0.00037,44171,16.12410,273944
8320,yankouskia,1,0.00037,44172,16.12446,273944
8321,yannbertrand,1,0.00037,44173,16.12483,273944
8322,yanxyz,1,0.00037,44174,16.12519,273944
8323,yaodingyd,1,0.00037,44175,16.12556,273944
8324,YasharF,1,0.00037,44176,16.12592,273944
8325,yasserzamani,1,0.00037,44177,16.12629,273944
8326,Yasumoto,1,0.00037,44178,16.12665,273944
8327,yavorski,1,0.00037,44179,16.12702,273944
8328,yaziza,1,0.00037,44180,16.12738,273944
8329,yazumoto,1,0.00037,44181,16.12775,273944
8330,YChebotaev,1,0.00037,44182,16.12811,273944
8331,yehezkielbs,1,0.00037,44183,16.12848,273944
8332,yevgeniyredko,1,0.00037,44184,16.12884,273944
8333,Yevs,1,0.00037,44185,16.12921,273944
8334,yfakariya,1,0.00037,44186,16.12957,273944
8335,yitzchak,1,0.00037,44187,16.12994,273944
8336,yjcxy12,1,0.00037,44188,16.13030,273944
8337,ylylc,1,0.00037,44189,16.13067,273944
8338,yoavmmn,1,0.00037,44190,16.13103,273944
8339,yonjah,1,0.00037,44191,16.13140,273944
8340,yorkie,1,0.00037,44192,16.13176,273944
8341,yotamofek,1,0.00037,44193,16.13213,273944
8342,YoussefTaghlabi,1,0.00037,44194,16.13249,273944
8343,yrodiere,1,0.00037,44195,16.13286,273944
8344,ysagal,1,0.00037,44196,16.13322,273944
8345,ysmoradi,1,0.00037,44197,16.13359,273944
8346,yTakkar,1,0.00037,44198,16.13395,273944
8347,ytfei,1,0.00037,44199,16.13432,273944
8348,ytRino,1,0.00037,44200,16.13468,273944
8349,yuanoook,1,0.00037,44201,16.13505,273944
8350,yuanyan,1,0.00037,44202,16.13541,273944
8351,yuchi,1,0.00037,44203,16.13578,273944
8352,yuheiy,1,0.00037,44204,16.13614,273944
8353,yuj,1,0.00037,44205,16.13651,273944
8354,yuji0602,1,0.00037,44206,16.13687,273944
8355,yuji-k64613,1,0.00037,44207,16.13724,273944
8356,yukiwongky,1,0.00037,44208,16.13760,273944
8357,yukulele,1,0.00037,44209,16.13797,273944
8358,yume-chan,1,0.00037,44210,16.13833,273944
8359,yunchancho,1,0.00037,44211,16.13870,273944
8360,yunga91,1,0.00037,44212,16.13906,273944
8361,yunspace,1,0.00037,44213,16.13943,273944
8362,yurenju,1,0.00037,44214,16.13979,273944
8363,Yurickh,1,0.00037,44215,16.14016,273944
8364,yuriyyakym,1,0.00037,44216,16.14053,273944
8365,yusijs,1,0.00037,44217,16.14089,273944
8366,yvele,1,0.00037,44218,16.14126,273944
8367,ywarnier,1,0.00037,44219,16.14162,273944
8368,yxl,1,0.00037,44220,16.14199,273944
8369,yzarubin,1,0.00037,44221,16.14235,273944
8370,zacbraddy,1,0.00037,44222,16.14272,273944
8371,zackify,1,0.00037,44223,16.14308,273944
8372,zakhenry,1,0.00037,44224,16.14345,273944
8373,zakness,1,0.00037,44225,16.14381,273944
8374,zakrid,1,0.00037,44226,16.14418,273944
8375,zanona,1,0.00037,44227,16.14454,273944
8376,zappyzhao,1,0.00037,44228,16.14491,273944
8377,zarahzachz,1,0.00037,44229,16.14527,273944
8378,zbarnett,1,0.00037,44230,16.14564,273944
8379,zcei,1,0.00037,44231,16.14600,273944
8380,zdroid,1,0.00037,44232,16.14637,273944
8381,ze12augusto,1,0.00037,44233,16.14673,273944
8382,zehua,1,0.00037,44234,16.14710,273944
8383,ZenHarbinger,1,0.00037,44235,16.14746,273944
8384,ZenonBuratta,1,0.00037,44236,16.14783,273944
8385,zenozeng,1,0.00037,44237,16.14819,273944
8386,zerogouki,1,0.00037,44238,16.14856,273944
8387,zerok,1,0.00037,44239,16.14892,273944
8388,zeusdeux,1,0.00037,44240,16.14929,273944
8389,Zhangjd,1,0.00037,44241,16.14965,273944
8390,zhangjg,1,0.00037,44242,16.15002,273944
8391,zhangweikop,1,0.00037,44243,16.15038,273944
8392,zhanhb,1,0.00037,44244,16.15075,273944
8393,zhantongz,1,0.00037,44245,16.15111,273944
8394,zhaocong89,1,0.00037,44246,16.15148,273944
8395,zhaosiyang,1,0.00037,44247,16.15184,273944
8396,zhengjunxin,1,0.00037,44248,16.15221,273944
8397,zhenlwa,1,0.00037,44249,16.15257,273944
8398,zheshishei,1,0.00037,44250,16.15294,273944
8399,zhirzh,1,0.00037,44251,16.15330,273944
8400,zhkuskov,1,0.00037,44252,16.15367,273944
8401,zhuoli99,1,0.00037,44253,16.15403,273944
8402,ziyaddin,1,0.00037,44254,16.15440,273944
8403,ZizhengTai,1,0.00037,44255,16.15476,273944
8404,zkochan,1,0.00037,44256,16.15513,273944
8405,zlosch,1,0.00037,44257,16.15549,273944
8406,zn,1,0.00037,44258,16.15586,273944
8407,zodern,1,0.00037,44259,16.15622,273944
8408,zoeysaurusrex,1,0.00037,44260,16.15659,273944
8409,zoliszel,1,0.00037,44261,16.15695,273944
8410,ZombieHippie,1,0.00037,44262,16.15732,273944
8411,zoomcharts,1,0.00037,44263,16.15768,273944
8412,zoulasc,1,0.00037,44264,16.15805,273944
8413,zramaekers,1,0.00037,44265,16.15841,273944
8414,ZSkycat,1,0.00037,44266,16.15878,273944
8415,zsmb13,1,0.00037,44267,16.15914,273944
8416,zsxwing,1,0.00037,44268,16.15951,273944
8417,zuohuadong,1,0.00037,44269,16.15987,273944
8418,zuvizudar,1,0.00037,44270,16.16024,273944
8419,zwread,1,0.00037,44271,16.16060,273944
8420,zx6658,1,0.00037,44272,16.16097,273944
8421,zxqfox,1,0.00037,44273,16.16133,273944
8422,zypA13510,1,0.00037,44274,16.16170,273944
8423,zyrolasting,1,0.00037,44275,16.16206,273944
8424,ZYSzys,1,0.00037,44276,16.16243,273944
8425,zzo,1,0.00037,44277,16.16279,273944
8426,zzx88991,1,0.00037,44278,16.16316,273944
